DATE,PROVINCIA_DESTINO,PROVINCIA_ORIGEN,FLUJO,POB_RESID_ORIGEN,POB_SALE_ORIGEN,POB_CASA_ORIGEN,POB_RESID_DESTINO,POB_LLEGA_DESTINO
2019/11/30,Albacete,Ciudad Real,706,495761,84802,410959,388167,93908
2019/11/30,Albacete,Valencia,250,2565124,794219,1770905,388167,93908
2019/11/30,Albacete,Cuenca,1019,196329,39668,156661,388167,93908
2019/11/30,Albacete,Jaén,251,633564,119149,514415,388167,93908
2019/11/30,Albacete,Albacete,75055,388167,98015,290152,388167,93908
2019/11/30,Albacete,Alicante,225,1858683,523005,1335678,388167,93908
2019/11/30,Albacete,Madrid,23,6663394,2445079,4218315,388167,93908
2019/11/30,Albacete,Murcia,571,1493898,368145,1125753,388167,93908
2019/11/30,Alicante,Bizkaia,18,1152934,391429,761505,1858683,514708
2019/11/30,Alicante,Murcia,3846,1493898,368145,1125753,1858683,514708
2019/11/30,Alicante,Barcelona,22,5664579,1977077,3687502,1858683,514708
2019/11/30,Alicante,Albacete,398,388167,98015,290152,1858683,514708
2019/11/30,Alicante,Rioja,25,316798,88934,227864,1858683,514708
2019/11/30,Alicante,Badajoz,28,673559,131089,542470,1858683,514708
2019/11/30,Alicante,Alicante,413413,1858683,523005,1335678,1858683,514708
2019/11/30,Alicante,Girona,95,771044,197290,573754,1858683,514708
2019/11/30,Alicante,Madrid,19,6663394,2445079,4218315,1858683,514708
2019/11/30,Alicante,Valencia,1797,2565124,794219,1770905,1858683,514708
2019/11/30,Almería,Almería,144843,716820,174628,542192,716820,172939
2019/11/30,Almería,Murcia,2484,1493898,368145,1125753,716820,172939
2019/11/30,Almería,Granada,523,914678,221853,692825,716820,172939
2019/11/30,Araba,Huelva,35,521870,113602,408268,331549,119867
2019/11/30,Araba,Murcia,65,1493898,368145,1125753,331549,119867
2019/11/30,Araba,Cáceres,48,394151,84165,309986,331549,119867
2019/11/30,Araba,Cantabria,114,580795,183030,397765,331549,119867
2019/11/30,Araba,Burgos,3568,357072,90270,266802,331549,119867
2019/11/30,Araba,Gipuzkoa,1432,723576,226911,496665,331549,119867
2019/11/30,Araba,Bizkaia,5288,1152934,391429,761505,331549,119867
2019/11/30,Araba,Rioja,3991,316798,88934,227864,331549,119867
2019/11/30,Araba,Navarra,830,654183,200438,453745,331549,119867
2019/11/30,Araba,Araba,84463,331549,105672,225877,331549,119867
2019/11/30,Asturias,Asturias,257854,1022800,305758,717042,1022800,303988
2019/11/30,Asturias,Cantabria,546,580795,183030,397765,1022800,303988
2019/11/30,Asturias,Lugo,2162,329587,77703,251884,1022800,303988
2019/11/30,Asturias,León,200,460001,136767,323234,1022800,303988
2019/11/30,Ávila,Segovia,181,153129,44473,108656,157640,34051
2019/11/30,Ávila,Toledo,318,694844,178444,516400,157640,34051
2019/11/30,Ávila,Madrid,291,6663394,2445079,4218315,157640,34051
2019/11/30,Ávila,Valladolid,190,519546,150660,368886,157640,34051
2019/11/30,Ávila,Salamanca,319,330119,92587,237532,157640,34051
2019/11/30,Ávila,Ávila,21732,157640,42201,115439,157640,34051
2019/11/30,Ávila,Cáceres,297,394151,84165,309986,157640,34051
2019/11/30,Badajoz,Ciudad Real,69,495761,84802,410959,673559,124104
2019/11/30,Badajoz,Córdoba,183,782979,175143,607836,673559,124104
2019/11/30,Badajoz,Sevilla,370,1942389,503839,1438550,673559,124104
2019/11/30,Badajoz,Cáceres,1724,394151,84165,309986,673559,124104
2019/11/30,Badajoz,Badajoz,94817,673559,131089,542470,673559,124104
2019/11/30,Badajoz,Huelva,341,521870,113602,408268,673559,124104
2019/11/30,Balears,Balears,256318,1149460,298678,850782,1149460,289056
2019/11/30,Balears,Barcelona,65,5664579,1977077,3687502,1149460,289056
2019/11/30,Balears,Cantabria,19,580795,183030,397765,1149460,289056
2019/11/30,Barcelona,Barcelona,1506209,5664579,1977077,3687502,5664579,2036370
2019/11/30,Barcelona,Balears,135,1149460,298678,850782,5664579,2036370
2019/11/30,Barcelona,Zaragoza,21,964724,311185,653539,5664579,2036370
2019/11/30,Barcelona,Alicante,16,1858683,523005,1335678,5664579,2036370
2019/11/30,Barcelona,Tarragona,5468,804664,228590,576074,5664579,2036370
2019/11/30,Barcelona,Girona,9753,771044,197290,573754,5664579,2036370
2019/11/30,Barcelona,Lleida,986,434930,123560,311370,5664579,2036370
2019/11/30,Barcelona,Valencia,17,2565124,794219,1770905,5664579,2036370
2019/11/30,Bizkaia,Cantabria,6231,580795,183030,397765,1152934,390577
2019/11/30,Bizkaia,Palencia,24,160866,48557,112309,1152934,390577
2019/11/30,Bizkaia,Bizkaia,311552,1152934,391429,761505,1152934,390577
2019/11/30,Bizkaia,Málaga,22,1661785,393804,1267981,1152934,390577
2019/11/30,Bizkaia,Burgos,1372,357072,90270,266802,1152934,390577
2019/11/30,Bizkaia,Gipuzkoa,2462,723576,226911,496665,1152934,390577
2019/11/30,Bizkaia,Rioja,91,316798,88934,227864,1152934,390577
2019/11/30,Bizkaia,Araba,3941,331549,105672,225877,1152934,390577
2019/11/30,Burgos,Araba,1912,331549,105672,225877,357072,86088
2019/11/30,Burgos,Segovia,125,153129,44473,108656,357072,86088
2019/11/30,Burgos,Bizkaia,479,1152934,391429,761505,357072,86088
2019/11/30,Burgos,Soria,224,88636,15531,73105,357072,86088
2019/11/30,Burgos,Burgos,64874,357072,90270,266802,357072,86088
2019/11/30,Burgos,Palencia,520,160866,48557,112309,357072,86088
2019/11/30,Burgos,Rioja,235,316798,88934,227864,357072,86088
2019/11/30,Burgos,Cantabria,172,580795,183030,397765,357072,86088
2019/11/30,Burgos,Valladolid,67,519546,150660,368886,357072,86088
2019/11/30,Cáceres,Ávila,317,157640,42201,115439,394151,78948
2019/11/30,Cáceres,Salamanca,450,330119,92587,237532,394151,78948
2019/11/30,Cáceres,Valencia,25,2565124,794219,1770905,394151,78948
2019/11/30,Cáceres,Badajoz,2241,673559,131089,542470,394151,78948
2019/11/30,Cáceres,Cáceres,54075,394151,84165,309986,394151,78948
2019/11/30,Cáceres,Toledo,570,694844,178444,516400,394151,78948
2019/11/30,Cádiz,Ceuta,49,84777,27047,57730,1240155,299256
2019/11/30,Cádiz,Cádiz,249451,1240155,302979,937176,1240155,299256
2019/11/30,Cádiz,Barcelona,19,5664579,1977077,3687502,1240155,299256
2019/11/30,Cádiz,Huelva,319,521870,113602,408268,1240155,299256
2019/11/30,Cádiz,Sevilla,2768,1942389,503839,1438550,1240155,299256
2019/11/30,Cádiz,Málaga,2718,1661785,393804,1267981,1240155,299256
2019/11/30,Cantabria,Burgos,111,357072,90270,266802,580795,168662
2019/11/30,Cantabria,Cantabria,139664,580795,183030,397765,580795,168662
2019/11/30,Cantabria,Palencia,107,160866,48557,112309,580795,168662
2019/11/30,Cantabria,Bizkaia,1695,1152934,391429,761505,580795,168662
2019/11/30,Cantabria,Asturias,271,1022800,305758,717042,580795,168662
2019/11/30,Castellón,Tarragona,3201,804664,228590,576074,579962,156029
2019/11/30,Castellón,Castellón,121481,579962,155822,424140,579962,156029
2019/11/30,Castellón,Teruel,185,134137,21690,112447,579962,156029
2019/11/30,Castellón,Valencia,1183,2565124,794219,1770905,579962,156029
2019/11/30,Castellón,Toledo,29,694844,178444,516400,579962,156029
2019/11/30,Ceuta,Málaga,44,1661785,393804,1267981,84777,28074
2019/11/30,Ceuta,Ceuta,25286,84777,27047,57730,84777,28074
2019/11/30,Ciudad Real,Cuenca,77,196329,39668,156661,495761,77236
2019/11/30,Ciudad Real,Jaén,65,633564,119149,514415,495761,77236
2019/11/30,Ciudad Real,Córdoba,512,782979,175143,607836,495761,77236
2019/11/30,Ciudad Real,Tarragona,26,804664,228590,576074,495761,77236
2019/11/30,Ciudad Real,Badajoz,218,673559,131089,542470,495761,77236
2019/11/30,Ciudad Real,Ciudad Real,54390,495761,84802,410959,495761,77236
2019/11/30,Ciudad Real,Toledo,1708,694844,178444,516400,495761,77236
2019/11/30,Ciudad Real,Albacete,620,388167,98015,290152,495761,77236
2019/11/30,Córdoba,Granada,153,914678,221853,692825,782979,169301
2019/11/30,Córdoba,Jaén,699,633564,119149,514415,782979,169301
2019/11/30,Córdoba,Badajoz,293,673559,131089,542470,782979,169301
2019/11/30,Córdoba,Ciudad Real,162,495761,84802,410959,782979,169301
2019/11/30,Córdoba,Córdoba,129784,782979,175143,607836,782979,169301
2019/11/30,Córdoba,Sevilla,2082,1942389,503839,1438550,782979,169301
2019/11/30,Córdoba,Málaga,468,1661785,393804,1267981,782979,169301
2019/11/30,Coruña,Pontevedra,8083,942665,246669,695996,1119596,298007
2019/11/30,Coruña,Ourense,79,307651,84344,223307,1119596,298007
2019/11/30,Coruña,Coruña,241769,1119596,300482,819114,1119596,298007
2019/11/30,Coruña,Lugo,829,329587,77703,251884,1119596,298007
2019/11/30,Cuenca,Valencia,229,2565124,794219,1770905,196329,33736
2019/11/30,Cuenca,Guadalajara,90,257762,80563,177199,196329,33736
2019/11/30,Cuenca,Toledo,386,694844,178444,516400,196329,33736
2019/11/30,Cuenca,Ciudad Real,291,495761,84802,410959,196329,33736
2019/11/30,Cuenca,Cuenca,20084,196329,39668,156661,196329,33736
2019/11/30,Cuenca,Madrid,41,6663394,2445079,4218315,196329,33736
2019/11/30,Cuenca,Albacete,1252,388167,98015,290152,196329,33736
2019/11/30,Gipuzkoa,Navarra,1066,654183,200438,453745,723576,233628
2019/11/30,Gipuzkoa,Araba,1172,331549,105672,225877,723576,233628
2019/11/30,Gipuzkoa,Bizkaia,4546,1152934,391429,761505,723576,233628
2019/11/30,Gipuzkoa,Gipuzkoa,181902,723576,226911,496665,723576,233628
2019/11/30,Girona,Barcelona,4951,5664579,1977077,3687502,771044,180703
2019/11/30,Girona,Alicante,17,1858683,523005,1335678,771044,180703
2019/11/30,Girona,Murcia,83,1493898,368145,1125753,771044,180703
2019/11/30,Girona,Girona,132409,771044,197290,573754,771044,180703
2019/11/30,Girona,Lleida,300,434930,123560,311370,771044,180703
2019/11/30,Granada,Almería,1227,716820,174628,542192,914678,219703
2019/11/30,Granada,Málaga,1183,1661785,393804,1267981,914678,219703
2019/11/30,Granada,Granada,169938,914678,221853,692825,914678,219703
2019/11/30,Granada,Córdoba,107,782979,175143,607836,914678,219703
2019/11/30,Granada,Murcia,100,1493898,368145,1125753,914678,219703
2019/11/30,Granada,Jaén,751,633564,119149,514415,914678,219703
2019/11/30,Guadalajara,Segovia,25,153129,44473,108656,257762,71171
2019/11/30,Guadalajara,Toledo,27,694844,178444,516400,257762,71171
2019/11/30,Guadalajara,Zaragoza,18,964724,311185,653539,257762,71171
2019/11/30,Guadalajara,Cuenca,273,196329,39668,156661,257762,71171
2019/11/30,Guadalajara,Guadalajara,41471,257762,80563,177199,257762,71171
2019/11/30,Guadalajara,Teruel,98,134137,21690,112447,257762,71171
2019/11/30,Guadalajara,Madrid,6215,6663394,2445079,4218315,257762,71171
2019/11/30,Huelva,Sevilla,818,1942389,503839,1438550,521870,109461
2019/11/30,Huelva,Huelva,84909,521870,113602,408268,521870,109461
2019/11/30,Huelva,Cádiz,297,1240155,302979,937176,521870,109461
2019/11/30,Huelva,Badajoz,539,673559,131089,542470,521870,109461
2019/11/30,Huesca,Lleida,1515,434930,123560,311370,220461,54697
2019/11/30,Huesca,Huesca,37157,220461,55964,164497,220461,54697
2019/11/30,Huesca,Navarra,23,654183,200438,453745,220461,54697
2019/11/30,Huesca,Zaragoza,824,964724,311185,653539,220461,54697
2019/11/30,Jaén,Granada,949,914678,221853,692825,633564,112218
2019/11/30,Jaén,Ciudad Real,137,495761,84802,410959,633564,112218
2019/11/30,Jaén,Balears,22,1149460,298678,850782,633564,112218
2019/11/30,Jaén,Toledo,94,694844,178444,516400,633564,112218
2019/11/30,Jaén,Jaén,83004,633564,119149,514415,633564,112218
2019/11/30,Jaén,Córdoba,780,782979,175143,607836,633564,112218
2019/11/30,Jaén,Almería,27,716820,174628,542192,633564,112218
2019/11/30,Las Palmas de Gran Canaria,Santa Cruz de Tenerife,16,1032983,288917,744066,1120406,324779
2019/11/30,Las Palmas de Gran Canaria,Bizkaia,18,1152934,391429,761505,1120406,324779
2019/11/30,Las Palmas de Gran Canaria,Las Palmas de Gran Canaria,293373,1120406,319314,801092,1120406,324779
2019/11/30,León,León,102298,460001,136767,323234,460001,126437
2019/11/30,León,Valladolid,404,519546,150660,368886,460001,126437
2019/11/30,León,Ourense,309,307651,84344,223307,460001,126437
2019/11/30,León,Lugo,47,329587,77703,251884,460001,126437
2019/11/30,León,Palencia,368,160866,48557,112309,460001,126437
2019/11/30,León,Zamora,417,172539,44804,127735,460001,126437
2019/11/30,León,Asturias,342,1022800,305758,717042,460001,126437
2019/11/30,Lleida,Barcelona,559,5664579,1977077,3687502,434930,118350
2019/11/30,Lleida,Tarragona,442,804664,228590,576074,434930,118350
2019/11/30,Lleida,Huesca,1380,220461,55964,164497,434930,118350
2019/11/30,Lleida,Lleida,91165,434930,123560,311370,434930,118350
2019/11/30,Lleida,Zaragoza,197,964724,311185,653539,434930,118350
2019/11/30,Lleida,Girona,166,771044,197290,573754,434930,118350
2019/11/30,Lugo,Asturias,1128,1022800,305758,717042,329587,74107
2019/11/30,Lugo,Pontevedra,242,942665,246669,695996,329587,74107
2019/11/30,Lugo,Ourense,1140,307651,84344,223307,329587,74107
2019/11/30,Lugo,Coruña,1082,1119596,300482,819114,329587,74107
2019/11/30,Lugo,León,196,460001,136767,323234,329587,74107
2019/11/30,Lugo,Lugo,55659,329587,77703,251884,329587,74107
2019/11/30,Madrid,Guadalajara,12292,257762,80563,177199,6663394,2589640
2019/11/30,Madrid,Barcelona,16,5664579,1977077,3687502,6663394,2589640
2019/11/30,Madrid,Murcia,91,1493898,368145,1125753,6663394,2589640
2019/11/30,Madrid,Ciudad Real,65,495761,84802,410959,6663394,2589640
2019/11/30,Madrid,Cuenca,292,196329,39668,156661,6663394,2589640
2019/11/30,Madrid,Alicante,178,1858683,523005,1335678,6663394,2589640
2019/11/30,Madrid,Cáceres,22,394151,84165,309986,6663394,2589640
2019/11/30,Madrid,Toledo,12710,694844,178444,516400,6663394,2589640
2019/11/30,Madrid,Ávila,1063,157640,42201,115439,6663394,2589640
2019/11/30,Madrid,Castellón,41,579962,155822,424140,6663394,2589640
2019/11/30,Madrid,Cádiz,92,1240155,302979,937176,6663394,2589640
2019/11/30,Madrid,Madrid,1892864,6663394,2445079,4218315,6663394,2589640
2019/11/30,Madrid,Segovia,521,153129,44473,108656,6663394,2589640
2019/11/30,Madrid,Málaga,47,1661785,393804,1267981,6663394,2589640
2019/11/30,Málaga,Granada,288,914678,221853,692825,1661785,394474
2019/11/30,Málaga,Sevilla,800,1942389,503839,1438550,1661785,394474
2019/11/30,Málaga,Jaén,19,633564,119149,514415,1661785,394474
2019/11/30,Málaga,Málaga,323985,1661785,393804,1267981,1661785,394474
2019/11/30,Málaga,Melilla,25,86487,30345,56142,1661785,394474
2019/11/30,Málaga,Córdoba,577,782979,175143,607836,1661785,394474
2019/11/30,Málaga,Cádiz,1804,1240155,302979,937176,1661785,394474
2019/11/30,Melilla,Melilla,28426,86487,30345,56142,86487,30099
2019/11/30,Murcia,Granada,57,914678,221853,692825,1493898,364782
2019/11/30,Murcia,Murcia,304187,1493898,368145,1125753,1493898,364782
2019/11/30,Murcia,Almería,1638,716820,174628,542192,1493898,364782
2019/11/30,Murcia,Alicante,6682,1858683,523005,1335678,1493898,364782
2019/11/30,Murcia,Araba,103,331549,105672,225877,1493898,364782
2019/11/30,Murcia,Girona,204,771044,197290,573754,1493898,364782
2019/11/30,Murcia,Jaén,107,633564,119149,514415,1493898,364782
2019/11/30,Murcia,Albacete,745,388167,98015,290152,1493898,364782
2019/11/30,Navarra,Zaragoza,1250,964724,311185,653539,654183,199884
2019/11/30,Navarra,Rioja,3418,316798,88934,227864,654183,199884
2019/11/30,Navarra,Navarra,158401,654183,200438,453745,654183,199884
2019/11/30,Navarra,Gipuzkoa,1071,723576,226911,496665,654183,199884
2019/11/30,Navarra,Tarragona,46,804664,228590,576074,654183,199884
2019/11/30,Navarra,Araba,138,331549,105672,225877,654183,199884
2019/11/30,Ourense,León,490,460001,136767,323234,307651,78190
2019/11/30,Ourense,Lugo,513,329587,77703,251884,307651,78190
2019/11/30,Ourense,Ourense,63029,307651,84344,223307,307651,78190
2019/11/30,Ourense,Pontevedra,416,942665,246669,695996,307651,78190
2019/11/30,Ourense,Zamora,36,172539,44804,127735,307651,78190
2019/11/30,Palencia,León,28,460001,136767,323234,160866,44953
2019/11/30,Palencia,Valladolid,939,519546,150660,368886,160866,44953
2019/11/30,Palencia,Cantabria,378,580795,183030,397765,160866,44953
2019/11/30,Palencia,Burgos,255,357072,90270,266802,160866,44953
2019/11/30,Palencia,Palencia,33945,160866,48557,112309,160866,44953
2019/11/30,Pontevedra,Ourense,1629,307651,84344,223307,942665,239310
2019/11/30,Pontevedra,Pontevedra,197661,942665,246669,695996,942665,239310
2019/11/30,Pontevedra,Huelva,25,521870,113602,408268,942665,239310
2019/11/30,Pontevedra,Coruña,4717,1119596,300482,819114,942665,239310
2019/11/30,Pontevedra,Lugo,31,329587,77703,251884,942665,239310
2019/11/30,Rioja,Burgos,433,357072,90270,266802,316798,86289
2019/11/30,Rioja,Soria,27,88636,15531,73105,316798,86289
2019/11/30,Rioja,Araba,992,331549,105672,225877,316798,86289
2019/11/30,Rioja,Zaragoza,200,964724,311185,653539,316798,86289
2019/11/30,Rioja,Navarra,5411,654183,200438,453745,316798,86289
2019/11/30,Rioja,Rioja,65933,316798,88934,227864,316798,86289
2019/11/30,Rioja,Bizkaia,17,1152934,391429,761505,316798,86289
2019/11/30,Salamanca,Ávila,267,157640,42201,115439,330119,91379
2019/11/30,Salamanca,Zamora,535,172539,44804,127735,330119,91379
2019/11/30,Salamanca,Cáceres,222,394151,84165,309986,330119,91379
2019/11/30,Salamanca,Salamanca,71994,330119,92587,237532,330119,91379
2019/11/30,Salamanca,Valladolid,45,519546,150660,368886,330119,91379
2019/11/30,Santa Cruz de Tenerife,Las Palmas de Gran Canaria,206,1120406,319314,801092,1032983,291063
2019/11/30,Santa Cruz de Tenerife,Santa Cruz de Tenerife,263643,1032983,288917,744066,1032983,291063
2019/11/30,Segovia,Segovia,25931,153129,44473,108656,153129,38642
2019/11/30,Segovia,Soria,71,88636,15531,73105,153129,38642
2019/11/30,Segovia,Madrid,168,6663394,2445079,4218315,153129,38642
2019/11/30,Segovia,Ávila,301,157640,42201,115439,153129,38642
2019/11/30,Segovia,Burgos,148,357072,90270,266802,153129,38642
2019/11/30,Segovia,Valladolid,729,519546,150660,368886,153129,38642
2019/11/30,Sevilla,Madrid,53,6663394,2445079,4218315,1942389,511895
2019/11/30,Sevilla,Granada,21,914678,221853,692825,1942389,511895
2019/11/30,Sevilla,Huelva,2166,521870,113602,408268,1942389,511895
2019/11/30,Sevilla,Badajoz,124,673559,131089,542470,1942389,511895
2019/11/30,Sevilla,Balears,19,1149460,298678,850782,1942389,511895
2019/11/30,Sevilla,Sevilla,398996,1942389,503839,1438550,1942389,511895
2019/11/30,Sevilla,Cádiz,2245,1240155,302979,937176,1942389,511895
2019/11/30,Sevilla,Córdoba,2779,782979,175143,607836,1942389,511895
2019/11/30,Sevilla,Barcelona,51,5664579,1977077,3687502,1942389,511895
2019/11/30,Sevilla,Málaga,226,1661785,393804,1267981,1942389,511895
2019/11/30,Soria,Guadalajara,22,257762,80563,177199,88636,14386
2019/11/30,Soria,Soria,8564,88636,15531,73105,88636,14386
2019/11/30,Soria,Burgos,180,357072,90270,266802,88636,14386
2019/11/30,Soria,Zaragoza,281,964724,311185,653539,88636,14386
2019/11/30,Soria,Rioja,26,316798,88934,227864,88636,14386
2019/11/30,Tarragona,Zaragoza,40,964724,311185,653539,804664,211457
2019/11/30,Tarragona,Teruel,68,134137,21690,112447,804664,211457
2019/11/30,Tarragona,Tarragona,160672,804664,228590,576074,804664,211457
2019/11/30,Tarragona,Lleida,210,434930,123560,311370,804664,211457
2019/11/30,Tarragona,Barcelona,3303,5664579,1977077,3687502,804664,211457
2019/11/30,Tarragona,Castellón,1289,579962,155822,424140,804664,211457
2019/11/30,Teruel,Tarragona,437,804664,228590,576074,134137,18142
2019/11/30,Teruel,Guadalajara,28,257762,80563,177199,134137,18142
2019/11/30,Teruel,Castellón,178,579962,155822,424140,134137,18142
2019/11/30,Teruel,Teruel,9022,134137,21690,112447,134137,18142
2019/11/30,Teruel,Zaragoza,371,964724,311185,653539,134137,18142
2019/11/30,Teruel,Valencia,95,2565124,794219,1770905,134137,18142
2019/11/30,Toledo,Albacete,20,388167,98015,290152,694844,154900
2019/11/30,Toledo,Toledo,95510,694844,178444,516400,694844,154900
2019/11/30,Toledo,Cuenca,304,196329,39668,156661,694844,154900
2019/11/30,Toledo,Ciudad Real,774,495761,84802,410959,694844,154900
2019/11/30,Toledo,Madrid,7837,6663394,2445079,4218315,694844,154900
2019/11/30,Toledo,Ávila,210,157640,42201,115439,694844,154900
2019/11/30,Toledo,Cáceres,90,394151,84165,309986,694844,154900
2019/11/30,Valencia,Teruel,118,134137,21690,112447,2565124,782980
2019/11/30,Valencia,Valencia,631021,2565124,794219,1770905,2565124,782980
2019/11/30,Valencia,Albacete,538,388167,98015,290152,2565124,782980
2019/11/30,Valencia,Alicante,3345,1858683,523005,1335678,2565124,782980
2019/11/30,Valencia,Cuenca,229,196329,39668,156661,2565124,782980
2019/11/30,Valencia,Balears,27,1149460,298678,850782,2565124,782980
2019/11/30,Valencia,Castellón,1429,579962,155822,424140,2565124,782980
2019/11/30,Valladolid,Segovia,388,153129,44473,108656,519546,150055
2019/11/30,Valladolid,Palencia,755,160866,48557,112309,519546,150055
2019/11/30,Valladolid,Burgos,20,357072,90270,266802,519546,150055
2019/11/30,Valladolid,Ávila,30,157640,42201,115439,519546,150055
2019/11/30,Valladolid,Valladolid,118425,519546,150660,368886,519546,150055
2019/11/30,Valladolid,Zamora,251,172539,44804,127735,519546,150055
2019/11/30,Zamora,Valladolid,463,519546,150660,368886,172539,38625
2019/11/30,Zamora,León,318,460001,136767,323234,172539,38625
2019/11/30,Zamora,Ourense,244,307651,84344,223307,172539,38625
2019/11/30,Zamora,Zamora,28467,172539,44804,127735,172539,38625
2019/11/30,Zamora,Salamanca,205,330119,92587,237532,172539,38625
2019/11/30,Zaragoza,Tarragona,228,804664,228590,576074,964724,313597
2019/11/30,Zaragoza,Lleida,25,434930,123560,311370,964724,313597
2019/11/30,Zaragoza,Castellón,37,579962,155822,424140,964724,313597
2019/11/30,Zaragoza,Soria,129,88636,15531,73105,964724,313597
2019/11/30,Zaragoza,Huesca,855,220461,55964,164497,964724,313597
2019/11/30,Zaragoza,Navarra,994,654183,200438,453745,964724,313597
2019/11/30,Zaragoza,Cáceres,20,394151,84165,309986,964724,313597
2019/11/30,Zaragoza,Zaragoza,257141,964724,311185,653539,964724,313597
2019/11/30,Zaragoza,Teruel,805,134137,21690,112447,964724,313597
2020/03/16,Albacete,Valencia,293,2565124,393358,2171766,388167,36974
2020/03/16,Albacete,Cuenca,438,196329,16777,179552,388167,36974
2020/03/16,Albacete,Albacete,23859,388167,38434,349733,388167,36974
2020/03/16,Albacete,Murcia,99,1493898,184629,1309269,388167,36974
2020/03/16,Albacete,Jaén,16,633564,55814,577750,388167,36974
2020/03/16,Albacete,Alicante,201,1858683,268358,1590325,388167,36974
2020/03/16,Albacete,Ciudad Real,660,495761,41120,454641,388167,36974
2020/03/16,Alicante,Almería,16,716820,78751,638069,1858683,270394
2020/03/16,Alicante,Murcia,2666,1493898,184629,1309269,1858683,270394
2020/03/16,Alicante,Alicante,205763,1858683,268358,1590325,1858683,270394
2020/03/16,Alicante,Valencia,1066,2565124,393358,2171766,1858683,270394
2020/03/16,Alicante,Albacete,260,388167,38434,349733,1858683,270394
2020/03/16,Almería,Melilla,26,86487,10804,75683,716820,80697
2020/03/16,Almería,Granada,331,914678,104267,810411,716820,80697
2020/03/16,Almería,Murcia,1784,1493898,184629,1309269,716820,80697
2020/03/16,Almería,Almería,60943,716820,78751,638069,716820,80697
2020/03/16,Araba,Burgos,1695,357072,40918,316154,331549,60235
2020/03/16,Araba,Bizkaia,1433,1152934,206652,946282,331549,60235
2020/03/16,Araba,Rioja,1222,316798,38370,278428,331549,60235
2020/03/16,Araba,Araba,43256,331549,52765,278784,331549,60235
2020/03/16,Araba,Navarra,136,654183,89793,564390,331549,60235
2020/03/16,Araba,Gipuzkoa,183,723576,101919,621657,331549,60235
2020/03/16,Asturias,Cantabria,183,580795,84426,496369,1022800,132315
2020/03/16,Asturias,León,35,460001,60914,399087,1022800,132315
2020/03/16,Asturias,Lugo,785,329587,40782,288805,1022800,132315
2020/03/16,Asturias,Asturias,102766,1022800,133696,889104,1022800,132315
2020/03/16,Ávila,Toledo,182,694844,85290,609554,157640,15114
2020/03/16,Ávila,Cáceres,109,394151,35776,358375,157640,15114
2020/03/16,Ávila,Ávila,9181,157640,14889,142751,157640,15114
2020/03/16,Ávila,Salamanca,250,330119,42750,287369,157640,15114
2020/03/16,Ávila,Valladolid,25,519546,74120,445426,157640,15114
2020/03/16,Ávila,Segovia,138,153129,19338,133791,157640,15114
2020/03/16,Ávila,Madrid,120,6663394,924401,5738993,157640,15114
2020/03/16,Badajoz,Cáceres,949,394151,35776,358375,673559,70805
2020/03/16,Badajoz,Ciudad Real,56,495761,41120,454641,673559,70805
2020/03/16,Badajoz,Sevilla,45,1942389,238362,1704027,673559,70805
2020/03/16,Badajoz,Córdoba,47,782979,92923,690056,673559,70805
2020/03/16,Badajoz,Badajoz,49998,673559,71888,601671,673559,70805
2020/03/16,Badajoz,Huelva,211,521870,59650,462220,673559,70805
2020/03/16,Balears,Valencia,45,2565124,393358,2171766,1149460,142411
2020/03/16,Balears,Balears,119696,1149460,141264,1008196,1149460,142411
2020/03/16,Barcelona,Almería,16,716820,78751,638069,5664579,832548
2020/03/16,Barcelona,Barcelona,497219,5664579,829155,4835424,5664579,832548
2020/03/16,Barcelona,Girona,2443,771044,84088,686956,5664579,832548
2020/03/16,Barcelona,Zaragoza,16,964724,142420,822304,5664579,832548
2020/03/16,Barcelona,Tarragona,1355,804664,92160,712504,5664579,832548
2020/03/16,Barcelona,Lleida,86,434930,51751,383179,5664579,832548
2020/03/16,Bizkaia,Bizkaia,154518,1152934,206652,946282,1152934,204060
2020/03/16,Bizkaia,Cantabria,2343,580795,84426,496369,1152934,204060
2020/03/16,Bizkaia,Gipuzkoa,1554,723576,101919,621657,1152934,204060
2020/03/16,Bizkaia,Burgos,38,357072,40918,316154,1152934,204060
2020/03/16,Bizkaia,Coruña,20,1119596,176497,943099,1152934,204060
2020/03/16,Bizkaia,Araba,710,331549,52765,278784,1152934,204060
2020/03/16,Burgos,Bizkaia,149,1152934,206652,946282,357072,41881
2020/03/16,Burgos,Segovia,53,153129,19338,133791,357072,41881
2020/03/16,Burgos,Burgos,29264,357072,40918,316154,357072,41881
2020/03/16,Burgos,Rioja,58,316798,38370,278428,357072,41881
2020/03/16,Burgos,Palencia,124,160866,20158,140708,357072,41881
2020/03/16,Burgos,Araba,767,331549,52765,278784,357072,41881
2020/03/16,Burgos,Cantabria,25,580795,84426,496369,357072,41881
2020/03/16,Burgos,Valladolid,47,519546,74120,445426,357072,41881
2020/03/16,Cáceres,Ávila,69,157640,14889,142751,394151,34882
2020/03/16,Cáceres,Cáceres,22457,394151,35776,358375,394151,34882
2020/03/16,Cáceres,Toledo,220,694844,85290,609554,394151,34882
2020/03/16,Cáceres,Badajoz,868,673559,71888,601671,394151,34882
2020/03/16,Cádiz,Cádiz,101810,1240155,133165,1106990,1240155,135990
2020/03/16,Cádiz,Málaga,1182,1661785,189348,1472437,1240155,135990
2020/03/16,Cádiz,Ceuta,29,84777,10446,74331,1240155,135990
2020/03/16,Cádiz,Huelva,671,521870,59650,462220,1240155,135990
2020/03/16,Cádiz,Sevilla,845,1942389,238362,1704027,1240155,135990
2020/03/16,Cantabria,Cantabria,60061,580795,84426,496369,580795,79190
2020/03/16,Cantabria,Palencia,60,160866,20158,140708,580795,79190
2020/03/16,Cantabria,Bizkaia,493,1152934,206652,946282,580795,79190
2020/03/16,Cantabria,Asturias,169,1022800,133696,889104,580795,79190
2020/03/16,Castellón,Valencia,715,2565124,393358,2171766,579962,69376
2020/03/16,Castellón,Castellón,49000,579962,67731,512231,579962,69376
2020/03/16,Castellón,Tarragona,812,804664,92160,712504,579962,69376
2020/03/16,Ceuta,Ceuta,9760,84777,10446,74331,84777,10444
2020/03/16,Ciudad Real,Ciudad Real,22766,495761,41120,454641,495761,37529
2020/03/16,Ciudad Real,Jaén,25,633564,55814,577750,495761,37529
2020/03/16,Ciudad Real,Badajoz,51,673559,71888,601671,495761,37529
2020/03/16,Ciudad Real,Córdoba,349,782979,92923,690056,495761,37529
2020/03/16,Ciudad Real,Toledo,266,694844,85290,609554,495761,37529
2020/03/16,Ciudad Real,Albacete,397,388167,38434,349733,495761,37529
2020/03/16,Córdoba,Badajoz,54,673559,71888,601671,782979,89245
2020/03/16,Córdoba,Málaga,223,1661785,189348,1472437,782979,89245
2020/03/16,Córdoba,Sevilla,1414,1942389,238362,1704027,782979,89245
2020/03/16,Córdoba,Granada,187,914678,104267,810411,782979,89245
2020/03/16,Córdoba,Jaén,617,633564,55814,577750,782979,89245
2020/03/16,Córdoba,Córdoba,61827,782979,92923,690056,782979,89245
2020/03/16,Córdoba,Ciudad Real,285,495761,41120,454641,782979,89245
2020/03/16,Coruña,Coruña,135720,1119596,176497,943099,1119596,176884
2020/03/16,Coruña,Pontevedra,4861,942665,160788,781877,1119596,176884
2020/03/16,Coruña,Lugo,523,329587,40782,288805,1119596,176884
2020/03/16,Cuenca,Albacete,543,388167,38434,349733,196329,16712
2020/03/16,Cuenca,Madrid,32,6663394,924401,5738993,196329,16712
2020/03/16,Cuenca,Toledo,122,694844,85290,609554,196329,16712
2020/03/16,Cuenca,Valencia,50,2565124,393358,2171766,196329,16712
2020/03/16,Cuenca,Guadalajara,30,257762,33109,224653,196329,16712
2020/03/16,Cuenca,Ciudad Real,38,495761,41120,454641,196329,16712
2020/03/16,Cuenca,Murcia,16,1493898,184629,1309269,196329,16712
2020/03/16,Cuenca,Cuenca,7858,196329,16777,179552,196329,16712
2020/03/16,Gipuzkoa,Navarra,272,654183,89793,564390,723576,106404
2020/03/16,Gipuzkoa,Gipuzkoa,76005,723576,101919,621657,723576,106404
2020/03/16,Gipuzkoa,Araba,154,331549,52765,278784,723576,106404
2020/03/16,Gipuzkoa,Bizkaia,1784,1152934,206652,946282,723576,106404
2020/03/16,Girona,Lleida,109,434930,51751,383179,771044,87255
2020/03/16,Girona,Girona,53137,771044,84088,686956,771044,87255
2020/03/16,Girona,Barcelona,2322,5664579,829155,4835424,771044,87255
2020/03/16,Granada,Málaga,196,1661785,189348,1472437,914678,101136
2020/03/16,Granada,Almería,192,716820,78751,638069,914678,101136
2020/03/16,Granada,Jaén,155,633564,55814,577750,914678,101136
2020/03/16,Granada,Granada,69759,914678,104267,810411,914678,101136
2020/03/16,Granada,Córdoba,236,782979,92923,690056,914678,101136
2020/03/16,Guadalajara,Madrid,2036,6663394,924401,5738993,257762,35975
2020/03/16,Guadalajara,Guadalajara,18917,257762,33109,224653,257762,35975
2020/03/16,Guadalajara,Cuenca,63,196329,16777,179552,257762,35975
2020/03/16,Huelva,Cádiz,386,1240155,133165,1106990,521870,61543
2020/03/16,Huelva,Sevilla,710,1942389,238362,1704027,521870,61543
2020/03/16,Huelva,Huelva,42515,521870,59650,462220,521870,61543
2020/03/16,Huelva,Badajoz,334,673559,71888,601671,521870,61543
2020/03/16,Huesca,Zaragoza,218,964724,142420,822304,220461,25142
2020/03/16,Huesca,Huesca,14940,220461,22781,197680,220461,25142
2020/03/16,Huesca,Lleida,434,434930,51751,383179,220461,25142
2020/03/16,Jaén,Jaén,34519,633564,55814,577750,633564,53528
2020/03/16,Jaén,Córdoba,856,782979,92923,690056,633564,53528
2020/03/16,Jaén,Granada,141,914678,104267,810411,633564,53528
2020/03/16,Las Palmas de Gran Canaria,Las Palmas de Gran Canaria,147954,1120406,163417,956989,1120406,162163
2020/03/16,León,Valladolid,55,519546,74120,445426,460001,59622
2020/03/16,León,León,43451,460001,60914,399087,460001,59622
2020/03/16,León,Asturias,42,1022800,133696,889104,460001,59622
2020/03/16,León,Lugo,26,329587,40782,288805,460001,59622
2020/03/16,León,Zamora,80,172539,19883,152656,460001,59622
2020/03/16,León,Ourense,309,307651,48039,259612,460001,59622
2020/03/16,Lleida,Lleida,31821,434930,51751,383179,434930,49768
2020/03/16,Lleida,Huesca,388,220461,22781,197680,434930,49768
2020/03/16,Lleida,Girona,96,771044,84088,686956,434930,49768
2020/03/16,Lleida,Barcelona,184,5664579,829155,4835424,434930,49768
2020/03/16,Lleida,Zaragoza,146,964724,142420,822304,434930,49768
2020/03/16,Lugo,Lugo,28448,329587,40782,288805,329587,41727
2020/03/16,Lugo,Asturias,676,1022800,133696,889104,329587,41727
2020/03/16,Lugo,León,60,460001,60914,399087,329587,41727
2020/03/16,Lugo,Coruña,571,1119596,176497,943099,329587,41727
2020/03/16,Lugo,Ourense,150,307651,48039,259612,329587,41727
2020/03/16,Lugo,Pontevedra,26,942665,160788,781877,329587,41727
2020/03/16,Madrid,Toledo,3894,694844,85290,609554,6663394,935893
2020/03/16,Madrid,Valencia,20,2565124,393358,2171766,6663394,935893
2020/03/16,Madrid,Ávila,197,157640,14889,142751,6663394,935893
2020/03/16,Madrid,Segovia,64,153129,19338,133791,6663394,935893
2020/03/16,Madrid,Cuenca,75,196329,16777,179552,6663394,935893
2020/03/16,Madrid,Guadalajara,2628,257762,33109,224653,6663394,935893
2020/03/16,Madrid,Madrid,515372,6663394,924401,5738993,6663394,935893
2020/03/16,Málaga,Córdoba,198,782979,92923,690056,1661785,193007
2020/03/16,Málaga,Málaga,145769,1661785,189348,1472437,1661785,193007
2020/03/16,Málaga,Granada,230,914678,104267,810411,1661785,193007
2020/03/16,Málaga,Sevilla,260,1942389,238362,1704027,1661785,193007
2020/03/16,Málaga,Cádiz,824,1240155,133165,1106990,1661785,193007
2020/03/16,Melilla,Almería,18,716820,78751,638069,86487,11671
2020/03/16,Melilla,Melilla,10448,86487,10804,75683,86487,11671
2020/03/16,Melilla,Málaga,34,1661785,189348,1472437,86487,11671
2020/03/16,Murcia,Albacete,228,388167,38434,349733,1493898,183039
2020/03/16,Murcia,Murcia,136406,1493898,184629,1309269,1493898,183039
2020/03/16,Murcia,Alicante,2627,1858683,268358,1590325,1493898,183039
2020/03/16,Murcia,Almería,1174,716820,78751,638069,1493898,183039
2020/03/16,Navarra,Gipuzkoa,357,723576,101919,621657,654183,92449
2020/03/16,Navarra,Araba,41,331549,52765,278784,654183,92449
2020/03/16,Navarra,Navarra,62437,654183,89793,564390,654183,92449
2020/03/16,Navarra,Rioja,2002,316798,38370,278428,654183,92449
2020/03/16,Navarra,Barcelona,16,5664579,829155,4835424,654183,92449
2020/03/16,Navarra,Zaragoza,614,964724,142420,822304,654183,92449
2020/03/16,Ourense,León,273,460001,60914,399087,307651,47957
2020/03/16,Ourense,Zamora,21,172539,19883,152656,307651,47957
2020/03/16,Ourense,Pontevedra,178,942665,160788,781877,307651,47957
2020/03/16,Ourense,Lugo,243,329587,40782,288805,307651,47957
2020/03/16,Ourense,Ourense,36385,307651,48039,259612,307651,47957
2020/03/16,Palencia,León,25,460001,60914,399087,160866,20891
2020/03/16,Palencia,Burgos,195,357072,40918,316154,160866,20891
2020/03/16,Palencia,Valladolid,93,519546,74120,445426,160866,20891
2020/03/16,Palencia,Palencia,13532,160866,20158,140708,160866,20891
2020/03/16,Palencia,Cantabria,141,580795,84426,496369,160866,20891
2020/03/16,Pontevedra,Ourense,165,307651,48039,259612,942665,158458
2020/03/16,Pontevedra,Pontevedra,125766,942665,160788,781877,942665,158458
2020/03/16,Pontevedra,Coruña,3563,1119596,176497,943099,942665,158458
2020/03/16,Pontevedra,Lugo,27,329587,40782,288805,942665,158458
2020/03/16,Rioja,Araba,437,331549,52765,278784,316798,36468
2020/03/16,Rioja,Navarra,1558,654183,89793,564390,316798,36468
2020/03/16,Rioja,Rioja,26648,316798,38370,278428,316798,36468
2020/03/16,Salamanca,Ávila,156,157640,14889,142751,330119,42016
2020/03/16,Salamanca,Salamanca,32925,330119,42750,287369,330119,42016
2020/03/16,Santa Cruz de Tenerife,Santa Cruz de Tenerife,124503,1032983,141903,891080,1032983,141275
2020/03/16,Segovia,Segovia,12420,153129,19338,133791,153129,20007
2020/03/16,Segovia,Burgos,63,357072,40918,316154,153129,20007
2020/03/16,Segovia,Valladolid,301,519546,74120,445426,153129,20007
2020/03/16,Segovia,Ávila,50,157640,14889,142751,153129,20007
2020/03/16,Sevilla,Huelva,378,521870,59650,462220,1942389,234280
2020/03/16,Sevilla,Sevilla,153070,1942389,238362,1704027,1942389,234280
2020/03/16,Sevilla,Córdoba,1547,782979,92923,690056,1942389,234280
2020/03/16,Sevilla,Málaga,96,1661785,189348,1472437,1942389,234280
2020/03/16,Sevilla,Cádiz,693,1240155,133165,1106990,1942389,234280
2020/03/16,Soria,Segovia,53,153129,19338,133791,88636,8073
2020/03/16,Soria,Zaragoza,70,964724,142420,822304,88636,8073
2020/03/16,Soria,Navarra,24,654183,89793,564390,88636,8073
2020/03/16,Soria,Soria,5097,88636,6956,81680,88636,8073
2020/03/16,Soria,Burgos,27,357072,40918,316154,88636,8073
2020/03/16,Soria,Valladolid,72,519546,74120,445426,88636,8073
2020/03/16,Tarragona,Teruel,31,134137,9086,125051,804664,90820
2020/03/16,Tarragona,Barcelona,899,5664579,829155,4835424,804664,90820
2020/03/16,Tarragona,Tarragona,58296,804664,92160,712504,804664,90820
2020/03/16,Tarragona,Castellón,643,579962,67731,512231,804664,90820
2020/03/16,Teruel,Zaragoza,106,964724,142420,822304,134137,10467
2020/03/16,Teruel,Castellón,25,579962,67731,512231,134137,10467
2020/03/16,Teruel,Teruel,4892,134137,9086,125051,134137,10467
2020/03/16,Teruel,Tarragona,42,804664,92160,712504,134137,10467
2020/03/16,Toledo,Toledo,40795,694844,85290,609554,694844,81879
2020/03/16,Toledo,Ciudad Real,268,495761,41120,454641,694844,81879
2020/03/16,Toledo,Ávila,204,157640,14889,142751,694844,81879
2020/03/16,Toledo,Cuenca,95,196329,16777,179552,694844,81879
2020/03/16,Toledo,Madrid,3821,6663394,924401,5738993,694844,81879
2020/03/16,Toledo,Cáceres,167,394151,35776,358375,694844,81879
2020/03/16,Valencia,Albacete,364,388167,38434,349733,2565124,384955
2020/03/16,Valencia,Cuenca,98,196329,16777,179552,2565124,384955
2020/03/16,Valencia,Castellón,556,579962,67731,512231,2565124,384955
2020/03/16,Valencia,Alicante,1118,1858683,268358,1590325,2565124,384955
2020/03/16,Valencia,Valencia,266260,2565124,393358,2171766,2565124,384955
2020/03/16,Valladolid,Segovia,246,153129,19338,133791,519546,71870
2020/03/16,Valladolid,Zamora,29,172539,19883,152656,519546,71870
2020/03/16,Valladolid,Soria,34,88636,6956,81680,519546,71870
2020/03/16,Valladolid,Palencia,35,160866,20158,140708,519546,71870
2020/03/16,Valladolid,Valladolid,52356,519546,74120,445426,519546,71870
2020/03/16,Valladolid,León,27,460001,60914,399087,519546,71870
2020/03/16,Valladolid,Burgos,69,357072,40918,316154,519546,71870
2020/03/16,Zamora,León,66,460001,60914,399087,172539,20069
2020/03/16,Zamora,Ourense,41,307651,48039,259612,172539,20069
2020/03/16,Zamora,Zamora,13294,172539,19883,152656,172539,20069
2020/03/16,Zamora,Valladolid,68,519546,74120,445426,172539,20069
2020/03/16,Zaragoza,Barcelona,32,5664579,829155,4835424,964724,138598
2020/03/16,Zaragoza,Teruel,93,134137,9086,125051,964724,138598
2020/03/16,Zaragoza,Zaragoza,106243,964724,142420,822304,964724,138598
2020/03/16,Zaragoza,Navarra,392,654183,89793,564390,964724,138598
2020/03/16,Zaragoza,Lleida,153,434930,51751,383179,964724,138598
2020/03/16,Zaragoza,Huesca,144,220461,22781,197680,964724,138598
2020/03/16,Zaragoza,Soria,48,88636,6956,81680,964724,138598
2020/03/18,Albacete,Valencia,211,2565124,350539,2214585,388167,36055
2020/03/18,Albacete,Albacete,23661,388167,36903,351264,388167,36055
2020/03/18,Albacete,Alicante,168,1858683,248310,1610373,388167,36055
2020/03/18,Albacete,Cuenca,448,196329,16663,179666,388167,36055
2020/03/18,Albacete,Ciudad Real,634,495761,39916,455845,388167,36055
2020/03/18,Albacete,Jaén,58,633564,41093,592471,388167,36055
2020/03/18,Albacete,Murcia,296,1493898,179475,1314423,388167,36055
2020/03/18,Alicante,Murcia,2667,1493898,179475,1314423,1858683,252387
2020/03/18,Alicante,Alicante,189629,1858683,248310,1610373,1858683,252387
2020/03/18,Alicante,Valencia,1030,2565124,350539,2214585,1858683,252387
2020/03/18,Alicante,Albacete,229,388167,36903,351264,1858683,252387
2020/03/18,Almería,Granada,299,914678,74676,840002,716820,54232
2020/03/18,Almería,Almería,39456,716820,52176,664644,716820,54232
2020/03/18,Almería,Murcia,1580,1493898,179475,1314423,716820,54232
2020/03/18,Araba,Navarra,110,654183,82307,571876,331549,54368
2020/03/18,Araba,Bizkaia,1181,1152934,191431,961503,331549,54368
2020/03/18,Araba,Araba,38925,331549,48154,283395,331549,54368
2020/03/18,Araba,Rioja,1285,316798,37457,279341,331549,54368
2020/03/18,Araba,Burgos,1407,357072,38835,318237,331549,54368
2020/03/18,Araba,Gipuzkoa,180,723576,93137,630439,331549,54368
2020/03/18,Asturias,León,55,460001,56360,403641,1022800,122785
2020/03/18,Asturias,Asturias,93968,1022800,122891,899909,1022800,122785
2020/03/18,Asturias,Lugo,873,329587,39351,290236,1022800,122785
2020/03/18,Asturias,Cantabria,196,580795,78943,501852,1022800,122785
2020/03/18,Ávila,Madrid,112,6663394,858434,5804960,157640,14989
2020/03/18,Ávila,Ávila,8860,157640,14457,143183,157640,14989
2020/03/18,Ávila,Segovia,72,153129,18495,134634,157640,14989
2020/03/18,Ávila,Toledo,224,694844,77165,617679,157640,14989
2020/03/18,Ávila,Cáceres,272,394151,35615,358536,157640,14989
2020/03/18,Ávila,Salamanca,327,330119,40442,289677,157640,14989
2020/03/18,Badajoz,Huelva,210,521870,54609,467261,673559,64759
2020/03/18,Badajoz,Ciudad Real,54,495761,39916,455845,673559,64759
2020/03/18,Badajoz,Badajoz,45557,673559,65887,607672,673559,64759
2020/03/18,Badajoz,Sevilla,47,1942389,209578,1732811,673559,64759
2020/03/18,Badajoz,Córdoba,51,782979,85685,697294,673559,64759
2020/03/18,Badajoz,Cáceres,820,394151,35615,358536,673559,64759
2020/03/18,Balears,Balears,102973,1149460,124258,1025202,1149460,125395
2020/03/18,Balears,Valencia,123,2565124,350539,2214585,1149460,125395
2020/03/18,Balears,Barcelona,22,5664579,761411,4903168,1149460,125395
2020/03/18,Barcelona,Tarragona,1135,804664,87374,717290,5664579,762130
2020/03/18,Barcelona,Barcelona,458317,5664579,761411,4903168,5664579,762130
2020/03/18,Barcelona,Girona,2305,771044,77920,693124,5664579,762130
2020/03/18,Barcelona,Lleida,116,434930,50320,384610,5664579,762130
2020/03/18,Barcelona,Balears,208,1149460,124258,1025202,5664579,762130
2020/03/18,Bizkaia,Burgos,39,357072,38835,318237,1152934,188351
2020/03/18,Bizkaia,Cantabria,2049,580795,78943,501852,1152934,188351
2020/03/18,Bizkaia,Gipuzkoa,1040,723576,93137,630439,1152934,188351
2020/03/18,Bizkaia,Araba,749,331549,48154,283395,1152934,188351
2020/03/18,Bizkaia,Bizkaia,142623,1152934,191431,961503,1152934,188351
2020/03/18,Burgos,Valladolid,55,519546,67789,451757,357072,39319
2020/03/18,Burgos,Bizkaia,127,1152934,191431,961503,357072,39319
2020/03/18,Burgos,Palencia,199,160866,19289,141577,357072,39319
2020/03/18,Burgos,Rioja,59,316798,37457,279341,357072,39319
2020/03/18,Burgos,Araba,713,331549,48154,283395,357072,39319
2020/03/18,Burgos,Segovia,21,153129,18495,134634,357072,39319
2020/03/18,Burgos,Burgos,27485,357072,38835,318237,357072,39319
2020/03/18,Cáceres,Ávila,85,157640,14457,143183,394151,34918
2020/03/18,Cáceres,Badajoz,888,673559,65887,607672,394151,34918
2020/03/18,Cáceres,Toledo,173,694844,77165,617679,394151,34918
2020/03/18,Cáceres,Cáceres,23544,394151,35615,358536,394151,34918
2020/03/18,Cádiz,Huelva,638,521870,54609,467261,1240155,120560
2020/03/18,Cádiz,Málaga,925,1661785,167556,1494229,1240155,120560
2020/03/18,Cádiz,Cádiz,91605,1240155,117780,1122375,1240155,120560
2020/03/18,Cádiz,Ceuta,16,84777,8202,76575,1240155,120560
2020/03/18,Cádiz,Sevilla,751,1942389,209578,1732811,1240155,120560
2020/03/18,Cantabria,Bizkaia,504,1152934,191431,961503,580795,75114
2020/03/18,Cantabria,Asturias,169,1022800,122891,899909,580795,75114
2020/03/18,Cantabria,Cantabria,55843,580795,78943,501852,580795,75114
2020/03/18,Cantabria,Palencia,39,160866,19289,141577,580795,75114
2020/03/18,Castellón,Valencia,623,2565124,350539,2214585,579962,80083
2020/03/18,Castellón,Castellón,58478,579962,77664,502298,579962,80083
2020/03/18,Castellón,Tarragona,900,804664,87374,717290,579962,80083
2020/03/18,Castellón,Teruel,66,134137,9016,125121,579962,80083
2020/03/18,Ceuta,Cádiz,22,1240155,117780,1122375,84777,8181
2020/03/18,Ceuta,Ceuta,7714,84777,8202,76575,84777,8181
2020/03/18,Ciudad Real,Toledo,184,694844,77165,617679,495761,36789
2020/03/18,Ciudad Real,Albacete,393,388167,36903,351264,495761,36789
2020/03/18,Ciudad Real,Badajoz,48,673559,65887,607672,495761,36789
2020/03/18,Ciudad Real,Ciudad Real,22625,495761,39916,455845,495761,36789
2020/03/18,Ciudad Real,Córdoba,348,782979,85685,697294,495761,36789
2020/03/18,Córdoba,Córdoba,57759,782979,85685,697294,782979,83464
2020/03/18,Córdoba,Ciudad Real,213,495761,39916,455845,782979,83464
2020/03/18,Córdoba,Jaén,593,633564,41093,592471,782979,83464
2020/03/18,Córdoba,Granada,130,914678,74676,840002,782979,83464
2020/03/18,Córdoba,Málaga,273,1661785,167556,1494229,782979,83464
2020/03/18,Córdoba,Badajoz,61,673559,65887,607672,782979,83464
2020/03/18,Córdoba,Sevilla,1421,1942389,209578,1732811,782979,83464
2020/03/18,Coruña,Coruña,129786,1119596,167734,951862,1119596,168732
2020/03/18,Coruña,Lugo,487,329587,39351,290236,1119596,168732
2020/03/18,Coruña,Pontevedra,4612,942665,149213,793452,1119596,168732
2020/03/18,Cuenca,Albacete,586,388167,36903,351264,196329,16971
2020/03/18,Cuenca,Valencia,35,2565124,350539,2214585,196329,16971
2020/03/18,Cuenca,Ciudad Real,126,495761,39916,455845,196329,16971
2020/03/18,Cuenca,Toledo,198,694844,77165,617679,196329,16971
2020/03/18,Cuenca,Cuenca,7880,196329,16663,179666,196329,16971
2020/03/18,Cuenca,Madrid,41,6663394,858434,5804960,196329,16971
2020/03/18,Gipuzkoa,Gipuzkoa,68910,723576,93137,630439,723576,96540
2020/03/18,Gipuzkoa,Araba,146,331549,48154,283395,723576,96540
2020/03/18,Gipuzkoa,Bizkaia,1347,1152934,191431,961503,723576,96540
2020/03/18,Gipuzkoa,Navarra,251,654183,82307,571876,723576,96540
2020/03/18,Girona,Lleida,97,434930,50320,384610,771044,82592
2020/03/18,Girona,Barcelona,1905,5664579,761411,4903168,771044,82592
2020/03/18,Girona,Murcia,29,1493898,179475,1314423,771044,82592
2020/03/18,Girona,Castellón,18,579962,77664,502298,771044,82592
2020/03/18,Girona,Girona,49528,771044,77920,693124,771044,82592
2020/03/18,Girona,Melilla,16,86487,10226,76261,771044,82592
2020/03/18,Granada,Jaén,180,633564,41093,592471,914678,73691
2020/03/18,Granada,Córdoba,266,782979,85685,697294,914678,73691
2020/03/18,Granada,Málaga,151,1661785,167556,1494229,914678,73691
2020/03/18,Granada,Almería,266,716820,52176,664644,914678,73691
2020/03/18,Granada,Granada,51048,914678,74676,840002,914678,73691
2020/03/18,Guadalajara,Madrid,1877,6663394,858434,5804960,257762,33552
2020/03/18,Guadalajara,Cuenca,47,196329,16663,179666,257762,33552
2020/03/18,Guadalajara,Guadalajara,18192,257762,31690,226072,257762,33552
2020/03/18,Huelva,Sevilla,666,1942389,209578,1732811,521870,56540
2020/03/18,Huelva,Badajoz,297,673559,65887,607672,521870,56540
2020/03/18,Huelva,Huelva,38914,521870,54609,467261,521870,56540
2020/03/18,Huelva,Cádiz,469,1240155,117780,1122375,521870,56540
2020/03/18,Huesca,Huesca,14484,220461,22249,198212,220461,24137
2020/03/18,Huesca,Zaragoza,179,964724,130450,834274,220461,24137
2020/03/18,Huesca,Lleida,557,434930,50320,384610,220461,24137
2020/03/18,Jaén,Málaga,20,1661785,167556,1494229,633564,40242
2020/03/18,Jaén,Jaén,25718,633564,41093,592471,633564,40242
2020/03/18,Jaén,Granada,123,914678,74676,840002,633564,40242
2020/03/18,Jaén,Córdoba,679,782979,85685,697294,633564,40242
2020/03/18,Las Palmas de Gran Canaria,Las Palmas de Gran Canaria,130313,1120406,144508,975898,1120406,143320
2020/03/18,León,Palencia,35,160866,19289,141577,460001,55785
2020/03/18,León,Valladolid,34,519546,67789,451757,460001,55785
2020/03/18,León,Zamora,120,172539,18949,153590,460001,55785
2020/03/18,León,Asturias,40,1022800,122891,899909,460001,55785
2020/03/18,León,Ourense,350,307651,46130,261521,460001,55785
2020/03/18,León,León,40290,460001,56360,403641,460001,55785
2020/03/18,Lleida,Girona,114,771044,77920,693124,434930,48236
2020/03/18,Lleida,Lleida,30580,434930,50320,384610,434930,48236
2020/03/18,Lleida,Huesca,443,220461,22249,198212,434930,48236
2020/03/18,Lleida,Zaragoza,78,964724,130450,834274,434930,48236
2020/03/18,Lleida,Barcelona,218,5664579,761411,4903168,434930,48236
2020/03/18,Lugo,Coruña,442,1119596,167734,951862,329587,40123
2020/03/18,Lugo,Ourense,130,307651,46130,261521,329587,40123
2020/03/18,Lugo,Lugo,27837,329587,39351,290236,329587,40123
2020/03/18,Lugo,Asturias,648,1022800,122891,899909,329587,40123
2020/03/18,Madrid,Segovia,42,153129,18495,134634,6663394,864634
2020/03/18,Madrid,Cuenca,59,196329,16663,179666,6663394,864634
2020/03/18,Madrid,Ávila,74,157640,14457,143183,6663394,864634
2020/03/18,Madrid,Toledo,3502,694844,77165,617679,6663394,864634
2020/03/18,Madrid,Madrid,483816,6663394,858434,5804960,6663394,864634
2020/03/18,Madrid,Guadalajara,2276,257762,31690,226072,6663394,864634
2020/03/18,Málaga,Granada,207,914678,74676,840002,1661785,169157
2020/03/18,Málaga,Sevilla,225,1942389,209578,1732811,1661785,169157
2020/03/18,Málaga,Málaga,129380,1661785,167556,1494229,1661785,169157
2020/03/18,Málaga,Melilla,41,86487,10226,76261,1661785,169157
2020/03/18,Málaga,Cádiz,676,1240155,117780,1122375,1661785,169157
2020/03/18,Málaga,Córdoba,150,782979,85685,697294,1661785,169157
2020/03/18,Melilla,Melilla,9790,86487,10226,76261,86487,10142
2020/03/18,Murcia,Alicante,2659,1858683,248310,1610373,1493898,177858
2020/03/18,Murcia,Almería,1040,716820,52176,664644,1493898,177858
2020/03/18,Murcia,Albacete,341,388167,36903,351264,1493898,177858
2020/03/18,Murcia,Murcia,132201,1493898,179475,1314423,1493898,177858
2020/03/18,Navarra,Araba,20,331549,48154,283395,654183,83514
2020/03/18,Navarra,Zaragoza,547,964724,130450,834274,654183,83514
2020/03/18,Navarra,Navarra,55409,654183,82307,571876,654183,83514
2020/03/18,Navarra,Gipuzkoa,279,723576,93137,630439,654183,83514
2020/03/18,Navarra,Rioja,1767,316798,37457,279341,654183,83514
2020/03/18,Ourense,Zamora,21,172539,18949,153590,307651,46199
2020/03/18,Ourense,Pontevedra,173,942665,149213,793452,307651,46199
2020/03/18,Ourense,Lugo,226,329587,39351,290236,307651,46199
2020/03/18,Ourense,León,389,460001,56360,403641,307651,46199
2020/03/18,Ourense,Ourense,35280,307651,46130,261521,307651,46199
2020/03/18,Palencia,Cantabria,165,580795,78943,501852,160866,20068
2020/03/18,Palencia,Valladolid,51,519546,67789,451757,160866,20068
2020/03/18,Palencia,León,24,460001,56360,403641,160866,20068
2020/03/18,Palencia,Palencia,12796,160866,19289,141577,160866,20068
2020/03/18,Palencia,Burgos,209,357072,38835,318237,160866,20068
2020/03/18,Pontevedra,Pontevedra,116252,942665,149213,793452,942665,148132
2020/03/18,Pontevedra,Ourense,176,307651,46130,261521,942665,148132
2020/03/18,Pontevedra,Coruña,3798,1119596,167734,951862,942665,148132
2020/03/18,Rioja,Rioja,25862,316798,37457,279341,316798,35733
2020/03/18,Rioja,Araba,483,331549,48154,283395,316798,35733
2020/03/18,Rioja,Burgos,47,357072,38835,318237,316798,35733
2020/03/18,Rioja,Navarra,1575,654183,82307,571876,316798,35733
2020/03/18,Salamanca,Salamanca,30859,330119,40442,289677,330119,39949
2020/03/18,Salamanca,Ávila,225,157640,14457,143183,330119,39949
2020/03/18,Santa Cruz de Tenerife,Santa Cruz de Tenerife,112917,1032983,129512,903471,1032983,128765
2020/03/18,Segovia,Ávila,120,157640,14457,143183,153129,19321
2020/03/18,Segovia,Valladolid,178,519546,67789,451757,153129,19321
2020/03/18,Segovia,Burgos,70,357072,38835,318237,153129,19321
2020/03/18,Segovia,Segovia,12154,153129,18495,134634,153129,19321
2020/03/18,Sevilla,Cádiz,586,1240155,117780,1122375,1942389,207262
2020/03/18,Sevilla,Málaga,71,1661785,167556,1494229,1942389,207262
2020/03/18,Sevilla,Sevilla,133926,1942389,209578,1732811,1942389,207262
2020/03/18,Sevilla,Badajoz,47,673559,65887,607672,1942389,207262
2020/03/18,Sevilla,Córdoba,1582,782979,85685,697294,1942389,207262
2020/03/18,Sevilla,Huelva,379,521870,54609,467261,1942389,207262
2020/03/18,Soria,Soria,4974,88636,7295,81341,88636,7951
2020/03/18,Soria,Burgos,75,357072,38835,318237,88636,7951
2020/03/18,Soria,Valladolid,48,519546,67789,451757,88636,7951
2020/03/18,Soria,Zaragoza,163,964724,130450,834274,88636,7951
2020/03/18,Tarragona,Tarragona,55327,804664,87374,717290,804664,87213
2020/03/18,Tarragona,Barcelona,751,5664579,761411,4903168,804664,87213
2020/03/18,Tarragona,Teruel,34,134137,9016,125121,804664,87213
2020/03/18,Tarragona,Castellón,665,579962,77664,502298,804664,87213
2020/03/18,Teruel,Tarragona,47,804664,87374,717290,134137,10006
2020/03/18,Teruel,Teruel,4460,134137,9016,125121,134137,10006
2020/03/18,Teruel,Castellón,60,579962,77664,502298,134137,10006
2020/03/18,Toledo,Ávila,217,157640,14457,143183,694844,74727
2020/03/18,Toledo,Toledo,36337,694844,77165,617679,694844,74727
2020/03/18,Toledo,Cáceres,494,394151,35615,358536,694844,74727
2020/03/18,Toledo,Ciudad Real,249,495761,39916,455845,694844,74727
2020/03/18,Toledo,Cuenca,65,196329,16663,179666,694844,74727
2020/03/18,Toledo,Madrid,3010,6663394,858434,5804960,694844,74727
2020/03/18,Valencia,Albacete,271,388167,36903,351264,2565124,341662
2020/03/18,Valencia,Cuenca,66,196329,16663,179666,2565124,341662
2020/03/18,Valencia,Valencia,232167,2565124,350539,2214585,2565124,341662
2020/03/18,Valencia,Alicante,717,1858683,248310,1610373,2565124,341662
2020/03/18,Valencia,Castellón,563,579962,77664,502298,2565124,341662
2020/03/18,Valladolid,Soria,24,88636,7295,81341,519546,65413
2020/03/18,Valladolid,Zamora,75,172539,18949,153590,519546,65413
2020/03/18,Valladolid,Ávila,19,157640,14457,143183,519546,65413
2020/03/18,Valladolid,Segovia,268,153129,18495,134634,519546,65413
2020/03/18,Valladolid,León,29,460001,56360,403641,519546,65413
2020/03/18,Valladolid,Palencia,23,160866,19289,141577,519546,65413
2020/03/18,Valladolid,Burgos,125,357072,38835,318237,519546,65413
2020/03/18,Valladolid,Valladolid,46958,519546,67789,451757,519546,65413
2020/03/18,Zamora,Asturias,28,1022800,122891,899909,172539,18424
2020/03/18,Zamora,Zamora,12212,172539,18949,153590,172539,18424
2020/03/18,Zamora,Valladolid,42,519546,67789,451757,172539,18424
2020/03/18,Zamora,Salamanca,33,330119,40442,289677,172539,18424
2020/03/18,Zamora,Ourense,48,307651,46130,261521,172539,18424
2020/03/18,Zamora,León,30,460001,56360,403641,172539,18424
2020/03/18,Zaragoza,Soria,52,88636,7295,81341,964724,125051
2020/03/18,Zaragoza,Huesca,151,220461,22249,198212,964724,125051
2020/03/18,Zaragoza,Zaragoza,94526,964724,130450,834274,964724,125051
2020/03/18,Zaragoza,Teruel,147,134137,9016,125121,964724,125051
2020/03/18,Zaragoza,Navarra,444,654183,82307,571876,964724,125051
2020/03/18,Zaragoza,Lleida,152,434930,50320,384610,964724,125051
2020/03/20,Albacete,Albacete,21825,388167,33972,354195,388167,33404
2020/03/20,Albacete,Murcia,152,1493898,158659,1335239,388167,33404
2020/03/20,Albacete,Valencia,236,2565124,323614,2241510,388167,33404
2020/03/20,Albacete,Cuenca,411,196329,15378,180951,388167,33404
2020/03/20,Albacete,Alicante,129,1858683,222545,1636138,388167,33404
2020/03/20,Albacete,Ciudad Real,535,495761,34535,461226,388167,33404
2020/03/20,Albacete,Jaén,43,633564,38765,594799,388167,33404
2020/03/20,Alicante,Albacete,198,388167,33972,354195,1858683,225071
2020/03/20,Alicante,Murcia,2426,1493898,158659,1335239,1858683,225071
2020/03/20,Alicante,Alicante,170755,1858683,222545,1636138,1858683,225071
2020/03/20,Alicante,Valencia,893,2565124,323614,2241510,1858683,225071
2020/03/20,Almería,Murcia,1420,1493898,158659,1335239,716820,50862
2020/03/20,Almería,Málaga,16,1661785,158434,1503351,716820,50862
2020/03/20,Almería,Granada,233,914678,72879,841799,716820,50862
2020/03/20,Almería,Almería,36975,716820,49217,667603,716820,50862
2020/03/20,Araba,Navarra,59,654183,70909,583274,331549,43611
2020/03/20,Araba,Gipuzkoa,21,723576,71921,651655,331549,43611
2020/03/20,Araba,Bizkaia,728,1152934,158683,994251,331549,43611
2020/03/20,Araba,Araba,31714,331549,39544,292005,331549,43611
2020/03/20,Araba,Burgos,1186,357072,36920,320152,331549,43611
2020/03/20,Araba,Rioja,1096,316798,34849,281949,331549,43611
2020/03/20,Asturias,León,27,460001,54227,405774,1022800,115950
2020/03/20,Asturias,Lugo,759,329587,34717,294870,1022800,115950
2020/03/20,Asturias,Asturias,88430,1022800,115696,907104,1022800,115950
2020/03/20,Asturias,Cantabria,161,580795,75813,504982,1022800,115950
2020/03/20,Ávila,Ávila,8715,157640,13692,143948,157640,14101
2020/03/20,Ávila,Salamanca,315,330119,38639,291480,157640,14101
2020/03/20,Ávila,Toledo,179,694844,69494,625350,157640,14101
2020/03/20,Ávila,Cáceres,83,394151,30597,363554,157640,14101
2020/03/20,Ávila,Madrid,95,6663394,818891,5844503,157640,14101
2020/03/20,Ávila,Segovia,59,153129,17811,135318,157640,14101
2020/03/20,Badajoz,Sevilla,24,1942389,200872,1741517,673559,60642
2020/03/20,Badajoz,Ciudad Real,34,495761,34535,461226,673559,60642
2020/03/20,Badajoz,Cáceres,764,394151,30597,363554,673559,60642
2020/03/20,Badajoz,Badajoz,42802,673559,61723,611836,673559,60642
2020/03/20,Badajoz,Córdoba,33,782979,81603,701376,673559,60642
2020/03/20,Badajoz,Huelva,190,521870,52322,469548,673559,60642
2020/03/20,Balears,Valencia,91,2565124,323614,2241510,1149460,119318
2020/03/20,Balears,Balears,98017,1149460,118057,1031403,1149460,119318
2020/03/20,Balears,Barcelona,19,5664579,719354,4945225,1149460,119318
2020/03/20,Barcelona,Lleida,114,434930,48348,386582,5664579,719319
2020/03/20,Barcelona,Tarragona,960,804664,82697,721967,5664579,719319
2020/03/20,Barcelona,Barcelona,436366,5664579,719354,4945225,5664579,719319
2020/03/20,Barcelona,Girona,2126,771044,73315,697729,5664579,719319
2020/03/20,Bizkaia,Gipuzkoa,566,723576,71921,651655,1152934,157196
2020/03/20,Bizkaia,Bizkaia,118427,1152934,158683,994251,1152934,157196
2020/03/20,Bizkaia,Araba,486,331549,39544,292005,1152934,157196
2020/03/20,Bizkaia,Burgos,16,357072,36920,320152,1152934,157196
2020/03/20,Bizkaia,Cantabria,1533,580795,75813,504982,1152934,157196
2020/03/20,Burgos,Rioja,29,316798,34849,281949,357072,37348
2020/03/20,Burgos,Segovia,25,153129,17811,135318,357072,37348
2020/03/20,Burgos,Soria,44,88636,6770,81866,357072,37348
2020/03/20,Burgos,Araba,635,331549,39544,292005,357072,37348
2020/03/20,Burgos,Bizkaia,31,1152934,158683,994251,357072,37348
2020/03/20,Burgos,Burgos,26581,357072,36920,320152,357072,37348
2020/03/20,Burgos,Cantabria,24,580795,75813,504982,357072,37348
2020/03/20,Burgos,Palencia,146,160866,18496,142370,357072,37348
2020/03/20,Burgos,Valladolid,99,519546,63862,455684,357072,37348
2020/03/20,Cáceres,Cáceres,19117,394151,30597,363554,394151,30265
2020/03/20,Cáceres,Badajoz,841,673559,61723,611836,394151,30265
2020/03/20,Cáceres,Ávila,79,157640,13692,143948,394151,30265
2020/03/20,Cáceres,Toledo,166,694844,69494,625350,394151,30265
2020/03/20,Cádiz,Ceuta,17,84777,8028,76749,1240155,114232
2020/03/20,Cádiz,Málaga,778,1661785,158434,1503351,1240155,114232
2020/03/20,Cádiz,Huelva,612,521870,52322,469548,1240155,114232
2020/03/20,Cádiz,Cádiz,87187,1240155,112235,1127920,1240155,114232
2020/03/20,Cádiz,Sevilla,732,1942389,200872,1741517,1240155,114232
2020/03/20,Cantabria,Asturias,167,1022800,115696,907104,580795,72840
2020/03/20,Cantabria,Cantabria,54960,580795,75813,504982,580795,72840
2020/03/20,Cantabria,Bizkaia,355,1152934,158683,994251,580795,72840
2020/03/20,Cantabria,Palencia,33,160866,18496,142370,580795,72840
2020/03/20,Castellón,Tarragona,733,804664,82697,721967,579962,73603
2020/03/20,Castellón,Valencia,527,2565124,323614,2241510,579962,73603
2020/03/20,Castellón,Castellón,53893,579962,71678,508284,579962,73603
2020/03/20,Castellón,Teruel,51,134137,8439,125698,579962,73603
2020/03/20,Ceuta,Ceuta,7581,84777,8028,76749,84777,8088
2020/03/20,Ciudad Real,Badajoz,46,673559,61723,611836,495761,32772
2020/03/20,Ciudad Real,Toledo,125,694844,69494,625350,495761,32772
2020/03/20,Ciudad Real,Albacete,450,388167,33972,354195,495761,32772
2020/03/20,Ciudad Real,Córdoba,305,782979,81603,701376,495761,32772
2020/03/20,Ciudad Real,Ciudad Real,19522,495761,34535,461226,495761,32772
2020/03/20,Córdoba,Badajoz,49,673559,61723,611836,782979,79855
2020/03/20,Córdoba,Jaén,512,633564,38765,594799,782979,79855
2020/03/20,Córdoba,Málaga,217,1661785,158434,1503351,782979,79855
2020/03/20,Córdoba,Ciudad Real,212,495761,34535,461226,782979,79855
2020/03/20,Córdoba,Sevilla,1260,1942389,200872,1741517,782979,79855
2020/03/20,Córdoba,Granada,135,914678,72879,841799,782979,79855
2020/03/20,Córdoba,Córdoba,55268,782979,81603,701376,782979,79855
2020/03/20,Coruña,Lugo,412,329587,34717,294870,1119596,147796
2020/03/20,Coruña,Pontevedra,3970,942665,128673,813992,1119596,147796
2020/03/20,Coruña,Coruña,113230,1119596,146912,972684,1119596,147796
2020/03/20,Cuenca,Madrid,59,6663394,818891,5844503,196329,15339
2020/03/20,Cuenca,Albacete,512,388167,33972,354195,196329,15339
2020/03/20,Cuenca,Toledo,136,694844,69494,625350,196329,15339
2020/03/20,Cuenca,Ciudad Real,81,495761,34535,461226,196329,15339
2020/03/20,Cuenca,Cuenca,7270,196329,15378,180951,196329,15339
2020/03/20,Gipuzkoa,Araba,116,331549,39544,292005,723576,73669
2020/03/20,Gipuzkoa,Gipuzkoa,52385,723576,71921,651655,723576,73669
2020/03/20,Gipuzkoa,Bizkaia,743,1152934,158683,994251,723576,73669
2020/03/20,Gipuzkoa,Navarra,100,654183,70909,583274,723576,73669
2020/03/20,Girona,Barcelona,1800,5664579,719354,4945225,771044,76008
2020/03/20,Girona,Lleida,128,434930,48348,386582,771044,76008
2020/03/20,Girona,Girona,46927,771044,73315,697729,771044,76008
2020/03/20,Granada,Córdoba,267,782979,81603,701376,914678,72045
2020/03/20,Granada,Málaga,146,1661785,158434,1503351,914678,72045
2020/03/20,Granada,Almería,213,716820,49217,667603,914678,72045
2020/03/20,Granada,Jaén,211,633564,38765,594799,914678,72045
2020/03/20,Granada,Granada,51091,914678,72879,841799,914678,72045
2020/03/20,Guadalajara,Madrid,1808,6663394,818891,5844503,257762,29893
2020/03/20,Guadalajara,Guadalajara,16289,257762,28934,228828,257762,29893
2020/03/20,Huelva,Cádiz,426,1240155,112235,1127920,521870,53894
2020/03/20,Huelva,Badajoz,361,673559,61723,611836,521870,53894
2020/03/20,Huelva,Huelva,37357,521870,52322,469548,521870,53894
2020/03/20,Huelva,Sevilla,683,1942389,200872,1741517,521870,53894
2020/03/20,Huesca,Zaragoza,262,964724,125279,839445,220461,24265
2020/03/20,Huesca,Lleida,640,434930,48348,386582,220461,24265
2020/03/20,Huesca,Huesca,14399,220461,21997,198464,220461,24265
2020/03/20,Jaén,Córdoba,702,782979,81603,701376,633564,37744
2020/03/20,Jaén,Granada,226,914678,72879,841799,633564,37744
2020/03/20,Jaén,Jaén,23809,633564,38765,594799,633564,37744
2020/03/20,Las Palmas de Gran Canaria,Las Palmas de Gran Canaria,124352,1120406,138588,981818,1120406,137736
2020/03/20,León,Ourense,228,307651,41298,266353,460001,53764
2020/03/20,León,Valladolid,32,519546,63862,455684,460001,53764
2020/03/20,León,León,38953,460001,54227,405774,460001,53764
2020/03/20,León,Asturias,46,1022800,115696,907104,460001,53764
2020/03/20,León,Zamora,132,172539,18179,154360,460001,53764
2020/03/20,León,Palencia,33,160866,18496,142370,460001,53764
2020/03/20,Lleida,Girona,96,771044,73315,697729,434930,46100
2020/03/20,Lleida,Huesca,463,220461,21997,198464,434930,46100
2020/03/20,Lleida,Lleida,29176,434930,48348,386582,434930,46100
2020/03/20,Lleida,Barcelona,174,5664579,719354,4945225,434930,46100
2020/03/20,Lleida,Zaragoza,75,964724,125279,839445,434930,46100
2020/03/20,Lugo,Ourense,61,307651,41298,266353,329587,35370
2020/03/20,Lugo,Asturias,583,1022800,115696,907104,329587,35370
2020/03/20,Lugo,Lugo,24347,329587,34717,294870,329587,35370
2020/03/20,Lugo,Coruña,503,1119596,146912,972684,329587,35370
2020/03/20,Madrid,Toledo,3139,694844,69494,625350,6663394,825006
2020/03/20,Madrid,Guadalajara,2074,257762,28934,228828,6663394,825006
2020/03/20,Madrid,Cuenca,77,196329,15378,180951,6663394,825006
2020/03/20,Madrid,Valencia,26,2565124,323614,2241510,6663394,825006
2020/03/20,Madrid,Segovia,36,153129,17811,135318,6663394,825006
2020/03/20,Madrid,Madrid,465353,6663394,818891,5844503,6663394,825006
2020/03/20,Madrid,Ávila,155,157640,13692,143948,6663394,825006
2020/03/20,Málaga,Murcia,18,1493898,158659,1335239,1661785,160030
2020/03/20,Málaga,Cádiz,648,1240155,112235,1127920,1661785,160030
2020/03/20,Málaga,Sevilla,269,1942389,200872,1741517,1661785,160030
2020/03/20,Málaga,Córdoba,251,782979,81603,701376,1661785,160030
2020/03/20,Málaga,Málaga,121825,1661785,158434,1503351,1661785,160030
2020/03/20,Málaga,Melilla,16,86487,9896,76591,1661785,160030
2020/03/20,Málaga,Granada,124,914678,72879,841799,1661785,160030
2020/03/20,Málaga,Alicante,23,1858683,222545,1636138,1661785,160030
2020/03/20,Melilla,Melilla,9490,86487,9896,76591,86487,9799
2020/03/20,Murcia,Murcia,115724,1493898,158659,1335239,1493898,158854
2020/03/20,Murcia,Albacete,179,388167,33972,354195,1493898,158854
2020/03/20,Murcia,Alicante,2310,1858683,222545,1636138,1493898,158854
2020/03/20,Murcia,Almería,941,716820,49217,667603,1493898,158854
2020/03/20,Navarra,Gipuzkoa,215,723576,71921,651655,654183,71499
2020/03/20,Navarra,Navarra,47518,654183,70909,583274,654183,71499
2020/03/20,Navarra,Rioja,1335,316798,34849,281949,654183,71499
2020/03/20,Navarra,Zaragoza,520,964724,125279,839445,654183,71499
2020/03/20,Ourense,León,249,460001,54227,405774,307651,40892
2020/03/20,Ourense,Pontevedra,125,942665,128673,813992,307651,40892
2020/03/20,Ourense,Ourense,32101,307651,41298,266353,307651,40892
2020/03/20,Ourense,Lugo,179,329587,34717,294870,307651,40892
2020/03/20,Palencia,Burgos,234,357072,36920,320152,160866,19510
2020/03/20,Palencia,Cantabria,128,580795,75813,504982,160866,19510
2020/03/20,Palencia,Palencia,12707,160866,18496,142370,160866,19510
2020/03/20,Palencia,Valladolid,83,519546,63862,455684,160866,19510
2020/03/20,Pontevedra,Pontevedra,100195,942665,128673,813992,942665,128128
2020/03/20,Pontevedra,Ourense,182,307651,41298,266353,942665,128128
2020/03/20,Pontevedra,Coruña,3279,1119596,146912,972684,942665,128128
2020/03/20,Rioja,Rioja,24783,316798,34849,281949,316798,33813
2020/03/20,Rioja,Araba,455,331549,39544,292005,316798,33813
2020/03/20,Rioja,Burgos,54,357072,36920,320152,316798,33813
2020/03/20,Rioja,Navarra,1349,654183,70909,583274,316798,33813
2020/03/20,Salamanca,Ávila,142,157640,13692,143948,330119,38116
2020/03/20,Salamanca,Salamanca,29407,330119,38639,291480,330119,38116
2020/03/20,Salamanca,Zamora,32,172539,18179,154360,330119,38116
2020/03/20,Santa Cruz de Tenerife,Santa Cruz de Tenerife,108824,1032983,124775,908208,1032983,124492
2020/03/20,Santa Cruz de Tenerife,Barcelona,23,5664579,719354,4945225,1032983,124492
2020/03/20,Santa Cruz de Tenerife,Las Palmas de Gran Canaria,90,1120406,138588,981818,1032983,124492
2020/03/20,Segovia,Segovia,11912,153129,17811,135318,153129,18823
2020/03/20,Segovia,Valladolid,283,519546,63862,455684,153129,18823
2020/03/20,Segovia,Ávila,124,157640,13692,143948,153129,18823
2020/03/20,Segovia,Burgos,121,357072,36920,320152,153129,18823
2020/03/20,Sevilla,Cádiz,621,1240155,112235,1127920,1942389,199088
2020/03/20,Sevilla,Sevilla,128616,1942389,200872,1741517,1942389,199088
2020/03/20,Sevilla,Córdoba,1534,782979,81603,701376,1942389,199088
2020/03/20,Sevilla,Málaga,75,1661785,158434,1503351,1942389,199088
2020/03/20,Sevilla,Huelva,323,521870,52322,469548,1942389,199088
2020/03/20,Soria,Burgos,69,357072,36920,320152,88636,7424
2020/03/20,Soria,Zaragoza,105,964724,125279,839445,88636,7424
2020/03/20,Soria,Valladolid,63,519546,63862,455684,88636,7424
2020/03/20,Soria,Soria,4653,88636,6770,81866,88636,7424
2020/03/20,Soria,Segovia,25,153129,17811,135318,88636,7424
2020/03/20,Tarragona,Zaragoza,46,964724,125279,839445,804664,82237
2020/03/20,Tarragona,Teruel,31,134137,8439,125698,804664,82237
2020/03/20,Tarragona,Tarragona,52064,804664,82697,721967,804664,82237
2020/03/20,Tarragona,Barcelona,820,5664579,719354,4945225,804664,82237
2020/03/20,Tarragona,Castellón,578,579962,71678,508284,804664,82237
2020/03/20,Teruel,Castellón,32,579962,71678,508284,134137,9357
2020/03/20,Teruel,Zaragoza,34,964724,125279,839445,134137,9357
2020/03/20,Teruel,Tarragona,53,804664,82697,721967,134137,9357
2020/03/20,Teruel,Teruel,4361,134137,8439,125698,134137,9357
2020/03/20,Toledo,Cáceres,203,394151,30597,363554,694844,66618
2020/03/20,Toledo,Cuenca,66,196329,15378,180951,694844,66618
2020/03/20,Toledo,Madrid,2834,6663394,818891,5844503,694844,66618
2020/03/20,Toledo,Ciudad Real,168,495761,34535,461226,694844,66618
2020/03/20,Toledo,Toledo,31992,694844,69494,625350,694844,66618
2020/03/20,Toledo,Ávila,150,157640,13692,143948,694844,66618
2020/03/20,Valencia,Valencia,216173,2565124,323614,2241510,2565124,317336
2020/03/20,Valencia,Castellón,508,579962,71678,508284,2565124,317336
2020/03/20,Valencia,Albacete,286,388167,33972,354195,2565124,317336
2020/03/20,Valencia,Alicante,834,1858683,222545,1636138,2565124,317336
2020/03/20,Valencia,Cuenca,87,196329,15378,180951,2565124,317336
2020/03/20,Valladolid,Ávila,24,157640,13692,143948,519546,61507
2020/03/20,Valladolid,Burgos,110,357072,36920,320152,519546,61507
2020/03/20,Valladolid,Segovia,249,153129,17811,135318,519546,61507
2020/03/20,Valladolid,Zamora,98,172539,18179,154360,519546,61507
2020/03/20,Valladolid,Valladolid,43711,519546,63862,455684,519546,61507
2020/03/20,Valladolid,León,32,460001,54227,405774,519546,61507
2020/03/20,Zamora,Zamora,12132,172539,18179,154360,172539,18026
2020/03/20,Zamora,León,56,460001,54227,405774,172539,18026
2020/03/20,Zamora,Valladolid,47,519546,63862,455684,172539,18026
2020/03/20,Zaragoza,Soria,24,88636,6770,81866,964724,120101
2020/03/20,Zaragoza,Navarra,328,654183,70909,583274,964724,120101
2020/03/20,Zaragoza,Lleida,159,434930,48348,386582,964724,120101
2020/03/20,Zaragoza,Huesca,211,220461,21997,198464,964724,120101
2020/03/20,Zaragoza,Teruel,149,134137,8439,125698,964724,120101
2020/03/20,Zaragoza,Zaragoza,91093,964724,125279,839445,964724,120101
2020/03/22,Albacete,Valencia,217,2565124,164661,2400463,388167,17714
2020/03/22,Albacete,Albacete,12423,388167,17451,370716,388167,17714
2020/03/22,Albacete,Ciudad Real,281,495761,15540,480221,388167,17714
2020/03/22,Albacete,Cuenca,115,196329,5934,190395,388167,17714
2020/03/22,Albacete,Alicante,105,1858683,114193,1744490,388167,17714
2020/03/22,Albacete,Jaén,20,633564,28956,604608,388167,17714
2020/03/22,Albacete,Murcia,42,1493898,76641,1417257,388167,17714
2020/03/22,Alicante,Albacete,83,388167,17451,370716,1858683,113027
2020/03/22,Alicante,Alicante,96089,1858683,114193,1744490,1858683,113027
2020/03/22,Alicante,Murcia,1127,1493898,76641,1417257,1858683,113027
2020/03/22,Alicante,Valencia,434,2565124,164661,2400463,1858683,113027
2020/03/22,Almería,Granada,291,914678,56680,857998,716820,28923
2020/03/22,Almería,Almería,22567,716820,30020,686800,716820,28923
2020/03/22,Almería,Murcia,264,1493898,76641,1417257,716820,28923
2020/03/22,Araba,Burgos,416,357072,14986,342086,331549,22147
2020/03/22,Araba,Araba,17963,331549,21424,310125,331549,22147
2020/03/22,Araba,Bizkaia,294,1152934,90207,1062727,331549,22147
2020/03/22,Araba,Barcelona,31,5664579,373274,5291305,331549,22147
2020/03/22,Araba,Rioja,282,316798,15801,300997,331549,22147
2020/03/22,Asturias,Lugo,424,329587,17136,312451,1022800,57822
2020/03/22,Asturias,León,23,460001,27230,432771,1022800,57822
2020/03/22,Asturias,Cantabria,123,580795,35310,545485,1022800,57822
2020/03/22,Asturias,Asturias,45266,1022800,57649,965151,1022800,57822
2020/03/22,Ávila,Salamanca,126,330119,20486,309633,157640,7229
2020/03/22,Ávila,Segovia,51,153129,8107,145022,157640,7229
2020/03/22,Ávila,Cáceres,32,394151,15957,378194,157640,7229
2020/03/22,Ávila,Toledo,72,694844,30259,664585,157640,7229
2020/03/22,Ávila,Madrid,48,6663394,432831,6230563,157640,7229
2020/03/22,Ávila,Ávila,4786,157640,7136,150504,157640,7229
2020/03/22,Badajoz,Badajoz,23673,673559,33003,640556,673559,32664
2020/03/22,Badajoz,Cáceres,428,394151,15957,378194,673559,32664
2020/03/22,Badajoz,Huelva,124,521870,28745,493125,673559,32664
2020/03/22,Badajoz,Córdoba,49,782979,44654,738325,673559,32664
2020/03/22,Balears,Balears,37098,1149460,47826,1101634,1149460,48317
2020/03/22,Balears,Tarragona,46,804664,39707,764957,1149460,48317
2020/03/22,Barcelona,Tarragona,404,804664,39707,764957,5664579,375013
2020/03/22,Barcelona,Lleida,33,434930,22447,412483,5664579,375013
2020/03/22,Barcelona,Girona,948,771044,32057,738987,5664579,375013
2020/03/22,Barcelona,Barcelona,275241,5664579,373274,5291305,5664579,375013
2020/03/22,Bizkaia,Gipuzkoa,179,723576,34899,688677,1152934,89946
2020/03/22,Bizkaia,Bizkaia,72858,1152934,90207,1062727,1152934,89946
2020/03/22,Bizkaia,Cantabria,277,580795,35310,545485,1152934,89946
2020/03/22,Bizkaia,Araba,306,331549,21424,310125,1152934,89946
2020/03/22,Burgos,Araba,391,331549,21424,310125,357072,15269
2020/03/22,Burgos,Valladolid,85,519546,30252,489294,357072,15269
2020/03/22,Burgos,Palencia,107,160866,9017,151849,357072,15269
2020/03/22,Burgos,Burgos,10809,357072,14986,342086,357072,15269
2020/03/22,Cáceres,Cáceres,9712,394151,15957,378194,394151,15775
2020/03/22,Cáceres,Toledo,36,694844,30259,664585,394151,15775
2020/03/22,Cáceres,Badajoz,485,673559,33003,640556,394151,15775
2020/03/22,Cáceres,Ávila,58,157640,7136,150504,394151,15775
2020/03/22,Cáceres,Salamanca,33,330119,20486,309633,394151,15775
2020/03/22,Cádiz,Sevilla,467,1942389,105719,1836670,1240155,68049
2020/03/22,Cádiz,Huelva,420,521870,28745,493125,1240155,68049
2020/03/22,Cádiz,Málaga,302,1661785,77269,1584516,1240155,68049
2020/03/22,Cádiz,Cádiz,53897,1240155,67198,1172957,1240155,68049
2020/03/22,Cantabria,Asturias,79,1022800,57649,965151,580795,35008
2020/03/22,Cantabria,Cantabria,27120,580795,35310,545485,580795,35008
2020/03/22,Cantabria,Bizkaia,219,1152934,90207,1062727,580795,35008
2020/03/22,Cantabria,Palencia,23,160866,9017,151849,580795,35008
2020/03/22,Castellón,Castellón,22503,579962,30052,549910,579962,30672
2020/03/22,Castellón,Valencia,444,2565124,164661,2400463,579962,30672
2020/03/22,Castellón,Alicante,39,1858683,114193,1744490,579962,30672
2020/03/22,Castellón,Tarragona,405,804664,39707,764957,579962,30672
2020/03/22,Ceuta,Cádiz,23,1240155,67198,1172957,84777,4777
2020/03/22,Ceuta,Ceuta,4413,84777,4875,79902,84777,4777
2020/03/22,Ciudad Real,Albacete,334,388167,17451,370716,495761,15374
2020/03/22,Ciudad Real,Jaén,20,633564,28956,604608,495761,15374
2020/03/22,Ciudad Real,Badajoz,47,673559,33003,640556,495761,15374
2020/03/22,Ciudad Real,Córdoba,274,782979,44654,738325,495761,15374
2020/03/22,Ciudad Real,Ciudad Real,9159,495761,15540,480221,495761,15374
2020/03/22,Córdoba,Málaga,43,1661785,77269,1584516,782979,44362
2020/03/22,Córdoba,Córdoba,32115,782979,44654,738325,782979,44362
2020/03/22,Córdoba,Jaén,471,633564,28956,604608,782979,44362
2020/03/22,Córdoba,Sevilla,605,1942389,105719,1836670,782979,44362
2020/03/22,Córdoba,Ciudad Real,184,495761,15540,480221,782979,44362
2020/03/22,Córdoba,Granada,96,914678,56680,857998,782979,44362
2020/03/22,Coruña,Coruña,56019,1119596,71742,1047854,1119596,71724
2020/03/22,Coruña,Lugo,192,329587,17136,312451,1119596,71724
2020/03/22,Coruña,Pontevedra,2415,942665,62612,880053,1119596,71724
2020/03/22,Cuenca,Valencia,135,2565124,164661,2400463,196329,6022
2020/03/22,Cuenca,Cuenca,3036,196329,5934,190395,196329,6022
2020/03/22,Cuenca,Albacete,120,388167,17451,370716,196329,6022
2020/03/22,Cuenca,Madrid,27,6663394,432831,6230563,196329,6022
2020/03/22,Gipuzkoa,Navarra,56,654183,35889,618294,723576,35731
2020/03/22,Gipuzkoa,Bizkaia,208,1152934,90207,1062727,723576,35731
2020/03/22,Gipuzkoa,Gipuzkoa,27321,723576,34899,688677,723576,35731
2020/03/22,Girona,Lleida,72,434930,22447,412483,771044,33311
2020/03/22,Girona,Alicante,22,1858683,114193,1744490,771044,33311
2020/03/22,Girona,Girona,21276,771044,32057,738987,771044,33311
2020/03/22,Girona,Barcelona,909,5664579,373274,5291305,771044,33311
2020/03/22,Granada,Almería,178,716820,30020,686800,914678,55519
2020/03/22,Granada,Jaén,135,633564,28956,604608,914678,55519
2020/03/22,Granada,Córdoba,62,782979,44654,738325,914678,55519
2020/03/22,Granada,Málaga,53,1661785,77269,1584516,914678,55519
2020/03/22,Granada,Granada,42816,914678,56680,857998,914678,55519
2020/03/22,Guadalajara,Guadalajara,8049,257762,12805,244957,257762,12504
2020/03/22,Guadalajara,Cuenca,20,196329,5934,190395,257762,12504
2020/03/22,Guadalajara,Madrid,571,6663394,432831,6230563,257762,12504
2020/03/22,Huelva,Cádiz,348,1240155,67198,1172957,521870,28050
2020/03/22,Huelva,Sevilla,288,1942389,105719,1836670,521870,28050
2020/03/22,Huelva,Huelva,20055,521870,28745,493125,521870,28050
2020/03/22,Huelva,Badajoz,158,673559,33003,640556,521870,28050
2020/03/22,Huesca,Huesca,6069,220461,9344,211117,220461,9433
2020/03/22,Huesca,Lleida,217,434930,22447,412483,220461,9433
2020/03/22,Jaén,Córdoba,323,782979,44654,738325,633564,28180
2020/03/22,Jaén,Jaén,20844,633564,28956,604608,633564,28180
2020/03/22,Jaén,Alicante,25,1858683,114193,1744490,633564,28180
2020/03/22,Jaén,Granada,140,914678,56680,857998,633564,28180
2020/03/22,Las Palmas de Gran Canaria,Las Palmas de Gran Canaria,51797,1120406,64577,1055829,1120406,64042
2020/03/22,León,León,19604,460001,27230,432771,460001,27000
2020/03/22,León,Ourense,68,307651,21141,286510,460001,27000
2020/03/22,León,Asturias,26,1022800,57649,965151,460001,27000
2020/03/22,Lleida,Lleida,14678,434930,22447,412483,434930,22133
2020/03/22,Lleida,Huesca,164,220461,9344,211117,434930,22133
2020/03/22,Lleida,Girona,52,771044,32057,738987,434930,22133
2020/03/22,Lleida,Zaragoza,55,964724,61078,903646,434930,22133
2020/03/22,Lleida,Barcelona,25,5664579,373274,5291305,434930,22133
2020/03/22,Lugo,Lugo,12083,329587,17136,312451,329587,16966
2020/03/22,Lugo,Coruña,148,1119596,71742,1047854,329587,16966
2020/03/22,Lugo,Ourense,74,307651,21141,286510,329587,16966
2020/03/22,Lugo,Asturias,301,1022800,57649,965151,329587,16966
2020/03/22,Madrid,Cuenca,30,196329,5934,190395,6663394,437536
2020/03/22,Madrid,Ávila,16,157640,7136,150504,6663394,437536
2020/03/22,Madrid,Toledo,1487,694844,30259,664585,6663394,437536
2020/03/22,Madrid,Madrid,307065,6663394,432831,6230563,6663394,437536
2020/03/22,Madrid,Guadalajara,758,257762,12805,244957,6663394,437536
2020/03/22,Málaga,Granada,49,914678,56680,857998,1661785,77495
2020/03/22,Málaga,Málaga,59649,1661785,77269,1584516,1661785,77495
2020/03/22,Málaga,Sevilla,47,1942389,105719,1836670,1661785,77495
2020/03/22,Málaga,Córdoba,63,782979,44654,738325,1661785,77495
2020/03/22,Málaga,Cádiz,271,1240155,67198,1172957,1661785,77495
2020/03/22,Melilla,Almería,16,716820,30020,686800,86487,6567
2020/03/22,Melilla,Melilla,6343,86487,6572,79915,86487,6567
2020/03/22,Murcia,Almería,616,716820,30020,686800,1493898,76124
2020/03/22,Murcia,Barcelona,31,5664579,373274,5291305,1493898,76124
2020/03/22,Murcia,Albacete,42,388167,17451,370716,1493898,76124
2020/03/22,Murcia,Alicante,1110,1858683,114193,1744490,1493898,76124
2020/03/22,Murcia,Murcia,58508,1493898,76641,1417257,1493898,76124
2020/03/22,Navarra,Alicante,22,1858683,114193,1744490,654183,36374
2020/03/22,Navarra,Zaragoza,255,964724,61078,903646,654183,36374
2020/03/22,Navarra,Gipuzkoa,118,723576,34899,688677,654183,36374
2020/03/22,Navarra,Barcelona,31,5664579,373274,5291305,654183,36374
2020/03/22,Navarra,Navarra,26129,654183,35889,618294,654183,36374
2020/03/22,Navarra,Rioja,448,316798,15801,300997,654183,36374
2020/03/22,Ourense,Ourense,16671,307651,21141,286510,307651,20935
2020/03/22,Ourense,León,53,460001,27230,432771,307651,20935
2020/03/22,Ourense,Lugo,87,329587,17136,312451,307651,20935
2020/03/22,Ourense,Pontevedra,127,942665,62612,880053,307651,20935
2020/03/22,Palencia,Cantabria,27,580795,35310,545485,160866,9207
2020/03/22,Palencia,Valladolid,30,519546,30252,489294,160866,9207
2020/03/22,Palencia,Palencia,6454,160866,9017,151849,160866,9207
2020/03/22,Palencia,Burgos,103,357072,14986,342086,160866,9207
2020/03/22,Pontevedra,Ourense,142,307651,21141,286510,942665,61945
2020/03/22,Pontevedra,Pontevedra,49537,942665,62612,880053,942665,61945
2020/03/22,Pontevedra,Coruña,2215,1119596,71742,1047854,942665,61945
2020/03/22,Rioja,Araba,217,331549,21424,310125,316798,15688
2020/03/22,Rioja,Navarra,456,654183,35889,618294,316798,15688
2020/03/22,Rioja,Rioja,11808,316798,15801,300997,316798,15688
2020/03/22,Salamanca,Salamanca,15642,330119,20486,309633,330119,20631
2020/03/22,Salamanca,Ávila,114,157640,7136,150504,330119,20631
2020/03/22,Santa Cruz de Tenerife,Santa Cruz de Tenerife,48100,1032983,59403,973580,1032983,59217
2020/03/22,Segovia,Segovia,5347,153129,8107,145022,153129,8102
2020/03/22,Segovia,Valladolid,56,519546,30252,489294,153129,8102
2020/03/22,Segovia,Ávila,51,157640,7136,150504,153129,8102
2020/03/22,Sevilla,Huelva,179,521870,28745,493125,1942389,105581
2020/03/22,Sevilla,Málaga,34,1661785,77269,1584516,1942389,105581
2020/03/22,Sevilla,Sevilla,76030,1942389,105719,1836670,1942389,105581
2020/03/22,Sevilla,Córdoba,611,782979,44654,738325,1942389,105581
2020/03/22,Sevilla,Cádiz,473,1240155,67198,1172957,1942389,105581
2020/03/22,Soria,Soria,1928,88636,2808,85828,88636,2875
2020/03/22,Soria,Valladolid,20,519546,30252,489294,88636,2875
2020/03/22,Tarragona,Tarragona,25995,804664,39707,764957,804664,39215
2020/03/22,Tarragona,Castellón,257,579962,30052,549910,804664,39215
2020/03/22,Tarragona,Barcelona,446,5664579,373274,5291305,804664,39215
2020/03/22,Teruel,Tarragona,39,804664,39707,764957,134137,2702
2020/03/22,Teruel,Teruel,1143,134137,2614,131523,134137,2702
2020/03/22,Toledo,Ávila,89,157640,7136,150504,694844,30274
2020/03/22,Toledo,Toledo,16556,694844,30259,664585,694844,30274
2020/03/22,Toledo,Madrid,1534,6663394,432831,6230563,694844,30274
2020/03/22,Toledo,Cáceres,135,394151,15957,378194,694844,30274
2020/03/22,Valencia,Alicante,417,1858683,114193,1744490,2565124,162518
2020/03/22,Valencia,Albacete,155,388167,17451,370716,2565124,162518
2020/03/22,Valencia,Cuenca,28,196329,5934,190395,2565124,162518
2020/03/22,Valencia,Valencia,121019,2565124,164661,2400463,2565124,162518
2020/03/22,Valencia,Castellón,213,579962,30052,549910,2565124,162518
2020/03/22,Valladolid,Zamora,32,172539,8939,163600,519546,29994
2020/03/22,Valladolid,León,30,460001,27230,432771,519546,29994
2020/03/22,Valladolid,Valladolid,21853,519546,30252,489294,519546,29994
2020/03/22,Valladolid,Soria,22,88636,2808,85828,519546,29994
2020/03/22,Valladolid,Segovia,42,153129,8107,145022,519546,29994
2020/03/22,Valladolid,Burgos,57,357072,14986,342086,519546,29994
2020/03/22,Zamora,Zamora,6300,172539,8939,163600,172539,8905
2020/03/22,Zamora,Salamanca,23,330119,20486,309633,172539,8905
2020/03/22,Zaragoza,Lleida,53,434930,22447,412483,964724,60528
2020/03/22,Zaragoza,Navarra,187,654183,35889,618294,964724,60528
2020/03/22,Zaragoza,Zaragoza,47220,964724,61078,903646,964724,60528
2020/03/24,Albacete,Murcia,83,1493898,157742,1336156,388167,34555
2020/03/24,Albacete,Jaén,19,633564,50212,583352,388167,34555
2020/03/24,Albacete,Valencia,364,2565124,316519,2248605,388167,34555
2020/03/24,Albacete,Cuenca,370,196329,14362,181967,388167,34555
2020/03/24,Albacete,Alicante,226,1858683,201957,1656726,388167,34555
2020/03/24,Albacete,Ciudad Real,483,495761,33659,462102,388167,34555
2020/03/24,Albacete,Albacete,23718,388167,35030,353137,388167,34555
2020/03/24,Alicante,Alicante,156424,1858683,201957,1656726,1858683,202262
2020/03/24,Alicante,Murcia,1731,1493898,157742,1336156,1858683,202262
2020/03/24,Alicante,Valencia,961,2565124,316519,2248605,1858683,202262
2020/03/24,Alicante,Albacete,192,388167,35030,353137,1858683,202262
2020/03/24,Almería,Murcia,580,1493898,157742,1336156,716820,64124
2020/03/24,Almería,Almería,52124,716820,64397,652423,716820,64124
2020/03/24,Almería,Granada,593,914678,93355,821323,716820,64124
2020/03/24,Araba,Bizkaia,1035,1152934,172056,980878,331549,50300
2020/03/24,Araba,Araba,35961,331549,44158,287391,331549,50300
2020/03/24,Araba,Burgos,1420,357072,35819,321253,331549,50300
2020/03/24,Araba,Gipuzkoa,78,723576,82440,641136,331549,50300
2020/03/24,Araba,Rioja,1515,316798,37088,279710,331549,50300
2020/03/24,Araba,Navarra,93,654183,79339,574844,331549,50300
2020/03/24,Asturias,Asturias,89301,1022800,114338,908462,1022800,113898
2020/03/24,Asturias,Lugo,712,329587,34400,295187,1022800,113898
2020/03/24,Asturias,Cantabria,174,580795,69308,511487,1022800,113898
2020/03/24,Ávila,Ávila,8356,157640,13019,144621,157640,13426
2020/03/24,Ávila,Madrid,66,6663394,766816,5896578,157640,13426
2020/03/24,Ávila,Salamanca,263,330119,36947,293172,157640,13426
2020/03/24,Ávila,Toledo,164,694844,68946,625898,157640,13426
2020/03/24,Ávila,Cáceres,51,394151,29669,364482,157640,13426
2020/03/24,Ávila,Segovia,90,153129,16034,137095,157640,13426
2020/03/24,Badajoz,Ciudad Real,47,495761,33659,462102,673559,64748
2020/03/24,Badajoz,Córdoba,62,782979,84440,698539,673559,64748
2020/03/24,Badajoz,Cáceres,716,394151,29669,364482,673559,64748
2020/03/24,Badajoz,Sevilla,31,1942389,223902,1718487,673559,64748
2020/03/24,Badajoz,Badajoz,46148,673559,65487,608072,673559,64748
2020/03/24,Badajoz,Huelva,235,521870,57817,464053,673559,64748
2020/03/24,Balears,Barcelona,19,5664579,709916,4954663,1149460,111499
2020/03/24,Balears,Balears,91706,1149460,110469,1038991,1149460,111499
2020/03/24,Balears,Valencia,25,2565124,316519,2248605,1149460,111499
2020/03/24,Barcelona,Girona,1959,771044,68562,702482,5664579,711704
2020/03/24,Barcelona,Barcelona,448966,5664579,709916,4954663,5664579,711704
2020/03/24,Barcelona,Alicante,21,1858683,201957,1656726,5664579,711704
2020/03/24,Barcelona,Lleida,43,434930,48269,386661,5664579,711704
2020/03/24,Barcelona,Tarragona,917,804664,79378,725286,5664579,711704
2020/03/24,Bizkaia,Cantabria,1536,580795,69308,511487,1152934,168704
2020/03/24,Bizkaia,Bizkaia,127317,1152934,172056,980878,1152934,168704
2020/03/24,Bizkaia,Araba,568,331549,44158,287391,1152934,168704
2020/03/24,Bizkaia,Gipuzkoa,868,723576,82440,641136,1152934,168704
2020/03/24,Bizkaia,Burgos,40,357072,35819,321253,1152934,168704
2020/03/24,Burgos,Burgos,25384,357072,35819,321253,357072,36227
2020/03/24,Burgos,Bizkaia,67,1152934,172056,980878,357072,36227
2020/03/24,Burgos,Valladolid,80,519546,62830,456716,357072,36227
2020/03/24,Burgos,Soria,50,88636,6448,82188,357072,36227
2020/03/24,Burgos,Rioja,73,316798,37088,279710,357072,36227
2020/03/24,Burgos,Palencia,184,160866,18060,142806,357072,36227
2020/03/24,Burgos,Araba,723,331549,44158,287391,357072,36227
2020/03/24,Cáceres,Toledo,197,694844,68946,625898,394151,29498
2020/03/24,Cáceres,Cáceres,18235,394151,29669,364482,394151,29498
2020/03/24,Cáceres,Badajoz,850,673559,65487,608072,394151,29498
2020/03/24,Cáceres,Ávila,67,157640,13019,144621,394151,29498
2020/03/24,Cádiz,Huelva,552,521870,57817,464053,1240155,126962
2020/03/24,Cádiz,Málaga,841,1661785,156109,1505676,1240155,126962
2020/03/24,Cádiz,Ceuta,18,84777,8331,76446,1240155,126962
2020/03/24,Cádiz,Cádiz,100274,1240155,124847,1115308,1240155,126962
2020/03/24,Cádiz,Sevilla,587,1942389,223902,1718487,1240155,126962
2020/03/24,Cantabria,Cantabria,49631,580795,69308,511487,580795,66287
2020/03/24,Cantabria,Bizkaia,384,1152934,172056,980878,580795,66287
2020/03/24,Cantabria,Palencia,65,160866,18060,142806,580795,66287
2020/03/24,Cantabria,Asturias,135,1022800,114338,908462,580795,66287
2020/03/24,Castellón,Alicante,16,1858683,201957,1656726,579962,74232
2020/03/24,Castellón,Teruel,24,134137,7413,126724,579962,74232
2020/03/24,Castellón,Tarragona,703,804664,79378,725286,579962,74232
2020/03/24,Castellón,Castellón,54791,579962,70014,509948,579962,74232
2020/03/24,Castellón,Valencia,976,2565124,316519,2248605,579962,74232
2020/03/24,Ceuta,Ceuta,7881,84777,8331,76446,84777,8330
2020/03/24,Ciudad Real,Albacete,391,388167,35030,353137,495761,32003
2020/03/24,Ciudad Real,Ciudad Real,19279,495761,33659,462102,495761,32003
2020/03/24,Ciudad Real,Jaén,16,633564,50212,583352,495761,32003
2020/03/24,Ciudad Real,Toledo,122,694844,68946,625898,495761,32003
2020/03/24,Ciudad Real,Córdoba,417,782979,84440,698539,495761,32003
2020/03/24,Ciudad Real,Badajoz,33,673559,65487,608072,495761,32003
2020/03/24,Córdoba,Sevilla,1303,1942389,223902,1718487,782979,83669
2020/03/24,Córdoba,Badajoz,52,673559,65487,608072,782979,83669
2020/03/24,Córdoba,Málaga,146,1661785,156109,1505676,782979,83669
2020/03/24,Córdoba,Ciudad Real,257,495761,33659,462102,782979,83669
2020/03/24,Córdoba,Jaén,672,633564,50212,583352,782979,83669
2020/03/24,Córdoba,Granada,146,914678,93355,821323,782979,83669
2020/03/24,Córdoba,Córdoba,58661,782979,84440,698539,782979,83669
2020/03/24,Coruña,Lugo,505,329587,34400,295187,1119596,142456
2020/03/24,Coruña,Coruña,107740,1119596,141674,977922,1119596,142456
2020/03/24,Coruña,Pontevedra,4152,942665,126325,816340,1119596,142456
2020/03/24,Cuenca,Ciudad Real,58,495761,33659,462102,196329,15031
2020/03/24,Cuenca,Valencia,69,2565124,316519,2248605,196329,15031
2020/03/24,Cuenca,Albacete,462,388167,35030,353137,196329,15031
2020/03/24,Cuenca,Toledo,175,694844,68946,625898,196329,15031
2020/03/24,Cuenca,Cuenca,6818,196329,14362,181967,196329,15031
2020/03/24,Cuenca,Madrid,54,6663394,766816,5896578,196329,15031
2020/03/24,Gipuzkoa,Gipuzkoa,60938,723576,82440,641136,723576,86609
2020/03/24,Gipuzkoa,Navarra,204,654183,79339,574844,723576,86609
2020/03/24,Gipuzkoa,Araba,83,331549,44158,287391,723576,86609
2020/03/24,Gipuzkoa,Bizkaia,1077,1152934,172056,980878,723576,86609
2020/03/24,Girona,Girona,44776,771044,68562,702482,771044,73380
2020/03/24,Girona,Tarragona,22,804664,79378,725286,771044,73380
2020/03/24,Girona,Lleida,135,434930,48269,386661,771044,73380
2020/03/24,Girona,Murcia,28,1493898,157742,1336156,771044,73380
2020/03/24,Girona,Barcelona,1779,5664579,709916,4954663,771044,73380
2020/03/24,Girona,Almería,16,716820,64397,652423,771044,73380
2020/03/24,Granada,Córdoba,192,782979,84440,698539,914678,90497
2020/03/24,Granada,Almería,416,716820,64397,652423,914678,90497
2020/03/24,Granada,Málaga,88,1661785,156109,1505676,914678,90497
2020/03/24,Granada,Granada,66405,914678,93355,821323,914678,90497
2020/03/24,Granada,Jaén,172,633564,50212,583352,914678,90497
2020/03/24,Guadalajara,Guadalajara,16585,257762,28042,229720,257762,29611
2020/03/24,Guadalajara,Madrid,1446,6663394,766816,5896578,257762,29611
2020/03/24,Guadalajara,Cuenca,27,196329,14362,181967,257762,29611
2020/03/24,Huelva,Cádiz,416,1240155,124847,1115308,521870,59773
2020/03/24,Huelva,Badajoz,240,673559,65487,608072,521870,59773
2020/03/24,Huelva,Huelva,42781,521870,57817,464053,521870,59773
2020/03/24,Huelva,Sevilla,806,1942389,223902,1718487,521870,59773
2020/03/24,Huesca,Huesca,14363,220461,21713,198748,220461,23738
2020/03/24,Huesca,Zaragoza,189,964724,126445,838279,220461,23738
2020/03/24,Huesca,Lleida,463,434930,48269,386661,220461,23738
2020/03/24,Jaén,Granada,150,914678,93355,821323,633564,47655
2020/03/24,Jaén,Córdoba,499,782979,84440,698539,633564,47655
2020/03/24,Jaén,Jaén,33316,633564,50212,583352,633564,47655
2020/03/24,Las Palmas de Gran Canaria,Las Palmas de Gran Canaria,114221,1120406,127629,992777,1120406,126952
2020/03/24,León,Palencia,34,160866,18060,142806,460001,52954
2020/03/24,León,León,38950,460001,53713,406288,460001,52954
2020/03/24,León,Ourense,101,307651,39549,268102,460001,52954
2020/03/24,León,Asturias,44,1022800,114338,908462,460001,52954
2020/03/24,León,Zamora,149,172539,17759,154780,460001,52954
2020/03/24,Lleida,Barcelona,80,5664579,709916,4954663,434930,46393
2020/03/24,Lleida,Zaragoza,99,964724,126445,838279,434930,46393
2020/03/24,Lleida,Tarragona,42,804664,79378,725286,434930,46393
2020/03/24,Lleida,Lleida,29891,434930,48269,386661,434930,46393
2020/03/24,Lleida,Girona,137,771044,68562,702482,434930,46393
2020/03/24,Lleida,Huesca,439,220461,21713,198748,434930,46393
2020/03/24,Lugo,Lugo,24204,329587,34400,295187,329587,35484
2020/03/24,Lugo,Ourense,201,307651,39549,268102,329587,35484
2020/03/24,Lugo,Coruña,413,1119596,141674,977922,329587,35484
2020/03/24,Lugo,Asturias,631,1022800,114338,908462,329587,35484
2020/03/24,Madrid,Ávila,142,157640,13019,144621,6663394,771281
2020/03/24,Madrid,Segovia,18,153129,16034,137095,6663394,771281
2020/03/24,Madrid,Cuenca,81,196329,14362,181967,6663394,771281
2020/03/24,Madrid,Guadalajara,1674,257762,28042,229720,6663394,771281
2020/03/24,Madrid,Madrid,442941,6663394,766816,5896578,6663394,771281
2020/03/24,Madrid,Toledo,2937,694844,68946,625898,6663394,771281
2020/03/24,Málaga,Cádiz,513,1240155,124847,1115308,1661785,158696
2020/03/24,Málaga,Málaga,120965,1661785,156109,1505676,1661785,158696
2020/03/24,Málaga,Granada,145,914678,93355,821323,1661785,158696
2020/03/24,Málaga,Córdoba,168,782979,84440,698539,1661785,158696
2020/03/24,Málaga,Sevilla,124,1942389,223902,1718487,1661785,158696
2020/03/24,Melilla,Melilla,10934,86487,11236,75251,86487,11179
2020/03/24,Murcia,Barcelona,32,5664579,709916,4954663,1493898,159773
2020/03/24,Murcia,Alicante,2020,1858683,201957,1656726,1493898,159773
2020/03/24,Murcia,Albacete,131,388167,35030,353137,1493898,159773
2020/03/24,Murcia,Jaén,17,633564,50212,583352,1493898,159773
2020/03/24,Murcia,Murcia,122622,1493898,157742,1336156,1493898,159773
2020/03/24,Murcia,Almería,1034,716820,64397,652423,1493898,159773
2020/03/24,Navarra,Alicante,20,1858683,201957,1656726,654183,80907
2020/03/24,Navarra,Gipuzkoa,261,723576,82440,641136,654183,80907
2020/03/24,Navarra,Navarra,55248,654183,79339,574844,654183,80907
2020/03/24,Navarra,Rioja,1945,316798,37088,279710,654183,80907
2020/03/24,Navarra,Araba,18,331549,44158,287391,654183,80907
2020/03/24,Navarra,Zaragoza,451,964724,126445,838279,654183,80907
2020/03/24,Ourense,Zamora,18,172539,17759,154780,307651,39644
2020/03/24,Ourense,Pontevedra,157,942665,126325,816340,307651,39644
2020/03/24,Ourense,León,95,460001,53713,406288,307651,39644
2020/03/24,Ourense,Lugo,186,329587,34400,295187,307651,39644
2020/03/24,Ourense,Ourense,30127,307651,39549,268102,307651,39644
2020/03/24,Palencia,León,27,460001,53713,406288,160866,19050
2020/03/24,Palencia,Burgos,142,357072,35819,321253,160866,19050
2020/03/24,Palencia,Cantabria,183,580795,69308,511487,160866,19050
2020/03/24,Palencia,Palencia,12622,160866,18060,142806,160866,19050
2020/03/24,Palencia,Valladolid,43,519546,62830,456716,160866,19050
2020/03/24,Pontevedra,Coruña,3482,1119596,141674,977922,942665,124857
2020/03/24,Pontevedra,Ourense,105,307651,39549,268102,942665,124857
2020/03/24,Pontevedra,Pontevedra,96738,942665,126325,816340,942665,124857
2020/03/24,Rioja,Navarra,1620,654183,79339,574844,316798,34816
2020/03/24,Rioja,Araba,506,331549,44158,287391,316798,34816
2020/03/24,Rioja,Rioja,25843,316798,37088,279710,316798,34816
2020/03/24,Salamanca,Salamanca,28031,330119,36947,293172,330119,36471
2020/03/24,Salamanca,Zamora,32,172539,17759,154780,330119,36471
2020/03/24,Salamanca,Ávila,124,157640,13019,144621,330119,36471
2020/03/24,Santa Cruz de Tenerife,Santa Cruz de Tenerife,102645,1032983,118171,914812,1032983,117558
2020/03/24,Segovia,Ávila,120,157640,13019,144621,153129,17221
2020/03/24,Segovia,Valladolid,219,519546,62830,456716,153129,17221
2020/03/24,Segovia,Burgos,74,357072,35819,321253,153129,17221
2020/03/24,Segovia,Segovia,10381,153129,16034,137095,153129,17221
2020/03/24,Sevilla,Málaga,110,1661785,156109,1505676,1942389,221327
2020/03/24,Sevilla,Cádiz,538,1240155,124847,1115308,1942389,221327
2020/03/24,Sevilla,Sevilla,151300,1942389,223902,1718487,1942389,221327
2020/03/24,Sevilla,Huelva,388,521870,57817,464053,1942389,221327
2020/03/24,Sevilla,Córdoba,1445,782979,84440,698539,1942389,221327
2020/03/24,Soria,Zaragoza,97,964724,126445,838279,88636,7016
2020/03/24,Soria,Burgos,55,357072,35819,321253,88636,7016
2020/03/24,Soria,Soria,4419,88636,6448,82188,88636,7016
2020/03/24,Soria,Valladolid,50,519546,62830,456716,88636,7016
2020/03/24,Tarragona,Lleida,20,434930,48269,386661,804664,79979
2020/03/24,Tarragona,Castellón,643,579962,70014,509948,804664,79979
2020/03/24,Tarragona,Barcelona,737,5664579,709916,4954663,804664,79979
2020/03/24,Tarragona,Tarragona,51233,804664,79378,725286,804664,79979
2020/03/24,Teruel,Teruel,3811,134137,7413,126724,134137,8713
2020/03/24,Teruel,Castellón,26,579962,70014,509948,134137,8713
2020/03/24,Teruel,Zaragoza,27,964724,126445,838279,134137,8713
2020/03/24,Toledo,Toledo,32760,694844,68946,625898,694844,66587
2020/03/24,Toledo,Ciudad Real,179,495761,33659,462102,694844,66587
2020/03/24,Toledo,Madrid,2780,6663394,766816,5896578,694844,66587
2020/03/24,Toledo,Cáceres,185,394151,29669,364482,694844,66587
2020/03/24,Toledo,Cuenca,53,196329,14362,181967,694844,66587
2020/03/24,Toledo,Ávila,207,157640,13019,144621,694844,66587
2020/03/24,Valencia,Alicante,876,1858683,201957,1656726,2565124,304394
2020/03/24,Valencia,Cuenca,94,196329,14362,181967,2565124,304394
2020/03/24,Valencia,Albacete,286,388167,35030,353137,2565124,304394
2020/03/24,Valencia,Castellón,384,579962,70014,509948,2565124,304394
2020/03/24,Valencia,Valencia,204776,2565124,316519,2248605,2565124,304394
2020/03/24,Valladolid,Zamora,72,172539,17759,154780,519546,60380
2020/03/24,Valladolid,Burgos,86,357072,35819,321253,519546,60380
2020/03/24,Valladolid,Valladolid,43609,519546,62830,456716,519546,60380
2020/03/24,Valladolid,León,36,460001,53713,406288,519546,60380
2020/03/24,Valladolid,Segovia,216,153129,16034,137095,519546,60380
2020/03/24,Valladolid,Palencia,19,160866,18060,142806,519546,60380
2020/03/24,Valladolid,Ávila,21,157640,13019,144621,519546,60380
2020/03/24,Zamora,León,22,460001,53713,406288,172539,17882
2020/03/24,Zamora,Ourense,25,307651,39549,268102,172539,17882
2020/03/24,Zamora,Zamora,11918,172539,17759,154780,172539,17882
2020/03/24,Zamora,Valladolid,55,519546,62830,456716,172539,17882
2020/03/24,Zaragoza,Soria,29,88636,6448,82188,964724,121464
2020/03/24,Zaragoza,Huesca,193,220461,21713,198748,964724,121464
2020/03/24,Zaragoza,Lleida,82,434930,48269,386661,964724,121464
2020/03/24,Zaragoza,Teruel,145,134137,7413,126724,964724,121464
2020/03/24,Zaragoza,Zaragoza,93961,964724,126445,838279,964724,121464
2020/03/24,Zaragoza,Valencia,18,2565124,316519,2248605,964724,121464
2020/03/24,Zaragoza,Navarra,411,654183,79339,574844,964724,121464
2020/03/26,Albacete,Cuenca,469,196329,14794,181535,388167,29323
2020/03/26,Albacete,Albacete,17823,388167,29071,359096,388167,29323
2020/03/26,Albacete,Ciudad Real,499,495761,34795,460966,388167,29323
2020/03/26,Albacete,Jaén,16,633564,51478,582086,388167,29323
2020/03/26,Albacete,Murcia,178,1493898,171350,1322548,388167,29323
2020/03/26,Albacete,Valencia,267,2565124,316851,2248273,388167,29323
2020/03/26,Albacete,Alicante,205,1858683,209509,1649174,388167,29323
2020/03/26,Alicante,Valencia,988,2565124,316851,2248273,1858683,210067
2020/03/26,Alicante,Albacete,198,388167,29071,359096,1858683,210067
2020/03/26,Alicante,Murcia,2009,1493898,171350,1322548,1858683,210067
2020/03/26,Alicante,Almería,18,716820,66249,650571,1858683,210067
2020/03/26,Alicante,Alicante,160775,1858683,209509,1649174,1858683,210067
2020/03/26,Almería,Alicante,20,1858683,209509,1649174,716820,66797
2020/03/26,Almería,Murcia,1006,1493898,171350,1322548,716820,66797
2020/03/26,Almería,Almería,52922,716820,66249,650571,716820,66797
2020/03/26,Almería,Granada,461,914678,90277,824401,716820,66797
2020/03/26,Araba,Burgos,1315,357072,35318,321754,331549,48503
2020/03/26,Araba,Rioja,1535,316798,36306,280492,331549,48503
2020/03/26,Araba,Araba,35004,331549,43286,288263,331549,48503
2020/03/26,Araba,Gipuzkoa,90,723576,81484,642092,331549,48503
2020/03/26,Araba,Navarra,120,654183,77670,576513,331549,48503
2020/03/26,Araba,Bizkaia,864,1152934,169622,983312,331549,48503
2020/03/26,Asturias,León,28,460001,54775,405226,1022800,115124
2020/03/26,Asturias,Lugo,666,329587,34248,295339,1022800,115124
2020/03/26,Asturias,Cantabria,130,580795,68769,512026,1022800,115124
2020/03/26,Asturias,Asturias,89445,1022800,115596,907204,1022800,115124
2020/03/26,Ávila,Madrid,63,6663394,760152,5903242,157640,13450
2020/03/26,Ávila,Cáceres,96,394151,29935,364216,157640,13450
2020/03/26,Ávila,Toledo,146,694844,69868,624976,157640,13450
2020/03/26,Ávila,Segovia,93,153129,15698,137431,157640,13450
2020/03/26,Ávila,Ávila,8338,157640,13047,144593,157640,13450
2020/03/26,Ávila,Salamanca,196,330119,37185,292934,157640,13450
2020/03/26,Badajoz,Sevilla,54,1942389,221881,1720508,673559,65225
2020/03/26,Badajoz,Córdoba,120,782979,84432,698547,673559,65225
2020/03/26,Badajoz,Huelva,210,521870,56663,465207,673559,65225
2020/03/26,Badajoz,Ciudad Real,34,495761,34795,460966,673559,65225
2020/03/26,Badajoz,Cáceres,838,394151,29935,364216,673559,65225
2020/03/26,Badajoz,Badajoz,46293,673559,65603,607956,673559,65225
2020/03/26,Balears,Balears,89369,1149460,107785,1041675,1149460,108668
2020/03/26,Balears,Barcelona,19,5664579,699813,4964766,1149460,108668
2020/03/26,Barcelona,Girona,1884,771044,67789,703255,5664579,701360
2020/03/26,Barcelona,Tarragona,868,804664,78192,726472,5664579,701360
2020/03/26,Barcelona,Lleida,89,434930,48307,386623,5664579,701360
2020/03/26,Barcelona,Barcelona,442386,5664579,699813,4964766,5664579,701360
2020/03/26,Bizkaia,Araba,601,331549,43286,288263,1152934,166301
2020/03/26,Bizkaia,Bizkaia,124909,1152934,169622,983312,1152934,166301
2020/03/26,Bizkaia,Cantabria,1488,580795,68769,512026,1152934,166301
2020/03/26,Bizkaia,Burgos,34,357072,35318,321754,1152934,166301
2020/03/26,Bizkaia,Gipuzkoa,763,723576,81484,642092,1152934,166301
2020/03/26,Burgos,Segovia,21,153129,15698,137431,357072,35966
2020/03/26,Burgos,Soria,29,88636,6476,82160,357072,35966
2020/03/26,Burgos,Rioja,65,316798,36306,280492,357072,35966
2020/03/26,Burgos,Cantabria,27,580795,68769,512026,357072,35966
2020/03/26,Burgos,Araba,661,331549,43286,288263,357072,35966
2020/03/26,Burgos,Valladolid,80,519546,63187,456359,357072,35966
2020/03/26,Burgos,Palencia,244,160866,18307,142559,357072,35966
2020/03/26,Burgos,Bizkaia,118,1152934,169622,983312,357072,35966
2020/03/26,Burgos,Burgos,25136,357072,35318,321754,357072,35966
2020/03/26,Cáceres,Badajoz,887,673559,65603,607956,394151,29704
2020/03/26,Cáceres,Salamanca,33,330119,37185,292934,394151,29704
2020/03/26,Cáceres,Toledo,161,694844,69868,624976,394151,29704
2020/03/26,Cáceres,Ávila,81,157640,13047,144593,394151,29704
2020/03/26,Cáceres,Cáceres,18677,394151,29935,364216,394151,29704
2020/03/26,Cádiz,Ceuta,20,84777,8269,76508,1240155,131179
2020/03/26,Cádiz,Málaga,947,1661785,158625,1503160,1240155,131179
2020/03/26,Cádiz,Sevilla,776,1942389,221881,1720508,1240155,131179
2020/03/26,Cádiz,Cádiz,103888,1240155,128707,1111448,1240155,131179
2020/03/26,Cádiz,Huelva,595,521870,56663,465207,1240155,131179
2020/03/26,Cantabria,Cantabria,48739,580795,68769,512026,580795,65916
2020/03/26,Cantabria,Asturias,160,1022800,115596,907204,580795,65916
2020/03/26,Cantabria,Palencia,42,160866,18307,142559,580795,65916
2020/03/26,Cantabria,Bizkaia,356,1152934,169622,983312,580795,65916
2020/03/26,Castellón,Castellón,51768,579962,67820,512142,579962,72645
2020/03/26,Castellón,Valencia,1094,2565124,316851,2248273,579962,72645
2020/03/26,Castellón,Tarragona,769,804664,78192,726472,579962,72645
2020/03/26,Ceuta,Ceuta,7746,84777,8269,76508,84777,8286
2020/03/26,Ceuta,Cádiz,34,1240155,128707,1111448,84777,8286
2020/03/26,Ciudad Real,Albacete,444,388167,29071,359096,495761,33379
2020/03/26,Ciudad Real,Ciudad Real,20378,495761,34795,460966,495761,33379
2020/03/26,Ciudad Real,Toledo,198,694844,69868,624976,495761,33379
2020/03/26,Ciudad Real,Jaén,71,633564,51478,582086,495761,33379
2020/03/26,Ciudad Real,Córdoba,390,782979,84432,698547,495761,33379
2020/03/26,Ciudad Real,Badajoz,37,673559,65603,607956,495761,33379
2020/03/26,Córdoba,Badajoz,57,673559,65603,607956,782979,83451
2020/03/26,Córdoba,Jaén,607,633564,51478,582086,782979,83451
2020/03/26,Córdoba,Sevilla,1365,1942389,221881,1720508,782979,83451
2020/03/26,Córdoba,Málaga,139,1661785,158625,1503160,782979,83451
2020/03/26,Córdoba,Ciudad Real,203,495761,34795,460966,782979,83451
2020/03/26,Córdoba,Córdoba,58600,782979,84432,698547,782979,83451
2020/03/26,Córdoba,Granada,99,914678,90277,824401,782979,83451
2020/03/26,Coruña,Coruña,106568,1119596,140532,979064,1119596,141370
2020/03/26,Coruña,Lugo,433,329587,34248,295339,1119596,141370
2020/03/26,Coruña,Pontevedra,4034,942665,122851,819814,1119596,141370
2020/03/26,Cuenca,Albacete,580,388167,29071,359096,196329,15500
2020/03/26,Cuenca,Ciudad Real,103,495761,34795,460966,196329,15500
2020/03/26,Cuenca,Valencia,59,2565124,316851,2248273,196329,15500
2020/03/26,Cuenca,Guadalajara,25,257762,28002,229760,196329,15500
2020/03/26,Cuenca,Cuenca,7130,196329,14794,181535,196329,15500
2020/03/26,Cuenca,Madrid,55,6663394,760152,5903242,196329,15500
2020/03/26,Cuenca,Toledo,126,694844,69868,624976,196329,15500
2020/03/26,Gipuzkoa,Gipuzkoa,59605,723576,81484,642092,723576,84299
2020/03/26,Gipuzkoa,Araba,80,331549,43286,288263,723576,84299
2020/03/26,Gipuzkoa,Navarra,255,654183,77670,576513,723576,84299
2020/03/26,Gipuzkoa,Bizkaia,921,1152934,169622,983312,723576,84299
2020/03/26,Girona,Lleida,83,434930,48307,386623,771044,71028
2020/03/26,Girona,Girona,43675,771044,67789,703255,771044,71028
2020/03/26,Girona,Barcelona,1794,5664579,699813,4964766,771044,71028
2020/03/26,Granada,Murcia,16,1493898,171350,1322548,914678,87644
2020/03/26,Granada,Jaén,158,633564,51478,582086,914678,87644
2020/03/26,Granada,Córdoba,164,782979,84432,698547,914678,87644
2020/03/26,Granada,Almería,311,716820,66249,650571,914678,87644
2020/03/26,Granada,Málaga,85,1661785,158625,1503160,914678,87644
2020/03/26,Granada,Granada,63266,914678,90277,824401,914678,87644
2020/03/26,Guadalajara,Madrid,1497,6663394,760152,5903242,257762,29075
2020/03/26,Guadalajara,Cuenca,21,196329,14794,181535,257762,29075
2020/03/26,Guadalajara,Guadalajara,16237,257762,28002,229760,257762,29075
2020/03/26,Huelva,Huelva,42421,521870,56663,465207,521870,58893
2020/03/26,Huelva,Sevilla,558,1942389,221881,1720508,521870,58893
2020/03/26,Huelva,Badajoz,256,673559,65603,607956,521870,58893
2020/03/26,Huelva,Cádiz,463,1240155,128707,1111448,521870,58893
2020/03/26,Huesca,Zaragoza,177,964724,125685,839039,220461,23291
2020/03/26,Huesca,Lleida,516,434930,48307,386623,220461,23291
2020/03/26,Huesca,Huesca,13894,220461,21171,199290,220461,23291
2020/03/26,Jaén,Granada,99,914678,90277,824401,633564,49126
2020/03/26,Jaén,Córdoba,647,782979,84432,698547,633564,49126
2020/03/26,Jaén,Jaén,35094,633564,51478,582086,633564,49126
2020/03/26,Jaén,Almería,22,716820,66249,650571,633564,49126
2020/03/26,Las Palmas de Gran Canaria,Las Palmas de Gran Canaria,110770,1120406,125354,995052,1120406,124495
2020/03/26,León,Zamora,126,172539,17902,154637,460001,54133
2020/03/26,León,Lugo,39,329587,34248,295339,460001,54133
2020/03/26,León,Asturias,34,1022800,115596,907204,460001,54133
2020/03/26,León,Cantabria,19,580795,68769,512026,460001,54133
2020/03/26,León,León,39859,460001,54775,405226,460001,54133
2020/03/26,León,Palencia,29,160866,18307,142559,460001,54133
2020/03/26,León,Ourense,68,307651,39010,268641,460001,54133
2020/03/26,Lleida,Huesca,403,220461,21171,199290,434930,46234
2020/03/26,Lleida,Tarragona,31,804664,78192,726472,434930,46234
2020/03/26,Lleida,Lleida,29704,434930,48307,386623,434930,46234
2020/03/26,Lleida,Zaragoza,56,964724,125685,839039,434930,46234
2020/03/26,Lleida,Girona,84,771044,67789,703255,434930,46234
2020/03/26,Lleida,Barcelona,95,5664579,699813,4964766,434930,46234
2020/03/26,Lugo,Asturias,634,1022800,115596,907204,329587,35073
2020/03/26,Lugo,Ourense,161,307651,39010,268641,329587,35073
2020/03/26,Lugo,Lugo,23924,329587,34248,295339,329587,35073
2020/03/26,Lugo,Coruña,419,1119596,140532,979064,329587,35073
2020/03/26,Madrid,Cuenca,77,196329,14794,181535,6663394,765627
2020/03/26,Madrid,Madrid,440621,6663394,760152,5903242,6663394,765627
2020/03/26,Madrid,Guadalajara,1865,257762,28002,229760,6663394,765627
2020/03/26,Madrid,Almería,17,716820,66249,650571,6663394,765627
2020/03/26,Madrid,Ciudad Real,17,495761,34795,460966,6663394,765627
2020/03/26,Madrid,Toledo,2898,694844,69868,624976,6663394,765627
2020/03/26,Madrid,Ávila,98,157640,13047,144593,6663394,765627
2020/03/26,Madrid,Segovia,17,153129,15698,137431,6663394,765627
2020/03/26,Málaga,Almería,17,716820,66249,650571,1661785,161992
2020/03/26,Málaga,Sevilla,204,1942389,221881,1720508,1661785,161992
2020/03/26,Málaga,Granada,157,914678,90277,824401,1661785,161992
2020/03/26,Málaga,Málaga,123478,1661785,158625,1503160,1661785,161992
2020/03/26,Málaga,Córdoba,271,782979,84432,698547,1661785,161992
2020/03/26,Málaga,Melilla,22,86487,11601,74886,1661785,161992
2020/03/26,Málaga,Cádiz,598,1240155,128707,1111448,1661785,161992
2020/03/26,Melilla,Melilla,11256,86487,11601,74886,86487,11526
2020/03/26,Murcia,Albacete,197,388167,29071,359096,1493898,173090
2020/03/26,Murcia,Murcia,130836,1493898,171350,1322548,1493898,173090
2020/03/26,Murcia,Granada,16,914678,90277,824401,1493898,173090
2020/03/26,Murcia,Almería,1344,716820,66249,650571,1493898,173090
2020/03/26,Murcia,Alicante,2585,1858683,209509,1649174,1493898,173090
2020/03/26,Navarra,Alicante,26,1858683,209509,1649174,654183,78741
2020/03/26,Navarra,Zaragoza,476,964724,125685,839039,654183,78741
2020/03/26,Navarra,Navarra,53672,654183,77670,576513,654183,78741
2020/03/26,Navarra,Rioja,1955,316798,36306,280492,654183,78741
2020/03/26,Navarra,Gipuzkoa,236,723576,81484,642092,654183,78741
2020/03/26,Navarra,Araba,18,331549,43286,288263,654183,78741
2020/03/26,Ourense,Ourense,29711,307651,39010,268641,307651,39252
2020/03/26,Ourense,Zamora,22,172539,17902,154637,307651,39252
2020/03/26,Ourense,León,136,460001,54775,405226,307651,39252
2020/03/26,Ourense,Pontevedra,180,942665,122851,819814,307651,39252
2020/03/26,Ourense,Lugo,202,329587,34248,295339,307651,39252
2020/03/26,Palencia,Palencia,12802,160866,18307,142559,160866,19424
2020/03/26,Palencia,Valladolid,51,519546,63187,456359,160866,19424
2020/03/26,Palencia,Burgos,157,357072,35318,321754,160866,19424
2020/03/26,Palencia,León,32,460001,54775,405226,160866,19424
2020/03/26,Palencia,Cantabria,169,580795,68769,512026,160866,19424
2020/03/26,Pontevedra,Ourense,160,307651,39010,268641,942665,121693
2020/03/26,Pontevedra,Coruña,3505,1119596,140532,979064,942665,121693
2020/03/26,Pontevedra,Pontevedra,93840,942665,122851,819814,942665,121693
2020/03/26,Rioja,Burgos,27,357072,35318,321754,316798,34237
2020/03/26,Rioja,Araba,542,331549,43286,288263,316798,34237
2020/03/26,Rioja,Rioja,25411,316798,36306,280492,316798,34237
2020/03/26,Rioja,Navarra,1479,654183,77670,576513,316798,34237
2020/03/26,Salamanca,Zamora,24,172539,17902,154637,330119,36730
2020/03/26,Salamanca,Salamanca,28478,330119,37185,292934,330119,36730
2020/03/26,Salamanca,Ávila,124,157640,13047,144593,330119,36730
2020/03/26,Santa Cruz de Tenerife,Las Palmas de Gran Canaria,16,1120406,125354,995052,1032983,117259
2020/03/26,Santa Cruz de Tenerife,Almería,16,716820,66249,650571,1032983,117259
2020/03/26,Santa Cruz de Tenerife,Santa Cruz de Tenerife,101604,1032983,117607,915376,1032983,117259
2020/03/26,Segovia,Ávila,98,157640,13047,144593,153129,16745
2020/03/26,Segovia,Valladolid,230,519546,63187,456359,153129,16745
2020/03/26,Segovia,Burgos,71,357072,35318,321754,153129,16745
2020/03/26,Segovia,Madrid,20,6663394,760152,5903242,153129,16745
2020/03/26,Segovia,Segovia,10127,153129,15698,137431,153129,16745
2020/03/26,Sevilla,Huelva,307,521870,56663,465207,1942389,218466
2020/03/26,Sevilla,Badajoz,25,673559,65603,607956,1942389,218466
2020/03/26,Sevilla,Córdoba,1572,782979,84432,698547,1942389,218466
2020/03/26,Sevilla,Sevilla,149587,1942389,221881,1720508,1942389,218466
2020/03/26,Sevilla,Málaga,93,1661785,158625,1503160,1942389,218466
2020/03/26,Sevilla,Cádiz,715,1240155,128707,1111448,1942389,218466
2020/03/26,Soria,Segovia,20,153129,15698,137431,88636,6892
2020/03/26,Soria,Zaragoza,108,964724,125685,839039,88636,6892
2020/03/26,Soria,Valladolid,41,519546,63187,456359,88636,6892
2020/03/26,Soria,Burgos,31,357072,35318,321754,88636,6892
2020/03/26,Soria,Soria,4334,88636,6476,82160,88636,6892
2020/03/26,Tarragona,Tarragona,49821,804664,78192,726472,804664,78328
2020/03/26,Tarragona,Zaragoza,33,964724,125685,839039,804664,78328
2020/03/26,Tarragona,Lleida,21,434930,48307,386623,804664,78328
2020/03/26,Tarragona,Teruel,29,134137,7423,126714,804664,78328
2020/03/26,Tarragona,Barcelona,689,5664579,699813,4964766,804664,78328
2020/03/26,Tarragona,Castellón,651,579962,67820,512142,804664,78328
2020/03/26,Teruel,Guadalajara,27,257762,28002,229760,134137,8852
2020/03/26,Teruel,Teruel,3949,134137,7423,126714,134137,8852
2020/03/26,Teruel,Zaragoza,34,964724,125685,839039,134137,8852
2020/03/26,Teruel,Tarragona,40,804664,78192,726472,134137,8852
2020/03/26,Toledo,Toledo,34115,694844,69868,624976,694844,67463
2020/03/26,Toledo,Madrid,2710,6663394,760152,5903242,694844,67463
2020/03/26,Toledo,Cáceres,203,394151,29935,364216,694844,67463
2020/03/26,Toledo,Cuenca,26,196329,14794,181535,694844,67463
2020/03/26,Toledo,Ávila,195,157640,13047,144593,694844,67463
2020/03/26,Toledo,Ciudad Real,209,495761,34795,460966,694844,67463
2020/03/26,Valencia,Valencia,201754,2565124,316851,2248273,2565124,305309
2020/03/26,Valencia,Castellón,474,579962,67820,512142,2565124,305309
2020/03/26,Valencia,Albacete,279,388167,29071,359096,2565124,305309
2020/03/26,Valencia,Cuenca,61,196329,14794,181535,2565124,305309
2020/03/26,Valencia,Alicante,877,1858683,209509,1649174,2565124,305309
2020/03/26,Valladolid,Burgos,94,357072,35318,321754,519546,60332
2020/03/26,Valladolid,Zamora,86,172539,17902,154637,519546,60332
2020/03/26,Valladolid,León,38,460001,54775,405226,519546,60332
2020/03/26,Valladolid,Segovia,208,153129,15698,137431,519546,60332
2020/03/26,Valladolid,Soria,36,88636,6476,82160,519546,60332
2020/03/26,Valladolid,Valladolid,43438,519546,63187,456359,519546,60332
2020/03/26,Valladolid,Palencia,21,160866,18307,142559,519546,60332
2020/03/26,Zamora,Ourense,60,307651,39010,268641,172539,17944
2020/03/26,Zamora,León,27,460001,54775,405226,172539,17944
2020/03/26,Zamora,Zamora,12066,172539,17902,154637,172539,17944
2020/03/26,Zamora,Salamanca,35,330119,37185,292934,172539,17944
2020/03/26,Zamora,Valladolid,117,519546,63187,456359,172539,17944
2020/03/26,Zaragoza,Navarra,406,654183,77670,576513,964724,120934
2020/03/26,Zaragoza,Lleida,63,434930,48307,386623,964724,120934
2020/03/26,Zaragoza,Huesca,162,220461,21171,199290,964724,120934
2020/03/26,Zaragoza,Teruel,108,134137,7423,126714,964724,120934
2020/03/26,Zaragoza,Zaragoza,93333,964724,125685,839039,964724,120934
2020/03/26,Zaragoza,Soria,82,88636,6476,82160,964724,120934
2020/03/28,Albacete,Albacete,13746,388167,20272,367895,388167,20559
2020/03/28,Albacete,Ciudad Real,344,495761,21841,473920,388167,20559
2020/03/28,Albacete,Cuenca,195,196329,9055,187274,388167,20559
2020/03/28,Albacete,Valencia,293,2565124,212189,2352935,388167,20559
2020/03/28,Albacete,Alicante,123,1858683,149507,1709176,388167,20559
2020/03/28,Albacete,Jaén,63,633564,39145,594419,388167,20559
2020/03/28,Albacete,Murcia,99,1493898,111415,1382483,388167,20559
2020/03/28,Alicante,Albacete,67,388167,20272,367895,1858683,148845
2020/03/28,Alicante,Valencia,762,2565124,212189,2352935,1858683,148845
2020/03/28,Alicante,Murcia,1217,1493898,111415,1382483,1858683,148845
2020/03/28,Alicante,Alicante,123508,1858683,149507,1709176,1858683,148845
2020/03/28,Almería,Almería,35463,716820,44382,672438,716820,44385
2020/03/28,Almería,Murcia,593,1493898,111415,1382483,716820,44385
2020/03/28,Almería,Granada,278,914678,71548,843130,716820,44385
2020/03/28,Araba,Araba,22876,331549,27931,303618,331549,28553
2020/03/28,Araba,Rioja,431,316798,21775,295023,331549,28553
2020/03/28,Araba,Navarra,49,654183,49320,604863,331549,28553
2020/03/28,Araba,Burgos,594,357072,20773,336299,331549,28553
2020/03/28,Araba,Bizkaia,397,1152934,111245,1041689,331549,28553
2020/03/28,Asturias,León,34,460001,36901,423100,1022800,75422
2020/03/28,Asturias,Cantabria,215,580795,46057,534738,1022800,75422
2020/03/28,Asturias,Asturias,57973,1022800,74560,948240,1022800,75422
2020/03/28,Asturias,Lugo,583,329587,22486,307101,1022800,75422
2020/03/28,Ávila,Salamanca,81,330119,25312,304807,157640,9224
2020/03/28,Ávila,Madrid,63,6663394,535657,6127737,157640,9224
2020/03/28,Ávila,Ávila,6093,157640,8893,148747,157640,9224
2020/03/28,Ávila,Toledo,152,694844,42133,652711,157640,9224
2020/03/28,Ávila,Melilla,22,86487,9513,76974,157640,9224
2020/03/28,Ávila,Cáceres,57,394151,21055,373096,157640,9224
2020/03/28,Ávila,Almería,16,716820,44382,672438,157640,9224
2020/03/28,Ávila,Segovia,64,153129,10128,143001,157640,9224
2020/03/28,Badajoz,Cáceres,655,394151,21055,373096,673559,45475
2020/03/28,Badajoz,Sevilla,45,1942389,159663,1782726,673559,45475
2020/03/28,Badajoz,Córdoba,70,782979,64663,718316,673559,45475
2020/03/28,Badajoz,Huelva,112,521870,41624,480246,673559,45475
2020/03/28,Badajoz,Ciudad Real,44,495761,21841,473920,673559,45475
2020/03/28,Badajoz,Badajoz,33489,673559,45745,627814,673559,45475
2020/03/28,Balears,Barcelona,16,5664579,500232,5164347,1149460,66874
2020/03/28,Balears,Balears,53055,1149460,65738,1083722,1149460,66874
2020/03/28,Barcelona,Girona,1464,771044,45680,725364,5664579,501470
2020/03/28,Barcelona,Tarragona,481,804664,54307,750357,5664579,501470
2020/03/28,Barcelona,Lleida,52,434930,32137,402793,5664579,501470
2020/03/28,Barcelona,Barcelona,359152,5664579,500232,5164347,5664579,501470
2020/03/28,Bizkaia,Araba,357,331549,27931,303618,1152934,110149
2020/03/28,Bizkaia,Bizkaia,86232,1152934,111245,1041689,1152934,110149
2020/03/28,Bizkaia,Gipuzkoa,314,723576,47136,676440,1152934,110149
2020/03/28,Bizkaia,Cantabria,347,580795,46057,534738,1152934,110149
2020/03/28,Burgos,Araba,586,331549,27931,303618,357072,21072
2020/03/28,Burgos,Palencia,115,160866,12599,148267,357072,21072
2020/03/28,Burgos,Valladolid,69,519546,38522,481024,357072,21072
2020/03/28,Burgos,Rioja,19,316798,21775,295023,357072,21072
2020/03/28,Burgos,Cantabria,24,580795,46057,534738,357072,21072
2020/03/28,Burgos,Burgos,14764,357072,20773,336299,357072,21072
2020/03/28,Cáceres,Cáceres,13629,394151,21055,373096,394151,20948
2020/03/28,Cáceres,Toledo,63,694844,42133,652711,394151,20948
2020/03/28,Cáceres,Ávila,89,157640,8893,148747,394151,20948
2020/03/28,Cáceres,Badajoz,652,673559,45745,627814,394151,20948
2020/03/28,Cádiz,Cádiz,81944,1240155,98485,1141670,1240155,100341
2020/03/28,Cádiz,Almería,19,716820,44382,672438,1240155,100341
2020/03/28,Cádiz,Sevilla,618,1942389,159663,1782726,1240155,100341
2020/03/28,Cádiz,Huelva,500,521870,41624,480246,1240155,100341
2020/03/28,Cádiz,Málaga,516,1661785,107943,1553842,1240155,100341
2020/03/28,Cantabria,Bizkaia,321,1152934,111245,1041689,580795,46188
2020/03/28,Cantabria,Cantabria,34482,580795,46057,534738,580795,46188
2020/03/28,Cantabria,Asturias,89,1022800,74560,948240,580795,46188
2020/03/28,Castellón,Castellón,30667,579962,41463,538499,579962,42282
2020/03/28,Castellón,Valencia,419,2565124,212189,2352935,579962,42282
2020/03/28,Castellón,Tarragona,657,804664,54307,750357,579962,42282
2020/03/28,Ceuta,Ceuta,6202,84777,6677,78100,84777,6594
2020/03/28,Ciudad Real,Córdoba,321,782979,64663,718316,495761,22059
2020/03/28,Ciudad Real,Albacete,510,388167,20272,367895,495761,22059
2020/03/28,Ciudad Real,Ciudad Real,13205,495761,21841,473920,495761,22059
2020/03/28,Ciudad Real,Jaén,39,633564,39145,594419,495761,22059
2020/03/28,Ciudad Real,Badajoz,46,673559,45745,627814,495761,22059
2020/03/28,Ciudad Real,Toledo,65,694844,42133,652711,495761,22059
2020/03/28,Córdoba,Badajoz,79,673559,45745,627814,782979,64548
2020/03/28,Córdoba,Sevilla,1119,1942389,159663,1782726,782979,64548
2020/03/28,Córdoba,Ciudad Real,185,495761,21841,473920,782979,64548
2020/03/28,Córdoba,Córdoba,47055,782979,64663,718316,782979,64548
2020/03/28,Córdoba,Jaén,623,633564,39145,594419,782979,64548
2020/03/28,Córdoba,Granada,140,914678,71548,843130,782979,64548
2020/03/28,Córdoba,Málaga,136,1661785,107943,1553842,782979,64548
2020/03/28,Coruña,Pontevedra,2390,942665,73717,868948,1119596,92499
2020/03/28,Coruña,Lugo,251,329587,22486,307101,1119596,92499
2020/03/28,Coruña,Coruña,72178,1119596,92378,1027218,1119596,92499
2020/03/28,Cuenca,Albacete,272,388167,20272,367895,196329,9006
2020/03/28,Cuenca,Madrid,29,6663394,535657,6127737,196329,9006
2020/03/28,Cuenca,Valencia,89,2565124,212189,2352935,196329,9006
2020/03/28,Cuenca,Ciudad Real,40,495761,21841,473920,196329,9006
2020/03/28,Cuenca,Cuenca,4486,196329,9055,187274,196329,9006
2020/03/28,Cuenca,Guadalajara,20,257762,17236,240526,196329,9006
2020/03/28,Cuenca,Toledo,76,694844,42133,652711,196329,9006
2020/03/28,Gipuzkoa,Gipuzkoa,35612,723576,47136,676440,723576,47791
2020/03/28,Gipuzkoa,Bizkaia,256,1152934,111245,1041689,723576,47791
2020/03/28,Gipuzkoa,Navarra,80,654183,49320,604863,723576,47791
2020/03/28,Girona,Girona,30741,771044,45680,725364,771044,47213
2020/03/28,Girona,Lleida,82,434930,32137,402793,771044,47213
2020/03/28,Girona,Barcelona,1191,5664579,500232,5164347,771044,47213
2020/03/28,Girona,Almería,17,716820,44382,672438,771044,47213
2020/03/28,Granada,Jaén,378,633564,39145,594419,914678,71283
2020/03/28,Granada,Córdoba,219,782979,64663,718316,914678,71283
2020/03/28,Granada,Granada,52934,914678,71548,843130,914678,71283
2020/03/28,Granada,Almería,317,716820,44382,672438,914678,71283
2020/03/28,Granada,Málaga,92,1661785,107943,1553842,914678,71283
2020/03/28,Guadalajara,Madrid,960,6663394,535657,6127737,257762,16771
2020/03/28,Guadalajara,Guadalajara,10708,257762,17236,240526,257762,16771
2020/03/28,Huelva,Cádiz,347,1240155,98485,1141670,521870,41615
2020/03/28,Huelva,Huelva,31258,521870,41624,480246,521870,41615
2020/03/28,Huelva,Badajoz,238,673559,45745,627814,521870,41615
2020/03/28,Huelva,Sevilla,427,1942389,159663,1782726,521870,41615
2020/03/28,Huesca,Huesca,9974,220461,14198,206263,220461,14387
2020/03/28,Huesca,Lleida,283,434930,32137,402793,220461,14387
2020/03/28,Huesca,Zaragoza,73,964724,82023,882701,220461,14387
2020/03/28,Jaén,Jaén,28340,633564,39145,594419,633564,37715
2020/03/28,Jaén,Granada,182,914678,71548,843130,633564,37715
2020/03/28,Jaén,Córdoba,514,782979,64663,718316,633564,37715
2020/03/28,Las Palmas de Gran Canaria,Las Palmas de Gran Canaria,69645,1120406,84260,1036146,1120406,83291
2020/03/28,León,Ourense,96,307651,26617,281034,460001,36237
2020/03/28,León,Asturias,43,1022800,74560,948240,460001,36237
2020/03/28,León,Zamora,116,172539,11866,160673,460001,36237
2020/03/28,León,Palencia,24,160866,12599,148267,460001,36237
2020/03/28,León,León,26818,460001,36901,423100,460001,36237
2020/03/28,Lleida,Huesca,221,220461,14198,206263,434930,31473
2020/03/28,Lleida,Girona,50,771044,45680,725364,434930,31473
2020/03/28,Lleida,Barcelona,79,5664579,500232,5164347,434930,31473
2020/03/28,Lleida,Lleida,21219,434930,32137,402793,434930,31473
2020/03/28,Lleida,Zaragoza,108,964724,82023,882701,434930,31473
2020/03/28,Lugo,Ourense,74,307651,26617,281034,329587,22450
2020/03/28,Lugo,Asturias,389,1022800,74560,948240,329587,22450
2020/03/28,Lugo,Coruña,236,1119596,92378,1027218,329587,22450
2020/03/28,Lugo,Lugo,15983,329587,22486,307101,329587,22450
2020/03/28,Madrid,Toledo,1757,694844,42133,652711,6663394,538285
2020/03/28,Madrid,Guadalajara,978,257762,17236,240526,6663394,538285
2020/03/28,Madrid,Madrid,366315,6663394,535657,6127737,6663394,538285
2020/03/28,Madrid,Cuenca,76,196329,9055,187274,6663394,538285
2020/03/28,Madrid,Ávila,63,157640,8893,148747,6663394,538285
2020/03/28,Málaga,Sevilla,133,1942389,159663,1782726,1661785,107471
2020/03/28,Málaga,Cádiz,421,1240155,98485,1141670,1661785,107471
2020/03/28,Málaga,Melilla,38,86487,9513,76974,1661785,107471
2020/03/28,Málaga,Granada,60,914678,71548,843130,1661785,107471
2020/03/28,Málaga,Córdoba,197,782979,64663,718316,1661785,107471
2020/03/28,Málaga,Málaga,84572,1661785,107943,1553842,1661785,107471
2020/03/28,Melilla,Melilla,9109,86487,9513,76974,86487,9340
2020/03/28,Murcia,Murcia,86544,1493898,111415,1382483,1493898,113194
2020/03/28,Murcia,Albacete,62,388167,20272,367895,1493898,113194
2020/03/28,Murcia,Almería,628,716820,44382,672438,1493898,113194
2020/03/28,Murcia,Barcelona,46,5664579,500232,5164347,1493898,113194
2020/03/28,Murcia,Alicante,1674,1858683,149507,1709176,1493898,113194
2020/03/28,Navarra,Rioja,798,316798,21775,295023,654183,49223
2020/03/28,Navarra,Navarra,35331,654183,49320,604863,654183,49223
2020/03/28,Navarra,Gipuzkoa,90,723576,47136,676440,654183,49223
2020/03/28,Navarra,Zaragoza,321,964724,82023,882701,654183,49223
2020/03/28,Ourense,Lugo,188,329587,22486,307101,307651,26899
2020/03/28,Ourense,Ourense,21194,307651,26617,281034,307651,26899
2020/03/28,Ourense,Pontevedra,118,942665,73717,868948,307651,26899
2020/03/28,Ourense,León,82,460001,36901,423100,307651,26899
2020/03/28,Palencia,León,27,460001,36901,423100,160866,12617
2020/03/28,Palencia,Valladolid,26,519546,38522,481024,160866,12617
2020/03/28,Palencia,Burgos,67,357072,20773,336299,160866,12617
2020/03/28,Palencia,Palencia,9061,160866,12599,148267,160866,12617
2020/03/28,Palencia,Cantabria,30,580795,46057,534738,160866,12617
2020/03/28,Pontevedra,Coruña,2777,1119596,92378,1027218,942665,74306
2020/03/28,Pontevedra,Ourense,154,307651,26617,281034,942665,74306
2020/03/28,Pontevedra,Pontevedra,57787,942665,73717,868948,942665,74306
2020/03/28,Rioja,Araba,401,331549,27931,303618,316798,21426
2020/03/28,Rioja,Rioja,15870,316798,21775,295023,316798,21426
2020/03/28,Rioja,Navarra,969,654183,49320,604863,316798,21426
2020/03/28,Salamanca,Ávila,80,157640,8893,148747,330119,25319
2020/03/28,Salamanca,Salamanca,19464,330119,25312,304807,330119,25319
2020/03/28,Salamanca,Zamora,76,172539,11866,160673,330119,25319
2020/03/28,Santa Cruz de Tenerife,Santa Cruz de Tenerife,65937,1032983,79129,953854,1032983,78623
2020/03/28,Santa Cruz de Tenerife,Las Palmas de Gran Canaria,18,1120406,84260,1036146,1032983,78623
2020/03/28,Segovia,Segovia,6758,153129,10128,143001,153129,10377
2020/03/28,Segovia,Ávila,47,157640,8893,148747,153129,10377
2020/03/28,Segovia,Valladolid,136,519546,38522,481024,153129,10377
2020/03/28,Segovia,Burgos,21,357072,20773,336299,153129,10377
2020/03/28,Sevilla,Huelva,368,521870,41624,480246,1942389,159317
2020/03/28,Sevilla,Málaga,36,1661785,107943,1553842,1942389,159317
2020/03/28,Sevilla,Sevilla,114037,1942389,159663,1782726,1942389,159317
2020/03/28,Sevilla,Córdoba,1317,782979,64663,718316,1942389,159317
2020/03/28,Sevilla,Cádiz,632,1240155,98485,1141670,1942389,159317
2020/03/28,Sevilla,Badajoz,31,673559,45745,627814,1942389,159317
2020/03/28,Soria,Segovia,16,153129,10128,143001,88636,3704
2020/03/28,Soria,Valladolid,33,519546,38522,481024,88636,3704
2020/03/28,Soria,Soria,2476,88636,3814,84822,88636,3704
2020/03/28,Tarragona,Tarragona,36435,804664,54307,750357,804664,54086
2020/03/28,Tarragona,Zaragoza,78,964724,82023,882701,804664,54086
2020/03/28,Tarragona,Barcelona,534,5664579,500232,5164347,804664,54086
2020/03/28,Tarragona,Castellón,405,579962,41463,538499,804664,54086
2020/03/28,Teruel,Tarragona,39,804664,54307,750357,134137,3908
2020/03/28,Teruel,Zaragoza,36,964724,82023,882701,134137,3908
2020/03/28,Teruel,Teruel,1871,134137,4139,129998,134137,3908
2020/03/28,Toledo,Toledo,23197,694844,42133,652711,694844,42165
2020/03/28,Toledo,Cáceres,117,394151,21055,373096,694844,42165
2020/03/28,Toledo,Ciudad Real,107,495761,21841,473920,694844,42165
2020/03/28,Toledo,Ávila,129,157640,8893,148747,694844,42165
2020/03/28,Toledo,Madrid,1809,6663394,535657,6127737,694844,42165
2020/03/28,Valencia,Cuenca,84,196329,9055,187274,2565124,208701
2020/03/28,Valencia,Albacete,182,388167,20272,367895,2565124,208701
2020/03/28,Valencia,Valencia,146177,2565124,212189,2352935,2565124,208701
2020/03/28,Valencia,Alicante,243,1858683,149507,1709176,2565124,208701
2020/03/28,Valencia,Castellón,280,579962,41463,538499,2565124,208701
2020/03/28,Valladolid,Ávila,48,157640,8893,148747,519546,38049
2020/03/28,Valladolid,Zamora,56,172539,11866,160673,519546,38049
2020/03/28,Valladolid,Soria,23,88636,3814,84822,519546,38049
2020/03/28,Valladolid,León,33,460001,36901,423100,519546,38049
2020/03/28,Valladolid,Valladolid,26426,519546,38522,481024,519546,38049
2020/03/28,Valladolid,Segovia,120,153129,10128,143001,519546,38049
2020/03/28,Valladolid,Burgos,93,357072,20773,336299,519546,38049
2020/03/28,Zamora,Zamora,8004,172539,11866,160673,172539,11435
2020/03/28,Zamora,Salamanca,16,330119,25312,304807,172539,11435
2020/03/28,Zaragoza,Huesca,51,220461,14198,206263,964724,79941
2020/03/28,Zaragoza,Soria,21,88636,3814,84822,964724,79941
2020/03/28,Zaragoza,Teruel,32,134137,4139,129998,964724,79941
2020/03/28,Zaragoza,Zaragoza,61696,964724,82023,882701,964724,79941
2020/03/28,Zaragoza,Lleida,52,434930,32137,402793,964724,79941
2020/03/28,Zaragoza,Navarra,237,654183,49320,604863,964724,79941
2020/03/30,Albacete,Albacete,15510,388167,25164,363003,388167,25358
2020/03/30,Albacete,Valencia,266,2565124,269955,2295169,388167,25358
2020/03/30,Albacete,Cuenca,353,196329,12329,184000,388167,25358
2020/03/30,Albacete,Alicante,159,1858683,174721,1683962,388167,25358
2020/03/30,Albacete,Ciudad Real,462,495761,28931,466830,388167,25358
2020/03/30,Albacete,Murcia,134,1493898,148848,1345050,388167,25358
2020/03/30,Alicante,Valencia,714,2565124,269955,2295169,1858683,173142
2020/03/30,Alicante,Murcia,1636,1493898,148848,1345050,1858683,173142
2020/03/30,Alicante,Albacete,138,388167,25164,363003,1858683,173142
2020/03/30,Alicante,Alicante,135232,1858683,174721,1683962,1858683,173142
2020/03/30,Almería,Murcia,949,1493898,148848,1345050,716820,59696
2020/03/30,Almería,Almería,47814,716820,59727,657093,716820,59696
2020/03/30,Almería,Granada,379,914678,83872,830806,716820,59696
2020/03/30,Araba,Araba,28044,331549,34453,297096,331549,38456
2020/03/30,Araba,Bizkaia,571,1152934,136303,1016631,331549,38456
2020/03/30,Araba,Gipuzkoa,24,723576,60412,663164,331549,38456
2020/03/30,Araba,Navarra,56,654183,62045,592138,331549,38456
2020/03/30,Araba,Rioja,1152,316798,30324,286474,331549,38456
2020/03/30,Araba,Burgos,802,357072,28066,329006,331549,38456
2020/03/30,Asturias,Lugo,560,329587,29953,299634,1022800,94033
2020/03/30,Asturias,Cantabria,120,580795,56955,523840,1022800,94033
2020/03/30,Asturias,Asturias,71952,1022800,94915,927885,1022800,94033
2020/03/30,Ávila,Cáceres,82,394151,25197,368954,157640,11733
2020/03/30,Ávila,Segovia,73,153129,13182,139947,157640,11733
2020/03/30,Ávila,Madrid,42,6663394,637344,6026050,157640,11733
2020/03/30,Ávila,Ávila,7437,157640,11305,146335,157640,11733
2020/03/30,Ávila,Salamanca,160,330119,32672,297447,157640,11733
2020/03/30,Ávila,Toledo,162,694844,56099,638745,157640,11733
2020/03/30,Badajoz,Cáceres,712,394151,25197,368954,673559,56663
2020/03/30,Badajoz,Córdoba,76,782979,74982,707997,673559,56663
2020/03/30,Badajoz,Badajoz,40528,673559,57864,615695,673559,56663
2020/03/30,Badajoz,Huelva,169,521870,52613,469257,673559,56663
2020/03/30,Badajoz,Sevilla,53,1942389,192029,1750360,673559,56663
2020/03/30,Badajoz,Ciudad Real,36,495761,28931,466830,673559,56663
2020/03/30,Balears,Balears,67066,1149460,82593,1066867,1149460,83346
2020/03/30,Balears,Alicante,17,1858683,174721,1683962,1149460,83346
2020/03/30,Barcelona,Lleida,97,434930,40746,394184,5664579,585455
2020/03/30,Barcelona,Tarragona,607,804664,66861,737803,5664579,585455
2020/03/30,Barcelona,Barcelona,371504,5664579,582091,5082488,5664579,585455
2020/03/30,Barcelona,Girona,1433,771044,56193,714851,5664579,585455
2020/03/30,Bizkaia,Araba,413,331549,34453,297096,1152934,134281
2020/03/30,Bizkaia,Gipuzkoa,304,723576,60412,663164,1152934,134281
2020/03/30,Bizkaia,Cantabria,976,580795,56955,523840,1152934,134281
2020/03/30,Bizkaia,Bizkaia,99762,1152934,136303,1016631,1152934,134281
2020/03/30,Bizkaia,Alicante,29,1858683,174721,1683962,1152934,134281
2020/03/30,Burgos,Soria,25,88636,5135,83501,357072,28869
2020/03/30,Burgos,Segovia,17,153129,13182,139947,357072,28869
2020/03/30,Burgos,Palencia,160,160866,15355,145511,357072,28869
2020/03/30,Burgos,Cantabria,45,580795,56955,523840,357072,28869
2020/03/30,Burgos,Araba,512,331549,34453,297096,357072,28869
2020/03/30,Burgos,Burgos,20059,357072,28066,329006,357072,28869
2020/03/30,Burgos,Valladolid,52,519546,52239,467307,357072,28869
2020/03/30,Burgos,Rioja,17,316798,30324,286474,357072,28869
2020/03/30,Cáceres,Ávila,78,157640,11305,146335,394151,25310
2020/03/30,Cáceres,Cáceres,15250,394151,25197,368954,394151,25310
2020/03/30,Cáceres,Toledo,226,694844,56099,638745,394151,25310
2020/03/30,Cáceres,Badajoz,793,673559,57864,615695,394151,25310
2020/03/30,Cádiz,Sevilla,793,1942389,192029,1750360,1240155,117019
2020/03/30,Cádiz,Cádiz,92950,1240155,114789,1125366,1240155,117019
2020/03/30,Cádiz,Málaga,586,1661785,134610,1527175,1240155,117019
2020/03/30,Cádiz,Huelva,643,521870,52613,469257,1240155,117019
2020/03/30,Cádiz,Almería,16,716820,59727,657093,1240155,117019
2020/03/30,Cantabria,Asturias,114,1022800,94915,927885,580795,55340
2020/03/30,Cantabria,Cantabria,40394,580795,56955,523840,580795,55340
2020/03/30,Cantabria,Bizkaia,337,1152934,136303,1016631,580795,55340
2020/03/30,Cantabria,Palencia,28,160866,15355,145511,580795,55340
2020/03/30,Castellón,Tarragona,513,804664,66861,737803,579962,56051
2020/03/30,Castellón,Teruel,219,134137,6135,128002,579962,56051
2020/03/30,Castellón,Castellón,38601,579962,52529,527433,579962,56051
2020/03/30,Castellón,Valencia,558,2565124,269955,2295169,579962,56051
2020/03/30,Ceuta,Ceuta,7524,84777,7954,76823,84777,7998
2020/03/30,Ciudad Real,Ciudad Real,16484,495761,28931,466830,495761,27901
2020/03/30,Ciudad Real,Toledo,45,694844,56099,638745,495761,27901
2020/03/30,Ciudad Real,Córdoba,281,782979,74982,707997,495761,27901
2020/03/30,Ciudad Real,Albacete,428,388167,25164,363003,495761,27901
2020/03/30,Ciudad Real,Badajoz,51,673559,57864,615695,495761,27901
2020/03/30,Córdoba,Málaga,146,1661785,134610,1527175,782979,73854
2020/03/30,Córdoba,Sevilla,1205,1942389,192029,1750360,782979,73854
2020/03/30,Córdoba,Ciudad Real,218,495761,28931,466830,782979,73854
2020/03/30,Córdoba,Badajoz,58,673559,57864,615695,782979,73854
2020/03/30,Córdoba,Jaén,673,633564,45568,587996,782979,73854
2020/03/30,Córdoba,Granada,117,914678,83872,830806,782979,73854
2020/03/30,Córdoba,Córdoba,51880,782979,74982,707997,782979,73854
2020/03/30,Coruña,Coruña,87932,1119596,115828,1003768,1119596,116075
2020/03/30,Coruña,Lugo,338,329587,29953,299634,1119596,116075
2020/03/30,Coruña,Pontevedra,3288,942665,101839,840826,1119596,116075
2020/03/30,Cuenca,Albacete,455,388167,25164,363003,196329,13263
2020/03/30,Cuenca,Cuenca,6140,196329,12329,184000,196329,13263
2020/03/30,Cuenca,Toledo,122,694844,56099,638745,196329,13263
2020/03/30,Cuenca,Valencia,39,2565124,269955,2295169,196329,13263
2020/03/30,Cuenca,Ciudad Real,94,495761,28931,466830,196329,13263
2020/03/30,Cuenca,Guadalajara,26,257762,22491,235271,196329,13263
2020/03/30,Cuenca,Madrid,44,6663394,637344,6026050,196329,13263
2020/03/30,Gipuzkoa,Bizkaia,514,1152934,136303,1016631,723576,62588
2020/03/30,Gipuzkoa,Araba,18,331549,34453,297096,723576,62588
2020/03/30,Gipuzkoa,Navarra,150,654183,62045,592138,723576,62588
2020/03/30,Gipuzkoa,Gipuzkoa,44364,723576,60412,663164,723576,62588
2020/03/30,Girona,Lleida,88,434930,40746,394184,771044,57616
2020/03/30,Girona,Girona,35073,771044,56193,714851,771044,57616
2020/03/30,Girona,Barcelona,1429,5664579,582091,5082488,771044,57616
2020/03/30,Granada,Almería,362,716820,59727,657093,914678,82188
2020/03/30,Granada,Jaén,328,633564,45568,587996,914678,82188
2020/03/30,Granada,Córdoba,185,782979,74982,707997,914678,82188
2020/03/30,Granada,Granada,59135,914678,83872,830806,914678,82188
2020/03/30,Granada,Málaga,89,1661785,134610,1527175,914678,82188
2020/03/30,Guadalajara,Guadalajara,13069,257762,22491,235271,257762,23140
2020/03/30,Guadalajara,Madrid,1004,6663394,637344,6026050,257762,23140
2020/03/30,Huelva,Cádiz,411,1240155,114789,1125366,521870,53945
2020/03/30,Huelva,Sevilla,757,1942389,192029,1750360,521870,53945
2020/03/30,Huelva,Badajoz,215,673559,57864,615695,521870,53945
2020/03/30,Huelva,Huelva,39442,521870,52613,469257,521870,53945
2020/03/30,Huesca,Zaragoza,122,964724,104360,860364,220461,19836
2020/03/30,Huesca,Lleida,455,434930,40746,394184,220461,19836
2020/03/30,Huesca,Huesca,11821,220461,17945,202516,220461,19836
2020/03/30,Jaén,Granada,307,914678,83872,830806,633564,43740
2020/03/30,Jaén,Jaén,30778,633564,45568,587996,633564,43740
2020/03/30,Jaén,Córdoba,466,782979,74982,707997,633564,43740
2020/03/30,Las Palmas de Gran Canaria,Las Palmas de Gran Canaria,93281,1120406,107835,1012571,1120406,106937
2020/03/30,León,León,32944,460001,45961,414040,460001,45432
2020/03/30,León,Zamora,74,172539,15149,157390,460001,45432
2020/03/30,León,Asturias,33,1022800,94915,927885,460001,45432
2020/03/30,León,Ourense,68,307651,33421,274230,460001,45432
2020/03/30,Lleida,Huesca,341,220461,17945,202516,434930,38869
2020/03/30,Lleida,Girona,78,771044,56193,714851,434930,38869
2020/03/30,Lleida,Barcelona,136,5664579,582091,5082488,434930,38869
2020/03/30,Lleida,Zaragoza,74,964724,104360,860364,434930,38869
2020/03/30,Lleida,Lleida,24270,434930,40746,394184,434930,38869
2020/03/30,Lugo,Asturias,562,1022800,94915,927885,329587,30172
2020/03/30,Lugo,Coruña,358,1119596,115828,1003768,329587,30172
2020/03/30,Lugo,Ourense,146,307651,33421,274230,329587,30172
2020/03/30,Lugo,Lugo,20551,329587,29953,299634,329587,30172
2020/03/30,Madrid,Toledo,2174,694844,56099,638745,6663394,642704
2020/03/30,Madrid,Ávila,72,157640,11305,146335,6663394,642704
2020/03/30,Madrid,Madrid,382404,6663394,637344,6026050,6663394,642704
2020/03/30,Madrid,Guadalajara,1414,257762,22491,235271,6663394,642704
2020/03/30,Madrid,Cuenca,55,196329,12329,184000,6663394,642704
2020/03/30,Málaga,Málaga,104071,1661785,134610,1527175,1661785,135268
2020/03/30,Málaga,Cádiz,522,1240155,114789,1125366,1661785,135268
2020/03/30,Málaga,Sevilla,168,1942389,192029,1750360,1661785,135268
2020/03/30,Málaga,Córdoba,109,782979,74982,707997,1661785,135268
2020/03/30,Málaga,Granada,127,914678,83872,830806,1661785,135268
2020/03/30,Melilla,Melilla,10066,86487,10259,76228,86487,10336
2020/03/30,Murcia,Murcia,113988,1493898,148848,1345050,1493898,151613
2020/03/30,Murcia,Alicante,2423,1858683,174721,1683962,1493898,151613
2020/03/30,Murcia,Albacete,201,388167,25164,363003,1493898,151613
2020/03/30,Murcia,Barcelona,18,5664579,582091,5082488,1493898,151613
2020/03/30,Murcia,Almería,1262,716820,59727,657093,1493898,151613
2020/03/30,Navarra,Rioja,1511,316798,30324,286474,654183,63495
2020/03/30,Navarra,Zaragoza,364,964724,104360,860364,654183,63495
2020/03/30,Navarra,Gipuzkoa,136,723576,60412,663164,654183,63495
2020/03/30,Navarra,Navarra,42627,654183,62045,592138,654183,63495
2020/03/30,Ourense,Ourense,25358,307651,33421,274230,307651,33117
2020/03/30,Ourense,Lugo,175,329587,29953,299634,307651,33117
2020/03/30,Ourense,Pontevedra,152,942665,101839,840826,307651,33117
2020/03/30,Ourense,León,92,460001,45961,414040,307651,33117
2020/03/30,Palencia,Palencia,10573,160866,15355,145511,160866,16078
2020/03/30,Palencia,Cantabria,103,580795,56955,523840,160866,16078
2020/03/30,Palencia,Burgos,147,357072,28066,329006,160866,16078
2020/03/30,Pontevedra,Melilla,16,86487,10259,76228,942665,100704
2020/03/30,Pontevedra,Coruña,2953,1119596,115828,1003768,942665,100704
2020/03/30,Pontevedra,Ourense,135,307651,33421,274230,942665,100704
2020/03/30,Pontevedra,Lugo,31,329587,29953,299634,942665,100704
2020/03/30,Pontevedra,Pontevedra,77755,942665,101839,840826,942665,100704
2020/03/30,Rioja,Araba,396,331549,34453,297096,316798,29199
2020/03/30,Rioja,Rioja,21418,316798,30324,286474,316798,29199
2020/03/30,Rioja,Navarra,1257,654183,62045,592138,316798,29199
2020/03/30,Salamanca,Zamora,31,172539,15149,157390,330119,32195
2020/03/30,Salamanca,Ávila,140,157640,11305,146335,330119,32195
2020/03/30,Salamanca,Salamanca,24660,330119,32672,297447,330119,32195
2020/03/30,Santa Cruz de Tenerife,Las Palmas de Gran Canaria,19,1120406,107835,1012571,1032983,100249
2020/03/30,Santa Cruz de Tenerife,Santa Cruz de Tenerife,85306,1032983,100629,932354,1032983,100249
2020/03/30,Segovia,Ávila,84,157640,11305,146335,153129,14089
2020/03/30,Segovia,Segovia,8399,153129,13182,139947,153129,14089
2020/03/30,Segovia,Valladolid,152,519546,52239,467307,153129,14089
2020/03/30,Segovia,Burgos,59,357072,28066,329006,153129,14089
2020/03/30,Sevilla,Cádiz,568,1240155,114789,1125366,1942389,189950
2020/03/30,Sevilla,Málaga,90,1661785,134610,1527175,1942389,189950
2020/03/30,Sevilla,Badajoz,29,673559,57864,615695,1942389,189950
2020/03/30,Sevilla,Sevilla,128869,1942389,192029,1750360,1942389,189950
2020/03/30,Sevilla,Huelva,332,521870,52613,469257,1942389,189950
2020/03/30,Sevilla,Córdoba,1329,782979,74982,707997,1942389,189950
2020/03/30,Soria,Valladolid,28,519546,52239,467307,88636,5691
2020/03/30,Soria,Segovia,16,153129,13182,139947,88636,5691
2020/03/30,Soria,Soria,3645,88636,5135,83501,88636,5691
2020/03/30,Tarragona,Tarragona,42269,804664,66861,737803,804664,66006
2020/03/30,Tarragona,Teruel,31,134137,6135,128002,804664,66006
2020/03/30,Tarragona,Barcelona,501,5664579,582091,5082488,804664,66006
2020/03/30,Tarragona,Castellón,509,579962,52529,527433,804664,66006
2020/03/30,Teruel,Teruel,3176,134137,6135,128002,134137,6900
2020/03/30,Teruel,Tarragona,43,804664,66861,737803,134137,6900
2020/03/30,Teruel,Castellón,95,579962,52529,527433,134137,6900
2020/03/30,Toledo,Ávila,98,157640,11305,146335,694844,55107
2020/03/30,Toledo,Toledo,28454,694844,56099,638745,694844,55107
2020/03/30,Toledo,Ciudad Real,142,495761,28931,466830,694844,55107
2020/03/30,Toledo,Cáceres,102,394151,25197,368954,694844,55107
2020/03/30,Toledo,Madrid,2139,6663394,637344,6026050,694844,55107
2020/03/30,Valencia,Albacete,219,388167,25164,363003,2565124,261152
2020/03/30,Valencia,Cuenca,62,196329,12329,184000,2565124,261152
2020/03/30,Valencia,Alicante,697,1858683,174721,1683962,2565124,261152
2020/03/30,Valencia,Valencia,169872,2565124,269955,2295169,2565124,261152
2020/03/30,Valencia,Castellón,332,579962,52529,527433,2565124,261152
2020/03/30,Valladolid,Zamora,84,172539,15149,157390,519546,50378
2020/03/30,Valladolid,Burgos,43,357072,28066,329006,519546,50378
2020/03/30,Valladolid,Valladolid,35573,519546,52239,467307,519546,50378
2020/03/30,Valladolid,León,37,460001,45961,414040,519546,50378
2020/03/30,Valladolid,Soria,23,88636,5135,83501,519546,50378
2020/03/30,Valladolid,Segovia,94,153129,13182,139947,519546,50378
2020/03/30,Zamora,Zamora,10460,172539,15149,157390,172539,15249
2020/03/30,Zamora,Valladolid,31,519546,52239,467307,172539,15249
2020/03/30,Zamora,León,22,460001,45961,414040,172539,15249
2020/03/30,Zaragoza,Barcelona,36,5664579,582091,5082488,964724,101025
2020/03/30,Zaragoza,Lleida,47,434930,40746,394184,964724,101025
2020/03/30,Zaragoza,Teruel,34,134137,6135,128002,964724,101025
2020/03/30,Zaragoza,Navarra,251,654183,62045,592138,964724,101025
2020/03/30,Zaragoza,Huesca,78,220461,17945,202516,964724,101025
2020/03/30,Zaragoza,Zaragoza,76885,964724,104360,860364,964724,101025
2020/03/31,Albacete,Albacete,14256,388167,23545,364622,388167,23159
2020/03/31,Albacete,Valencia,314,2565124,261949,2303175,388167,23159
2020/03/31,Albacete,Cuenca,282,196329,11664,184665,388167,23159
2020/03/31,Albacete,Jaén,48,633564,40864,592700,388167,23159
2020/03/31,Albacete,Ciudad Real,465,495761,25662,470099,388167,23159
2020/03/31,Albacete,Murcia,99,1493898,138196,1355702,388167,23159
2020/03/31,Albacete,Alicante,140,1858683,165689,1692994,388167,23159
2020/03/31,Alicante,Murcia,1844,1493898,138196,1355702,1858683,165837
2020/03/31,Alicante,Alicante,128171,1858683,165689,1692994,1858683,165837
2020/03/31,Alicante,Albacete,163,388167,23545,364622,1858683,165837
2020/03/31,Alicante,Valencia,429,2565124,261949,2303175,1858683,165837
2020/03/31,Almería,Almería,48111,716820,59644,657176,716820,60288
2020/03/31,Almería,Murcia,1054,1493898,138196,1355702,716820,60288
2020/03/31,Almería,Granada,242,914678,76663,838015,716820,60288
2020/03/31,Almería,Melilla,24,86487,9818,76669,716820,60288
2020/03/31,Araba,Gipuzkoa,24,723576,57347,666229,331549,36009
2020/03/31,Araba,Burgos,744,357072,27157,329915,331549,36009
2020/03/31,Araba,Araba,26526,331549,32866,298683,331549,36009
2020/03/31,Araba,Rioja,1047,316798,28434,288364,331549,36009
2020/03/31,Araba,Bizkaia,418,1152934,131893,1021041,331549,36009
2020/03/31,Araba,Navarra,61,654183,59701,594482,331549,36009
2020/03/31,Asturias,Lugo,503,329587,28612,300975,1022800,91427
2020/03/31,Asturias,León,41,460001,43804,416197,1022800,91427
2020/03/31,Asturias,Asturias,69844,1022800,91783,931017,1022800,91427
2020/03/31,Asturias,Cantabria,171,580795,54446,526349,1022800,91427
2020/03/31,Ávila,Cáceres,58,394151,23601,370550,157640,11826
2020/03/31,Ávila,Toledo,130,694844,52119,642725,157640,11826
2020/03/31,Ávila,Salamanca,253,330119,31459,298660,157640,11826
2020/03/31,Ávila,Madrid,45,6663394,629650,6033744,157640,11826
2020/03/31,Ávila,Segovia,86,153129,13079,140050,157640,11826
2020/03/31,Ávila,Ávila,7494,157640,11150,146490,157640,11826
2020/03/31,Badajoz,Cáceres,561,394151,23601,370550,673559,51253
2020/03/31,Badajoz,Córdoba,26,782979,68005,714974,673559,51253
2020/03/31,Badajoz,Badajoz,36427,673559,52190,621369,673559,51253
2020/03/31,Badajoz,Huelva,129,521870,47004,474866,673559,51253
2020/03/31,Balears,Barcelona,21,5664579,576750,5087829,1149460,78436
2020/03/31,Balears,Valencia,43,2565124,261949,2303175,1149460,78436
2020/03/31,Balears,Balears,63016,1149460,78068,1071392,1149460,78436
2020/03/31,Barcelona,Barcelona,370568,5664579,576750,5087829,5664579,576699
2020/03/31,Barcelona,Lleida,99,434930,39457,395473,5664579,576699
2020/03/31,Barcelona,Zaragoza,16,964724,99382,865342,5664579,576699
2020/03/31,Barcelona,Tarragona,598,804664,65693,738971,5664579,576699
2020/03/31,Barcelona,Girona,1376,771044,55795,715249,5664579,576699
2020/03/31,Bizkaia,Cantabria,817,580795,54446,526349,1152934,129236
2020/03/31,Bizkaia,Bizkaia,96261,1152934,131893,1021041,1152934,129236
2020/03/31,Bizkaia,Burgos,18,357072,27157,329915,1152934,129236
2020/03/31,Bizkaia,Araba,448,331549,32866,298683,1152934,129236
2020/03/31,Bizkaia,Gipuzkoa,331,723576,57347,666229,1152934,129236
2020/03/31,Burgos,Palencia,120,160866,14584,146282,357072,27385
2020/03/31,Burgos,Cantabria,18,580795,54446,526349,357072,27385
2020/03/31,Burgos,Valladolid,86,519546,50744,468802,357072,27385
2020/03/31,Burgos,Araba,452,331549,32866,298683,357072,27385
2020/03/31,Burgos,Burgos,19343,357072,27157,329915,357072,27385
2020/03/31,Cáceres,Toledo,77,694844,52119,642725,394151,23500
2020/03/31,Cáceres,Cáceres,14533,394151,23601,370550,394151,23500
2020/03/31,Cáceres,Badajoz,761,673559,52190,621369,394151,23500
2020/03/31,Cáceres,Ávila,54,157640,11150,146490,394151,23500
2020/03/31,Cádiz,Huelva,597,521870,47004,474866,1240155,106838
2020/03/31,Cádiz,Cádiz,85049,1240155,104928,1135227,1240155,106838
2020/03/31,Cádiz,Sevilla,664,1942389,175647,1766742,1240155,106838
2020/03/31,Cádiz,Málaga,499,1661785,122173,1539612,1240155,106838
2020/03/31,Cantabria,Cantabria,38335,580795,54446,526349,580795,52500
2020/03/31,Cantabria,Bizkaia,376,1152934,131893,1021041,580795,52500
2020/03/31,Cantabria,Asturias,121,1022800,91783,931017,580795,52500
2020/03/31,Castellón,Teruel,33,134137,5319,128818,579962,47517
2020/03/31,Castellón,Castellón,32287,579962,46487,533475,579962,47517
2020/03/31,Castellón,Valencia,593,2565124,261949,2303175,579962,47517
2020/03/31,Castellón,Tarragona,554,804664,65693,738971,579962,47517
2020/03/31,Ceuta,Ceuta,7089,84777,7534,77243,84777,7480
2020/03/31,Ciudad Real,Córdoba,310,782979,68005,714974,495761,25459
2020/03/31,Ciudad Real,Badajoz,35,673559,52190,621369,495761,25459
2020/03/31,Ciudad Real,Ciudad Real,14383,495761,25662,470099,495761,25459
2020/03/31,Ciudad Real,Albacete,354,388167,23545,364622,495761,25459
2020/03/31,Ciudad Real,Toledo,50,694844,52119,642725,495761,25459
2020/03/31,Córdoba,Córdoba,47248,782979,68005,714974,782979,66472
2020/03/31,Córdoba,Sevilla,951,1942389,175647,1766742,782979,66472
2020/03/31,Córdoba,Málaga,48,1661785,122173,1539612,782979,66472
2020/03/31,Córdoba,Granada,122,914678,76663,838015,782979,66472
2020/03/31,Córdoba,Ciudad Real,209,495761,25662,470099,782979,66472
2020/03/31,Córdoba,Jaén,388,633564,40864,592700,782979,66472
2020/03/31,Córdoba,Badajoz,57,673559,52190,621369,782979,66472
2020/03/31,Coruña,Lugo,363,329587,28612,300975,1119596,115444
2020/03/31,Coruña,Pontevedra,3375,942665,100302,842363,1119596,115444
2020/03/31,Coruña,Coruña,86077,1119596,112990,1006606,1119596,115444
2020/03/31,Cuenca,Albacete,333,388167,23545,364622,196329,12045
2020/03/31,Cuenca,Madrid,50,6663394,629650,6033744,196329,12045
2020/03/31,Cuenca,Cuenca,5518,196329,11664,184665,196329,12045
2020/03/31,Cuenca,Toledo,66,694844,52119,642725,196329,12045
2020/03/31,Cuenca,Valencia,32,2565124,261949,2303175,196329,12045
2020/03/31,Gipuzkoa,Navarra,113,654183,59701,594482,723576,59626
2020/03/31,Gipuzkoa,Gipuzkoa,42157,723576,57347,666229,723576,59626
2020/03/31,Gipuzkoa,Araba,19,331549,32866,298683,723576,59626
2020/03/31,Gipuzkoa,Bizkaia,512,1152934,131893,1021041,723576,59626
2020/03/31,Girona,Barcelona,1414,5664579,576750,5087829,771044,59008
2020/03/31,Girona,Girona,35825,771044,55795,715249,771044,59008
2020/03/31,Girona,Lleida,102,434930,39457,395473,771044,59008
2020/03/31,Granada,Granada,54566,914678,76663,838015,914678,75281
2020/03/31,Granada,Cádiz,22,1240155,104928,1135227,914678,75281
2020/03/31,Granada,Almería,187,716820,59644,657176,914678,75281
2020/03/31,Granada,Córdoba,103,782979,68005,714974,914678,75281
2020/03/31,Granada,Melilla,16,86487,9818,76669,914678,75281
2020/03/31,Granada,Málaga,65,1661785,122173,1539612,914678,75281
2020/03/31,Granada,Jaén,33,633564,40864,592700,914678,75281
2020/03/31,Guadalajara,Madrid,1428,6663394,629650,6033744,257762,23791
2020/03/31,Guadalajara,Guadalajara,13816,257762,22991,234771,257762,23791
2020/03/31,Huelva,Cádiz,361,1240155,104928,1135227,521870,48257
2020/03/31,Huelva,Huelva,34520,521870,47004,474866,521870,48257
2020/03/31,Huelva,Badajoz,201,673559,52190,621369,521870,48257
2020/03/31,Huelva,Sevilla,693,1942389,175647,1766742,521870,48257
2020/03/31,Huesca,Huesca,10810,220461,16852,203609,220461,18406
2020/03/31,Huesca,Zaragoza,126,964724,99382,865342,220461,18406
2020/03/31,Huesca,Lleida,360,434930,39457,395473,220461,18406
2020/03/31,Jaén,Córdoba,465,782979,68005,714974,633564,39703
2020/03/31,Jaén,Granada,73,914678,76663,838015,633564,39703
2020/03/31,Jaén,Jaén,27122,633564,40864,592700,633564,39703
2020/03/31,Jaén,Albacete,31,388167,23545,364622,633564,39703
2020/03/31,Las Palmas de Gran Canaria,Las Palmas de Gran Canaria,90578,1120406,105585,1014821,1120406,104097
2020/03/31,León,Valladolid,29,519546,50744,468802,460001,43196
2020/03/31,León,León,31225,460001,43804,416197,460001,43196
2020/03/31,León,Palencia,68,160866,14584,146282,460001,43196
2020/03/31,León,Ourense,64,307651,32087,275564,460001,43196
2020/03/31,León,Asturias,21,1022800,91783,931017,460001,43196
2020/03/31,León,Zamora,73,172539,14538,158001,460001,43196
2020/03/31,Lleida,Girona,47,771044,55795,715249,434930,37548
2020/03/31,Lleida,Lleida,23664,434930,39457,395473,434930,37548
2020/03/31,Lleida,Barcelona,28,5664579,576750,5087829,434930,37548
2020/03/31,Lleida,Zaragoza,47,964724,99382,865342,434930,37548
2020/03/31,Lleida,Huesca,288,220461,16852,203609,434930,37548
2020/03/31,Lugo,Ourense,117,307651,32087,275564,329587,29684
2020/03/31,Lugo,Coruña,374,1119596,112990,1006606,329587,29684
2020/03/31,Lugo,Asturias,484,1022800,91783,931017,329587,29684
2020/03/31,Lugo,Lugo,20134,329587,28612,300975,329587,29684
2020/03/31,Madrid,Toledo,2072,694844,52119,642725,6663394,640116
2020/03/31,Madrid,Guadalajara,1380,257762,22991,234771,6663394,640116
2020/03/31,Madrid,Madrid,383743,6663394,629650,6033744,6663394,640116
2020/03/31,Madrid,Ávila,90,157640,11150,146490,6663394,640116
2020/03/31,Madrid,Cuenca,24,196329,11664,184665,6663394,640116
2020/03/31,Málaga,Málaga,94562,1661785,122173,1539612,1661785,121700
2020/03/31,Málaga,Córdoba,72,782979,68005,714974,1661785,121700
2020/03/31,Málaga,Granada,58,914678,76663,838015,1661785,121700
2020/03/31,Málaga,Cádiz,428,1240155,104928,1135227,1661785,121700
2020/03/31,Málaga,Sevilla,102,1942389,175647,1766742,1661785,121700
2020/03/31,Melilla,Melilla,9513,86487,9818,76669,86487,9745
2020/03/31,Murcia,Alicante,1806,1858683,165689,1692994,1493898,136900
2020/03/31,Murcia,Albacete,68,388167,23545,364622,1493898,136900
2020/03/31,Murcia,Murcia,103878,1493898,138196,1355702,1493898,136900
2020/03/31,Murcia,Granada,35,914678,76663,838015,1493898,136900
2020/03/31,Murcia,Almería,791,716820,59644,657176,1493898,136900
2020/03/31,Navarra,Rioja,1373,316798,28434,288364,654183,60602
2020/03/31,Navarra,Gipuzkoa,103,723576,57347,666229,654183,60602
2020/03/31,Navarra,Navarra,40712,654183,59701,594482,654183,60602
2020/03/31,Navarra,Zaragoza,352,964724,99382,865342,654183,60602
2020/03/31,Ourense,Pontevedra,150,942665,100302,842363,307651,32336
2020/03/31,Ourense,León,59,460001,43804,416197,307651,32336
2020/03/31,Ourense,Lugo,147,329587,28612,300975,307651,32336
2020/03/31,Ourense,Ourense,24663,307651,32087,275564,307651,32336
2020/03/31,Palencia,Cantabria,106,580795,54446,526349,160866,15155
2020/03/31,Palencia,Burgos,156,357072,27157,329915,160866,15155
2020/03/31,Palencia,Palencia,10024,160866,14584,146282,160866,15155
2020/03/31,Palencia,Valladolid,22,519546,50744,468802,160866,15155
2020/03/31,Pontevedra,Coruña,3063,1119596,112990,1006606,942665,101291
2020/03/31,Pontevedra,Pontevedra,76847,942665,100302,842363,942665,101291
2020/03/31,Pontevedra,Ourense,127,307651,32087,275564,942665,101291
2020/03/31,Rioja,Araba,407,331549,32866,298683,316798,27313
2020/03/31,Rioja,Rioja,19698,316798,28434,288364,316798,27313
2020/03/31,Rioja,Navarra,1194,654183,59701,594482,316798,27313
2020/03/31,Salamanca,Ávila,104,157640,11150,146490,330119,31054
2020/03/31,Salamanca,Salamanca,23955,330119,31459,298660,330119,31054
2020/03/31,Santa Cruz de Tenerife,Las Palmas de Gran Canaria,26,1120406,105585,1014821,1032983,96065
2020/03/31,Santa Cruz de Tenerife,Santa Cruz de Tenerife,81325,1032983,97148,935835,1032983,96065
2020/03/31,Segovia,Ávila,102,157640,11150,146490,153129,13757
2020/03/31,Segovia,Valladolid,91,519546,50744,468802,153129,13757
2020/03/31,Segovia,Segovia,8486,153129,13079,140050,153129,13757
2020/03/31,Sevilla,Sevilla,116825,1942389,175647,1766742,1942389,172300
2020/03/31,Sevilla,Huelva,212,521870,47004,474866,1942389,172300
2020/03/31,Sevilla,Córdoba,1040,782979,68005,714974,1942389,172300
2020/03/31,Sevilla,Cádiz,518,1240155,104928,1135227,1942389,172300
2020/03/31,Sevilla,Málaga,31,1661785,122173,1539612,1942389,172300
2020/03/31,Soria,Valladolid,45,519546,50744,468802,88636,5276
2020/03/31,Soria,Soria,3396,88636,4934,83702,88636,5276
2020/03/31,Tarragona,Tarragona,40988,804664,65693,738971,804664,64280
2020/03/31,Tarragona,Castellón,401,579962,46487,533475,804664,64280
2020/03/31,Tarragona,Barcelona,534,5664579,576750,5087829,804664,64280
2020/03/31,Tarragona,Teruel,29,134137,5319,128818,804664,64280
2020/03/31,Teruel,Castellón,28,579962,46487,533475,134137,5778
2020/03/31,Teruel,Teruel,2457,134137,5319,128818,134137,5778
2020/03/31,Toledo,Cáceres,108,394151,23601,370550,694844,52045
2020/03/31,Toledo,Toledo,26841,694844,52119,642725,694844,52045
2020/03/31,Toledo,Ciudad Real,88,495761,25662,470099,694844,52045
2020/03/31,Toledo,Ávila,79,157640,11150,146490,694844,52045
2020/03/31,Toledo,Madrid,2042,6663394,629650,6033744,694844,52045
2020/03/31,Valencia,Valencia,175023,2565124,261949,2303175,2565124,256911
2020/03/31,Valencia,Cuenca,52,196329,11664,184665,2565124,256911
2020/03/31,Valencia,Castellón,331,579962,46487,533475,2565124,256911
2020/03/31,Valencia,Albacete,271,388167,23545,364622,2565124,256911
2020/03/31,Valencia,Alicante,535,1858683,165689,1692994,2565124,256911
2020/03/31,Valencia,Madrid,17,6663394,629650,6033744,2565124,256911
2020/03/31,Valladolid,Burgos,72,357072,27157,329915,519546,48590
2020/03/31,Valladolid,Zamora,30,172539,14538,158001,519546,48590
2020/03/31,Valladolid,Segovia,131,153129,13079,140050,519546,48590
2020/03/31,Valladolid,Valladolid,34431,519546,50744,468802,519546,48590
2020/03/31,Zamora,Salamanca,17,330119,31459,298660,172539,14354
2020/03/31,Zamora,Zamora,9533,172539,14538,158001,172539,14354
2020/03/31,Zamora,Valladolid,34,519546,50744,468802,172539,14354
2020/03/31,Zaragoza,Lleida,81,434930,39457,395473,964724,94988
2020/03/31,Zaragoza,Navarra,205,654183,59701,594482,964724,94988
2020/03/31,Zaragoza,Huesca,122,220461,16852,203609,964724,94988
2020/03/31,Zaragoza,Zaragoza,71515,964724,99382,865342,964724,94988
2020/04/01,Albacete,Alicante,110,1858683,170222,1688461,388167,22273
2020/04/01,Albacete,Albacete,13375,388167,22679,365488,388167,22273
2020/04/01,Albacete,Valencia,239,2565124,266372,2298752,388167,22273
2020/04/01,Albacete,Ciudad Real,365,495761,26320,469441,388167,22273
2020/04/01,Albacete,Cuenca,298,196329,11693,184636,388167,22273
2020/04/01,Albacete,Jaén,16,633564,39909,593655,388167,22273
2020/04/01,Albacete,Murcia,138,1493898,143052,1350846,388167,22273
2020/04/01,Alicante,Valencia,554,2565124,266372,2298752,1858683,171257
2020/04/01,Alicante,Alicante,131049,1858683,170222,1688461,1858683,171257
2020/04/01,Alicante,Albacete,220,388167,22679,365488,1858683,171257
2020/04/01,Alicante,Murcia,1974,1493898,143052,1350846,1858683,171257
2020/04/01,Almería,Almería,51836,716820,63736,653084,716820,65534
2020/04/01,Almería,Murcia,1469,1493898,143052,1350846,716820,65534
2020/04/01,Almería,Granada,166,914678,80119,834559,716820,65534
2020/04/01,Araba,Rioja,887,316798,27519,289279,331549,35234
2020/04/01,Araba,Navarra,60,654183,57986,596197,331549,35234
2020/04/01,Araba,Bizkaia,433,1152934,131241,1021693,331549,35234
2020/04/01,Araba,Burgos,654,357072,25762,331310,331549,35234
2020/04/01,Araba,Araba,25863,331549,32201,299348,331549,35234
2020/04/01,Asturias,Asturias,69050,1022800,91273,931527,1022800,91059
2020/04/01,Asturias,Cantabria,138,580795,52811,527984,1022800,91059
2020/04/01,Asturias,León,31,460001,42318,417683,1022800,91059
2020/04/01,Asturias,Lugo,567,329587,28475,301112,1022800,91059
2020/04/01,Ávila,Ávila,7106,157640,10858,146782,157640,11254
2020/04/01,Ávila,Toledo,89,694844,52659,642185,157640,11254
2020/04/01,Ávila,Salamanca,172,330119,30773,299346,157640,11254
2020/04/01,Ávila,Cáceres,77,394151,24371,369780,157640,11254
2020/04/01,Ávila,Segovia,59,153129,12689,140440,157640,11254
2020/04/01,Ávila,Madrid,69,6663394,608796,6054598,157640,11254
2020/04/01,Badajoz,Cáceres,586,394151,24371,369780,673559,51512
2020/04/01,Badajoz,Huelva,176,521870,45523,476347,673559,51512
2020/04/01,Badajoz,Córdoba,44,782979,65967,717012,673559,51512
2020/04/01,Badajoz,Sevilla,23,1942389,166506,1775883,673559,51512
2020/04/01,Badajoz,Ciudad Real,28,495761,26320,469441,673559,51512
2020/04/01,Badajoz,Badajoz,36141,673559,51996,621563,673559,51512
2020/04/01,Balears,Valencia,39,2565124,266372,2298752,1149460,74426
2020/04/01,Balears,Balears,58426,1149460,73292,1076168,1149460,74426
2020/04/01,Barcelona,Girona,1322,771044,53816,717228,5664579,555521
2020/04/01,Barcelona,Lleida,60,434930,37815,397115,5664579,555521
2020/04/01,Barcelona,Tarragona,633,804664,62577,742087,5664579,555521
2020/04/01,Barcelona,Barcelona,352496,5664579,553242,5111337,5664579,555521
2020/04/01,Bizkaia,Cantabria,737,580795,52811,527984,1152934,128778
2020/04/01,Bizkaia,Bizkaia,95195,1152934,131241,1021693,1152934,128778
2020/04/01,Bizkaia,Gipuzkoa,347,723576,57643,665933,1152934,128778
2020/04/01,Bizkaia,Araba,434,331549,32201,299348,1152934,128778
2020/04/01,Bizkaia,Burgos,19,357072,25762,331310,1152934,128778
2020/04/01,Burgos,Valladolid,72,519546,47897,471649,357072,26233
2020/04/01,Burgos,Cantabria,23,580795,52811,527984,357072,26233
2020/04/01,Burgos,Palencia,140,160866,13797,147069,357072,26233
2020/04/01,Burgos,Burgos,18086,357072,25762,331310,357072,26233
2020/04/01,Burgos,Araba,496,331549,32201,299348,357072,26233
2020/04/01,Cáceres,Ávila,76,157640,10858,146782,394151,24196
2020/04/01,Cáceres,Badajoz,665,673559,51996,621563,394151,24196
2020/04/01,Cáceres,Toledo,81,694844,52659,642185,394151,24196
2020/04/01,Cáceres,Cáceres,14892,394151,24371,369780,394151,24196
2020/04/01,Cádiz,Málaga,498,1661785,122181,1539604,1240155,97266
2020/04/01,Cádiz,Cádiz,75021,1240155,95201,1144954,1240155,97266
2020/04/01,Cádiz,Huelva,599,521870,45523,476347,1240155,97266
2020/04/01,Cádiz,Sevilla,570,1942389,166506,1775883,1240155,97266
2020/04/01,Cantabria,Asturias,108,1022800,91273,931527,580795,51883
2020/04/01,Cantabria,Palencia,28,160866,13797,147069,580795,51883
2020/04/01,Cantabria,Cantabria,36954,580795,52811,527984,580795,51883
2020/04/01,Cantabria,Bizkaia,312,1152934,131241,1021693,580795,51883
2020/04/01,Castellón,Tarragona,430,804664,62577,742087,579962,49048
2020/04/01,Castellón,Teruel,20,134137,5426,128711,579962,49048
2020/04/01,Castellón,Alicante,20,1858683,170222,1688461,579962,49048
2020/04/01,Castellón,Valencia,595,2565124,266372,2298752,579962,49048
2020/04/01,Castellón,Castellón,32987,579962,47024,532938,579962,49048
2020/04/01,Ceuta,Ceuta,6684,84777,7162,77615,84777,7078
2020/04/01,Ciudad Real,Albacete,371,388167,22679,365488,495761,25780
2020/04/01,Ciudad Real,Toledo,59,694844,52659,642185,495761,25780
2020/04/01,Ciudad Real,Ciudad Real,14799,495761,26320,469441,495761,25780
2020/04/01,Ciudad Real,Córdoba,308,782979,65967,717012,495761,25780
2020/04/01,Ciudad Real,Badajoz,35,673559,51996,621563,495761,25780
2020/04/01,Córdoba,Jaén,407,633564,39909,593655,782979,64971
2020/04/01,Córdoba,Córdoba,44626,782979,65967,717012,782979,64971
2020/04/01,Córdoba,Badajoz,45,673559,51996,621563,782979,64971
2020/04/01,Córdoba,Ciudad Real,255,495761,26320,469441,782979,64971
2020/04/01,Córdoba,Sevilla,979,1942389,166506,1775883,782979,64971
2020/04/01,Córdoba,Málaga,56,1661785,122181,1539604,782979,64971
2020/04/01,Córdoba,Granada,89,914678,80119,834559,782979,64971
2020/04/01,Coruña,Coruña,83397,1119596,112121,1007475,1119596,113029
2020/04/01,Coruña,Pontevedra,3288,942665,98711,843954,1119596,113029
2020/04/01,Coruña,Lugo,314,329587,28475,301112,1119596,113029
2020/04/01,Cuenca,Albacete,294,388167,22679,365488,196329,12072
2020/04/01,Cuenca,Valencia,54,2565124,266372,2298752,196329,12072
2020/04/01,Cuenca,Cuenca,5630,196329,11693,184636,196329,12072
2020/04/01,Cuenca,Toledo,72,694844,52659,642185,196329,12072
2020/04/01,Cuenca,Madrid,45,6663394,608796,6054598,196329,12072
2020/04/01,Cuenca,Ciudad Real,33,495761,26320,469441,196329,12072
2020/04/01,Gipuzkoa,Gipuzkoa,42307,723576,57643,665933,723576,59389
2020/04/01,Gipuzkoa,Araba,35,331549,32201,299348,723576,59389
2020/04/01,Gipuzkoa,Navarra,125,654183,57986,596197,723576,59389
2020/04/01,Gipuzkoa,Bizkaia,503,1152934,131241,1021693,723576,59389
2020/04/01,Girona,Barcelona,1365,5664579,553242,5111337,771044,56438
2020/04/01,Girona,Girona,34199,771044,53816,717228,771044,56438
2020/04/01,Girona,Lleida,102,434930,37815,397115,771044,56438
2020/04/01,Granada,Almería,176,716820,63736,653084,914678,79078
2020/04/01,Granada,Córdoba,129,782979,65967,717012,914678,79078
2020/04/01,Granada,Granada,58000,914678,80119,834559,914678,79078
2020/04/01,Granada,Málaga,111,1661785,122181,1539604,914678,79078
2020/04/01,Guadalajara,Guadalajara,13277,257762,22302,235460,257762,22347
2020/04/01,Guadalajara,Cuenca,32,196329,11693,184636,257762,22347
2020/04/01,Guadalajara,Madrid,1001,6663394,608796,6054598,257762,22347
2020/04/01,Huelva,Badajoz,302,673559,51996,621563,521870,47188
2020/04/01,Huelva,Sevilla,740,1942389,166506,1775883,521870,47188
2020/04/01,Huelva,Cádiz,417,1240155,95201,1144954,521870,47188
2020/04/01,Huelva,Huelva,32758,521870,45523,476347,521870,47188
2020/04/01,Huesca,Zaragoza,103,964724,95791,868933,220461,18016
2020/04/01,Huesca,Huesca,10631,220461,16522,203939,220461,18016
2020/04/01,Huesca,Lleida,238,434930,37815,397115,220461,18016
2020/04/01,Jaén,Córdoba,438,782979,65967,717012,633564,39118
2020/04/01,Jaén,Albacete,46,388167,22679,365488,633564,39118
2020/04/01,Jaén,Granada,95,914678,80119,834559,633564,39118
2020/04/01,Jaén,Jaén,26374,633564,39909,593655,633564,39118
2020/04/01,Las Palmas de Gran Canaria,Las Palmas de Gran Canaria,83938,1120406,98942,1021464,1120406,98019
2020/04/01,León,Ourense,59,307651,31800,275851,460001,41699
2020/04/01,León,León,29986,460001,42318,417683,460001,41699
2020/04/01,León,Zamora,117,172539,14587,157952,460001,41699
2020/04/01,Lleida,Lleida,22601,434930,37815,397115,434930,36379
2020/04/01,Lleida,Girona,59,771044,53816,717228,434930,36379
2020/04/01,Lleida,Huesca,278,220461,16522,203939,434930,36379
2020/04/01,Lleida,Zaragoza,70,964724,95791,868933,434930,36379
2020/04/01,Lleida,Barcelona,73,5664579,553242,5111337,434930,36379
2020/04/01,Lugo,Ourense,93,307651,31800,275851,329587,28844
2020/04/01,Lugo,Asturias,435,1022800,91273,931527,329587,28844
2020/04/01,Lugo,Lugo,19436,329587,28475,301112,329587,28844
2020/04/01,Lugo,Coruña,324,1119596,112121,1007475,329587,28844
2020/04/01,Madrid,Ávila,85,157640,10858,146782,6663394,609187
2020/04/01,Madrid,Guadalajara,1306,257762,22302,235460,6663394,609187
2020/04/01,Madrid,Madrid,368525,6663394,608796,6054598,6663394,609187
2020/04/01,Madrid,Toledo,2191,694844,52659,642185,6663394,609187
2020/04/01,Madrid,Cuenca,46,196329,11693,184636,6663394,609187
2020/04/01,Málaga,Sevilla,39,1942389,166506,1775883,1661785,122539
2020/04/01,Málaga,Málaga,93940,1661785,122181,1539604,1661785,122539
2020/04/01,Málaga,Melilla,20,86487,9417,77070,1661785,122539
2020/04/01,Málaga,Córdoba,73,782979,65967,717012,1661785,122539
2020/04/01,Málaga,Almería,18,716820,63736,653084,1661785,122539
2020/04/01,Málaga,Granada,85,914678,80119,834559,1661785,122539
2020/04/01,Málaga,Cádiz,473,1240155,95201,1144954,1661785,122539
2020/04/01,Melilla,Melilla,9101,86487,9417,77070,86487,9335
2020/04/01,Murcia,Albacete,159,388167,22679,365488,1493898,142562
2020/04/01,Murcia,Granada,63,914678,80119,834559,1493898,142562
2020/04/01,Murcia,Alicante,1785,1858683,170222,1688461,1493898,142562
2020/04/01,Murcia,Almería,936,716820,63736,653084,1493898,142562
2020/04/01,Murcia,Murcia,106189,1493898,143052,1350846,1493898,142562
2020/04/01,Navarra,Zaragoza,314,964724,95791,868933,654183,59030
2020/04/01,Navarra,Rioja,1252,316798,27519,289279,654183,59030
2020/04/01,Navarra,Navarra,39132,654183,57986,596197,654183,59030
2020/04/01,Navarra,Gipuzkoa,115,723576,57643,665933,654183,59030
2020/04/01,Navarra,Araba,16,331549,32201,299348,654183,59030
2020/04/01,Ourense,Ourense,23899,307651,31800,275851,307651,31917
2020/04/01,Ourense,Pontevedra,90,942665,98711,843954,307651,31917
2020/04/01,Ourense,Lugo,103,329587,28475,301112,307651,31917
2020/04/01,Ourense,León,76,460001,42318,417683,307651,31917
2020/04/01,Palencia,Cantabria,45,580795,52811,527984,160866,14445
2020/04/01,Palencia,Palencia,9341,160866,13797,147069,160866,14445
2020/04/01,Palencia,Burgos,143,357072,25762,331310,160866,14445
2020/04/01,Pontevedra,Ourense,147,307651,31800,275851,942665,98594
2020/04/01,Pontevedra,Lugo,24,329587,28475,301112,942665,98594
2020/04/01,Pontevedra,Pontevedra,74364,942665,98711,843954,942665,98594
2020/04/01,Pontevedra,Coruña,3041,1119596,112121,1007475,942665,98594
2020/04/01,Rioja,Navarra,1119,654183,57986,596197,316798,26551
2020/04/01,Rioja,Araba,337,331549,32201,299348,316798,26551
2020/04/01,Rioja,Rioja,19188,316798,27519,289279,316798,26551
2020/04/01,Salamanca,Zamora,32,172539,14587,157952,330119,30211
2020/04/01,Salamanca,Ávila,186,157640,10858,146782,330119,30211
2020/04/01,Salamanca,Salamanca,22926,330119,30773,299346,330119,30211
2020/04/01,Santa Cruz de Tenerife,Santa Cruz de Tenerife,75870,1032983,91255,941728,1032983,90812
2020/04/01,Segovia,Ávila,51,157640,10858,146782,153129,13482
2020/04/01,Segovia,Valladolid,150,519546,47897,471649,153129,13482
2020/04/01,Segovia,Segovia,8067,153129,12689,140440,153129,13482
2020/04/01,Segovia,Burgos,32,357072,25762,331310,153129,13482
2020/04/01,Sevilla,Málaga,71,1661785,122181,1539604,1942389,164230
2020/04/01,Sevilla,Cádiz,430,1240155,95201,1144954,1942389,164230
2020/04/01,Sevilla,Huelva,215,521870,45523,476347,1942389,164230
2020/04/01,Sevilla,Sevilla,107056,1942389,166506,1775883,1942389,164230
2020/04/01,Sevilla,Córdoba,995,782979,65967,717012,1942389,164230
2020/04/01,Soria,Valladolid,25,519546,47897,471649,88636,5178
2020/04/01,Soria,Soria,3366,88636,4980,83656,88636,5178
2020/04/01,Soria,Zaragoza,30,964724,95791,868933,88636,5178
2020/04/01,Tarragona,Barcelona,454,5664579,553242,5111337,804664,61938
2020/04/01,Tarragona,Tarragona,39113,804664,62577,742087,804664,61938
2020/04/01,Tarragona,Castellón,467,579962,47024,532938,804664,61938
2020/04/01,Teruel,Zaragoza,16,964724,95791,868933,134137,5937
2020/04/01,Teruel,Tarragona,39,804664,62577,742087,134137,5937
2020/04/01,Teruel,Teruel,2519,134137,5426,128711,134137,5937
2020/04/01,Toledo,Cáceres,106,394151,24371,369780,694844,52180
2020/04/01,Toledo,Ciudad Real,136,495761,26320,469441,694844,52180
2020/04/01,Toledo,Ávila,128,157640,10858,146782,694844,52180
2020/04/01,Toledo,Madrid,2174,6663394,608796,6054598,694844,52180
2020/04/01,Toledo,Toledo,27011,694844,52659,642185,694844,52180
2020/04/01,Valencia,Alicante,703,1858683,170222,1688461,2565124,261154
2020/04/01,Valencia,Valencia,177301,2565124,266372,2298752,2565124,261154
2020/04/01,Valencia,Albacete,233,388167,22679,365488,2565124,261154
2020/04/01,Valencia,Castellón,405,579962,47024,532938,2565124,261154
2020/04/01,Valencia,Cuenca,61,196329,11693,184636,2565124,261154
2020/04/01,Valladolid,Burgos,72,357072,25762,331310,519546,46819
2020/04/01,Valladolid,León,32,460001,42318,417683,519546,46819
2020/04/01,Valladolid,Ávila,25,157640,10858,146782,519546,46819
2020/04/01,Valladolid,Valladolid,32112,519546,47897,471649,519546,46819
2020/04/01,Valladolid,Segovia,136,153129,12689,140440,519546,46819
2020/04/01,Valladolid,Zamora,31,172539,14587,157952,519546,46819
2020/04/01,Valladolid,Soria,26,88636,4980,83656,519546,46819
2020/04/01,Valladolid,Salamanca,141,330119,30773,299346,519546,46819
2020/04/01,Zamora,Salamanca,19,330119,30773,299346,172539,14507
2020/04/01,Zamora,León,22,460001,42318,417683,172539,14507
2020/04/01,Zamora,Zamora,9788,172539,14587,157952,172539,14507
2020/04/01,Zaragoza,Huesca,108,220461,16522,203939,964724,91784
2020/04/01,Zaragoza,Navarra,229,654183,57986,596197,964724,91784
2020/04/01,Zaragoza,Zaragoza,68381,964724,95791,868933,964724,91784
2020/04/01,Zaragoza,Lleida,63,434930,37815,397115,964724,91784
2020/04/02,Albacete,Valencia,305,2565124,270586,2294538,388167,22840
2020/04/02,Albacete,Albacete,13530,388167,22733,365434,388167,22840
2020/04/02,Albacete,Cuenca,361,196329,12331,183998,388167,22840
2020/04/02,Albacete,Ciudad Real,480,495761,27693,468068,388167,22840
2020/04/02,Albacete,Jaén,42,633564,40718,592846,388167,22840
2020/04/02,Albacete,Murcia,145,1493898,145197,1348701,388167,22840
2020/04/02,Albacete,Alicante,144,1858683,170699,1687984,388167,22840
2020/04/02,Alicante,Albacete,197,388167,22733,365434,1858683,172927
2020/04/02,Alicante,Alicante,131773,1858683,170699,1687984,1858683,172927
2020/04/02,Alicante,Murcia,2038,1493898,145197,1348701,1858683,172927
2020/04/02,Alicante,Valencia,472,2565124,270586,2294538,1858683,172927
2020/04/02,Almería,Almería,50447,716820,62691,654129,716820,64423
2020/04/02,Almería,Murcia,1557,1493898,145197,1348701,716820,64423
2020/04/02,Almería,Granada,243,914678,78026,836652,716820,64423
2020/04/02,Araba,Rioja,971,316798,28443,288355,331549,36899
2020/04/02,Araba,Navarra,73,654183,60297,593886,331549,36899
2020/04/02,Araba,Bizkaia,502,1152934,133192,1019742,331549,36899
2020/04/02,Araba,Araba,27083,331549,33529,298020,331549,36899
2020/04/02,Araba,Burgos,760,357072,26344,330728,331549,36899
2020/04/02,Araba,Gipuzkoa,29,723576,59816,663760,331549,36899
2020/04/02,Asturias,Lugo,624,329587,28817,300770,1022800,93094
2020/04/02,Asturias,Asturias,69869,1022800,92624,930176,1022800,93094
2020/04/02,Asturias,Cantabria,117,580795,54318,526477,1022800,93094
2020/04/02,Asturias,León,33,460001,42875,417126,1022800,93094
2020/04/02,Ávila,Madrid,62,6663394,628250,6035144,157640,11553
2020/04/02,Ávila,Toledo,101,694844,54394,640450,157640,11553
2020/04/02,Ávila,Cáceres,49,394151,25097,369054,157640,11553
2020/04/02,Ávila,Segovia,83,153129,12813,140316,157640,11553
2020/04/02,Ávila,Ávila,7267,157640,11088,146552,157640,11553
2020/04/02,Ávila,Salamanca,178,330119,30606,299513,157640,11553
2020/04/02,Badajoz,Huelva,183,521870,45893,475977,673559,51985
2020/04/02,Badajoz,Córdoba,58,782979,65213,717766,673559,51985
2020/04/02,Badajoz,Sevilla,57,1942389,166692,1775697,673559,51985
2020/04/02,Badajoz,Cáceres,588,394151,25097,369054,673559,51985
2020/04/02,Badajoz,Badajoz,36550,673559,52399,621160,673559,51985
2020/04/02,Badajoz,Ciudad Real,40,495761,27693,468068,673559,51985
2020/04/02,Balears,Barcelona,19,5664579,560072,5104507,1149460,76991
2020/04/02,Balears,Balears,60798,1149460,75701,1073759,1149460,76991
2020/04/02,Balears,Valencia,76,2565124,270586,2294538,1149460,76991
2020/04/02,Barcelona,Barcelona,358787,5664579,560072,5104507,5664579,564793
2020/04/02,Barcelona,Tarragona,580,804664,63978,740686,5664579,564793
2020/04/02,Barcelona,Lleida,53,434930,39301,395629,5664579,564793
2020/04/02,Barcelona,Girona,1361,771044,55046,715998,5664579,564793
2020/04/02,Bizkaia,Araba,403,331549,33529,298020,1152934,131128
2020/04/02,Bizkaia,Burgos,20,357072,26344,330728,1152934,131128
2020/04/02,Bizkaia,Bizkaia,97210,1152934,133192,1019742,1152934,131128
2020/04/02,Bizkaia,Gipuzkoa,410,723576,59816,663760,1152934,131128
2020/04/02,Bizkaia,Cantabria,870,580795,54318,526477,1152934,131128
2020/04/02,Burgos,Valladolid,52,519546,48569,470977,357072,27176
2020/04/02,Burgos,Palencia,158,160866,14120,146746,357072,27176
2020/04/02,Burgos,Araba,517,331549,33529,298020,357072,27176
2020/04/02,Burgos,Burgos,18679,357072,26344,330728,357072,27176
2020/04/02,Cáceres,Toledo,88,694844,54394,640450,394151,25063
2020/04/02,Cáceres,Cáceres,15463,394151,25097,369054,394151,25063
2020/04/02,Cáceres,Badajoz,662,673559,52399,621160,394151,25063
2020/04/02,Cáceres,Ávila,92,157640,11088,146552,394151,25063
2020/04/02,Cádiz,Sevilla,500,1942389,166692,1775697,1240155,98560
2020/04/02,Cádiz,Cádiz,76074,1240155,95923,1144232,1240155,98560
2020/04/02,Cádiz,Málaga,464,1661785,121255,1540530,1240155,98560
2020/04/02,Cádiz,Huelva,541,521870,45893,475977,1240155,98560
2020/04/02,Cantabria,Cantabria,37628,580795,54318,526477,580795,53231
2020/04/02,Cantabria,Asturias,117,1022800,92624,930176,580795,53231
2020/04/02,Cantabria,Palencia,28,160866,14120,146746,580795,53231
2020/04/02,Cantabria,Bizkaia,334,1152934,133192,1019742,580795,53231
2020/04/02,Castellón,Teruel,35,134137,5442,128695,579962,49134
2020/04/02,Castellón,Tarragona,609,804664,63978,740686,579962,49134
2020/04/02,Castellón,Castellón,32879,579962,47097,532865,579962,49134
2020/04/02,Castellón,Valencia,555,2565124,270586,2294538,579962,49134
2020/04/02,Ceuta,Ceuta,6567,84777,7006,77771,84777,6972
2020/04/02,Ciudad Real,Albacete,395,388167,22733,365434,495761,26312
2020/04/02,Ciudad Real,Badajoz,40,673559,52399,621160,495761,26312
2020/04/02,Ciudad Real,Toledo,47,694844,54394,640450,495761,26312
2020/04/02,Ciudad Real,Córdoba,261,782979,65213,717766,495761,26312
2020/04/02,Ciudad Real,Ciudad Real,15637,495761,27693,468068,495761,26312
2020/04/02,Córdoba,Córdoba,44498,782979,65213,717766,782979,64233
2020/04/02,Córdoba,Granada,80,914678,78026,836652,782979,64233
2020/04/02,Córdoba,Badajoz,53,673559,52399,621160,782979,64233
2020/04/02,Córdoba,Ciudad Real,196,495761,27693,468068,782979,64233
2020/04/02,Córdoba,Sevilla,912,1942389,166692,1775697,782979,64233
2020/04/02,Córdoba,Jaén,378,633564,40718,592846,782979,64233
2020/04/02,Córdoba,Málaga,36,1661785,121255,1540530,782979,64233
2020/04/02,Coruña,Lugo,335,329587,28817,300770,1119596,112333
2020/04/02,Coruña,Coruña,84478,1119596,113828,1005768,1119596,112333
2020/04/02,Coruña,Pontevedra,3245,942665,100321,842344,1119596,112333
2020/04/02,Cuenca,Cuenca,5669,196329,12331,183998,196329,11939
2020/04/02,Cuenca,Ciudad Real,66,495761,27693,468068,196329,11939
2020/04/02,Cuenca,Toledo,116,694844,54394,640450,196329,11939
2020/04/02,Cuenca,Madrid,25,6663394,628250,6035144,196329,11939
2020/04/02,Cuenca,Guadalajara,18,257762,23022,234740,196329,11939
2020/04/02,Cuenca,Albacete,399,388167,22733,365434,196329,11939
2020/04/02,Cuenca,Valencia,32,2565124,270586,2294538,196329,11939
2020/04/02,Gipuzkoa,Bizkaia,541,1152934,133192,1019742,723576,61583
2020/04/02,Gipuzkoa,Navarra,146,654183,60297,593886,723576,61583
2020/04/02,Gipuzkoa,Gipuzkoa,43697,723576,59816,663760,723576,61583
2020/04/02,Girona,Barcelona,1407,5664579,560072,5104507,771044,57804
2020/04/02,Girona,Lleida,81,434930,39301,395629,771044,57804
2020/04/02,Girona,Girona,35238,771044,55046,715998,771044,57804
2020/04/02,Granada,Almería,200,716820,62691,654129,914678,77114
2020/04/02,Granada,Córdoba,132,782979,65213,717766,914678,77114
2020/04/02,Granada,Málaga,125,1661785,121255,1540530,914678,77114
2020/04/02,Granada,Granada,55942,914678,78026,836652,914678,77114
2020/04/02,Guadalajara,Madrid,1232,6663394,628250,6035144,257762,23021
2020/04/02,Guadalajara,Guadalajara,13673,257762,23022,234740,257762,23021
2020/04/02,Huelva,Sevilla,917,1942389,166692,1775697,521870,47727
2020/04/02,Huelva,Cádiz,408,1240155,95923,1144232,521870,47727
2020/04/02,Huelva,Huelva,32761,521870,45893,475977,521870,47727
2020/04/02,Huelva,Badajoz,266,673559,52399,621160,521870,47727
2020/04/02,Huesca,Zaragoza,145,964724,98238,866486,220461,18520
2020/04/02,Huesca,Huesca,10784,220461,16914,203547,220461,18520
2020/04/02,Huesca,Lleida,385,434930,39301,395629,220461,18520
2020/04/02,Jaén,Córdoba,473,782979,65213,717766,633564,40198
2020/04/02,Jaén,Jaén,27065,633564,40718,592846,633564,40198
2020/04/02,Jaén,Granada,107,914678,78026,836652,633564,40198
2020/04/02,Las Palmas de Gran Canaria,Las Palmas de Gran Canaria,84641,1120406,99282,1021124,1120406,98788
2020/04/02,León,León,30757,460001,42875,417126,460001,42877
2020/04/02,León,Asturias,27,1022800,92624,930176,460001,42877
2020/04/02,León,Zamora,68,172539,14426,158113,460001,42877
2020/04/02,León,Palencia,26,160866,14120,146746,460001,42877
2020/04/02,León,Ourense,76,307651,32644,275007,460001,42877
2020/04/02,Lleida,Zaragoza,67,964724,98238,866486,434930,37809
2020/04/02,Lleida,Tarragona,25,804664,63978,740686,434930,37809
2020/04/02,Lleida,Huesca,297,220461,16914,203547,434930,37809
2020/04/02,Lleida,Girona,62,771044,55046,715998,434930,37809
2020/04/02,Lleida,Lleida,23751,434930,39301,395629,434930,37809
2020/04/02,Lleida,Barcelona,65,5664579,560072,5104507,434930,37809
2020/04/02,Lugo,Coruña,427,1119596,113828,1005768,329587,28655
2020/04/02,Lugo,Lugo,19611,329587,28817,300770,329587,28655
2020/04/02,Lugo,Ourense,105,307651,32644,275007,329587,28655
2020/04/02,Lugo,Asturias,473,1022800,92624,930176,329587,28655
2020/04/02,Madrid,Toledo,2405,694844,54394,640450,6663394,622410
2020/04/02,Madrid,Madrid,380711,6663394,628250,6035144,6663394,622410
2020/04/02,Madrid,Guadalajara,1468,257762,23022,234740,6663394,622410
2020/04/02,Madrid,Cuenca,58,196329,12331,183998,6663394,622410
2020/04/02,Madrid,Ávila,103,157640,11088,146552,6663394,622410
2020/04/02,Málaga,Granada,80,914678,78026,836652,1661785,121717
2020/04/02,Málaga,Cádiz,408,1240155,95923,1144232,1661785,121717
2020/04/02,Málaga,Sevilla,75,1942389,166692,1775697,1661785,121717
2020/04/02,Málaga,Córdoba,149,782979,65213,717766,1661785,121717
2020/04/02,Málaga,Málaga,92986,1661785,121255,1540530,1661785,121717
2020/04/02,Melilla,Melilla,9132,86487,9463,77024,86487,9398
2020/04/02,Melilla,Cádiz,20,1240155,95923,1144232,86487,9398
2020/04/02,Murcia,Almería,994,716820,62691,654129,1493898,145288
2020/04/02,Murcia,Murcia,107720,1493898,145197,1348701,1493898,145288
2020/04/02,Murcia,Albacete,141,388167,22733,365434,1493898,145288
2020/04/02,Murcia,Granada,45,914678,78026,836652,1493898,145288
2020/04/02,Murcia,Alicante,1766,1858683,170699,1687984,1493898,145288
2020/04/02,Navarra,Navarra,40892,654183,60297,593886,654183,61198
2020/04/02,Navarra,Gipuzkoa,142,723576,59816,663760,654183,61198
2020/04/02,Navarra,Zaragoza,324,964724,98238,866486,654183,61198
2020/04/02,Navarra,Rioja,1369,316798,28443,288355,654183,61198
2020/04/02,Navarra,Araba,17,331549,33529,298020,654183,61198
2020/04/02,Ourense,Ourense,24805,307651,32644,275007,307651,32183
2020/04/02,Ourense,Pontevedra,152,942665,100321,842344,307651,32183
2020/04/02,Ourense,León,65,460001,42875,417126,307651,32183
2020/04/02,Ourense,Lugo,120,329587,28817,300770,307651,32183
2020/04/02,Palencia,Burgos,120,357072,26344,330728,160866,14910
2020/04/02,Palencia,Cantabria,122,580795,54318,526477,160866,14910
2020/04/02,Palencia,Palencia,9507,160866,14120,146746,160866,14910
2020/04/02,Pontevedra,Coruña,3075,1119596,113828,1005768,942665,98431
2020/04/02,Pontevedra,Pontevedra,75932,942665,100321,842344,942665,98431
2020/04/02,Pontevedra,Ourense,168,307651,32644,275007,942665,98431
2020/04/02,Rioja,Araba,383,331549,33529,298020,316798,27714
2020/04/02,Rioja,Rioja,19866,316798,28443,288355,316798,27714
2020/04/02,Rioja,Navarra,1286,654183,60297,593886,316798,27714
2020/04/02,Salamanca,Salamanca,23035,330119,30606,299513,330119,30519
2020/04/02,Salamanca,Ávila,113,157640,11088,146552,330119,30519
2020/04/02,Santa Cruz de Tenerife,Santa Cruz de Tenerife,77445,1032983,92735,940248,1032983,92784
2020/04/02,Segovia,Valladolid,165,519546,48569,470977,153129,13331
2020/04/02,Segovia,Ávila,111,157640,11088,146552,153129,13331
2020/04/02,Segovia,Burgos,30,357072,26344,330728,153129,13331
2020/04/02,Segovia,Segovia,8008,153129,12813,140316,153129,13331
2020/04/02,Sevilla,Córdoba,981,782979,65213,717766,1942389,165763
2020/04/02,Sevilla,Cádiz,403,1240155,95923,1144232,1942389,165763
2020/04/02,Sevilla,Huelva,313,521870,45893,475977,1942389,165763
2020/04/02,Sevilla,Málaga,76,1661785,121255,1540530,1942389,165763
2020/04/02,Sevilla,Sevilla,108367,1942389,166692,1775697,1942389,165763
2020/04/02,Soria,Soria,3402,88636,5061,83575,88636,5364
2020/04/02,Soria,Valladolid,28,519546,48569,470977,88636,5364
2020/04/02,Tarragona,Barcelona,526,5664579,560072,5104507,804664,63574
2020/04/02,Tarragona,Tarragona,39979,804664,63978,740686,804664,63574
2020/04/02,Tarragona,Castellón,461,579962,47097,532865,804664,63574
2020/04/02,Teruel,Castellón,29,579962,47097,532865,134137,6135
2020/04/02,Teruel,Tarragona,37,804664,63978,740686,134137,6135
2020/04/02,Teruel,Teruel,2607,134137,5442,128695,134137,6135
2020/04/02,Toledo,Toledo,27549,694844,54394,640450,694844,52976
2020/04/02,Toledo,Cáceres,94,394151,25097,369054,694844,52976
2020/04/02,Toledo,Madrid,2027,6663394,628250,6035144,694844,52976
2020/04/02,Toledo,Ciudad Real,108,495761,27693,468068,694844,52976
2020/04/02,Toledo,Ávila,137,157640,11088,146552,694844,52976
2020/04/02,Valencia,Albacete,216,388167,22733,365434,2565124,266711
2020/04/02,Valencia,Alicante,602,1858683,170699,1687984,2565124,266711
2020/04/02,Valencia,Castellón,412,579962,47097,532865,2565124,266711
2020/04/02,Valencia,Cuenca,108,196329,12331,183998,2565124,266711
2020/04/02,Valencia,Valencia,181122,2565124,270586,2294538,2565124,266711
2020/04/02,Valladolid,Soria,23,88636,5061,83575,519546,47116
2020/04/02,Valladolid,Valladolid,32514,519546,48569,470977,519546,47116
2020/04/02,Valladolid,Ávila,24,157640,11088,146552,519546,47116
2020/04/02,Valladolid,Zamora,63,172539,14426,158113,519546,47116
2020/04/02,Valladolid,León,31,460001,42875,417126,519546,47116
2020/04/02,Valladolid,Segovia,108,153129,12813,140316,519546,47116
2020/04/02,Valladolid,Burgos,96,357072,26344,330728,519546,47116
2020/04/02,Zamora,León,27,460001,42875,417126,172539,14535
2020/04/02,Zamora,Zamora,9485,172539,14426,158113,172539,14535
2020/04/02,Zamora,Valladolid,26,519546,48569,470977,172539,14535
2020/04/02,Zaragoza,Huesca,144,220461,16914,203547,964724,95083
2020/04/02,Zaragoza,Navarra,339,654183,60297,593886,964724,95083
2020/04/02,Zaragoza,Soria,20,88636,5061,83575,964724,95083
2020/04/02,Zaragoza,Zaragoza,70504,964724,98238,866486,964724,95083
2020/04/02,Zaragoza,Teruel,31,134137,5442,128695,964724,95083
2020/04/02,Zaragoza,Lleida,76,434930,39301,395629,964724,95083
2020/04/03,Albacete,Albacete,15556,388167,24822,363345,388167,24960
2020/04/03,Albacete,Murcia,158,1493898,146378,1347520,388167,24960
2020/04/03,Albacete,Ciudad Real,502,495761,28892,466869,388167,24960
2020/04/03,Albacete,Cuenca,335,196329,12605,183724,388167,24960
2020/04/03,Albacete,Valencia,283,2565124,281579,2283545,388167,24960
2020/04/03,Albacete,Alicante,146,1858683,175802,1682881,388167,24960
2020/04/03,Albacete,Jaén,18,633564,43295,590269,388167,24960
2020/04/03,Alicante,Alicante,136539,1858683,175802,1682881,1858683,177636
2020/04/03,Alicante,Valencia,515,2565124,281579,2283545,1858683,177636
2020/04/03,Alicante,Albacete,202,388167,24822,363345,1858683,177636
2020/04/03,Alicante,Murcia,2413,1493898,146378,1347520,1858683,177636
2020/04/03,Almería,Murcia,1622,1493898,146378,1347520,716820,68362
2020/04/03,Almería,Granada,271,914678,81752,832926,716820,68362
2020/04/03,Almería,Almería,54219,716820,66847,649973,716820,68362
2020/04/03,Araba,Gipuzkoa,27,723576,63622,659954,331549,38953
2020/04/03,Araba,Rioja,1032,316798,30607,286191,331549,38953
2020/04/03,Araba,Araba,29024,331549,35749,295800,331549,38953
2020/04/03,Araba,Burgos,880,357072,28618,328454,331549,38953
2020/04/03,Araba,Bizkaia,595,1152934,140584,1012350,331549,38953
2020/04/03,Araba,Navarra,58,654183,64341,589842,331549,38953
2020/04/03,Asturias,Lugo,657,329587,30848,298739,1022800,99677
2020/04/03,Asturias,Asturias,77107,1022800,99638,923162,1022800,99677
2020/04/03,Asturias,León,29,460001,46985,413016,1022800,99677
2020/04/03,Asturias,Cantabria,153,580795,58598,522197,1022800,99677
2020/04/03,Ávila,Madrid,170,6663394,657983,6005411,157640,12643
2020/04/03,Ávila,Salamanca,293,330119,33793,296326,157640,12643
2020/04/03,Ávila,Toledo,156,694844,56419,638425,157640,12643
2020/04/03,Ávila,Segovia,102,153129,13726,139403,157640,12643
2020/04/03,Ávila,Cáceres,91,394151,27027,367124,157640,12643
2020/04/03,Ávila,Ávila,8103,157640,11969,145671,157640,12643
2020/04/03,Badajoz,Córdoba,117,782979,74341,708638,673559,57350
2020/04/03,Badajoz,Cáceres,709,394151,27027,367124,673559,57350
2020/04/03,Badajoz,Ciudad Real,42,495761,28892,466869,673559,57350
2020/04/03,Badajoz,Badajoz,40869,673559,57803,615756,673559,57350
2020/04/03,Badajoz,Sevilla,43,1942389,190195,1752194,673559,57350
2020/04/03,Badajoz,Huelva,200,521870,50652,471218,673559,57350
2020/04/03,Balears,Balears,66472,1149460,81154,1068306,1149460,82039
2020/04/03,Balears,Barcelona,28,5664579,605388,5059191,1149460,82039
2020/04/03,Balears,Valencia,18,2565124,281579,2283545,1149460,82039
2020/04/03,Barcelona,Tarragona,750,804664,71013,733651,5664579,607219
2020/04/03,Barcelona,Barcelona,398488,5664579,605388,5059191,5664579,607219
2020/04/03,Barcelona,Girona,1627,771044,60347,710697,5664579,607219
2020/04/03,Barcelona,Lleida,56,434930,42747,392183,5664579,607219
2020/04/03,Bizkaia,Cantabria,856,580795,58598,522197,1152934,137862
2020/04/03,Bizkaia,Bizkaia,103575,1152934,140584,1012350,1152934,137862
2020/04/03,Bizkaia,Burgos,25,357072,28618,328454,1152934,137862
2020/04/03,Bizkaia,Gipuzkoa,492,723576,63622,659954,1152934,137862
2020/04/03,Bizkaia,Araba,405,331549,35749,295800,1152934,137862
2020/04/03,Burgos,Araba,543,331549,35749,295800,357072,29192
2020/04/03,Burgos,Cantabria,26,580795,58598,522197,357072,29192
2020/04/03,Burgos,Bizkaia,44,1152934,140584,1012350,357072,29192
2020/04/03,Burgos,Segovia,16,153129,13726,139403,357072,29192
2020/04/03,Burgos,Valladolid,86,519546,53315,466231,357072,29192
2020/04/03,Burgos,Palencia,177,160866,15657,145209,357072,29192
2020/04/03,Burgos,Soria,25,88636,5396,83240,357072,29192
2020/04/03,Burgos,Burgos,20744,357072,28618,328454,357072,29192
2020/04/03,Burgos,Rioja,21,316798,30607,286191,357072,29192
2020/04/03,Cáceres,Toledo,105,694844,56419,638425,394151,26839
2020/04/03,Cáceres,Ávila,75,157640,11969,145671,394151,26839
2020/04/03,Cáceres,Badajoz,929,673559,57803,615756,394151,26839
2020/04/03,Cáceres,Cáceres,17112,394151,27027,367124,394151,26839
2020/04/03,Cádiz,Málaga,601,1661785,133320,1528465,1240155,113039
2020/04/03,Cádiz,Sevilla,668,1942389,190195,1752194,1240155,113039
2020/04/03,Cádiz,Cádiz,90102,1240155,111040,1129115,1240155,113039
2020/04/03,Cádiz,Huelva,612,521870,50652,471218,1240155,113039
2020/04/03,Cantabria,Bizkaia,349,1152934,140584,1012350,580795,57422
2020/04/03,Cantabria,Palencia,50,160866,15657,145209,580795,57422
2020/04/03,Cantabria,Asturias,131,1022800,99638,923162,580795,57422
2020/04/03,Cantabria,Cantabria,42052,580795,58598,522197,580795,57422
2020/04/03,Castellón,Castellón,35636,579962,50236,529726,579962,51778
2020/04/03,Castellón,Tarragona,678,804664,71013,733651,579962,51778
2020/04/03,Castellón,Valencia,556,2565124,281579,2283545,579962,51778
2020/04/03,Castellón,Teruel,42,134137,7079,127058,579962,51778
2020/04/03,Ceuta,Ceuta,7469,84777,7901,76876,84777,7921
2020/04/03,Ciudad Real,Toledo,122,694844,56419,638425,495761,28716
2020/04/03,Ciudad Real,Cuenca,28,196329,12605,183724,495761,28716
2020/04/03,Ciudad Real,Badajoz,55,673559,57803,615756,495761,28716
2020/04/03,Ciudad Real,Córdoba,353,782979,74341,708638,495761,28716
2020/04/03,Ciudad Real,Albacete,395,388167,24822,363345,495761,28716
2020/04/03,Ciudad Real,Ciudad Real,17613,495761,28892,466869,495761,28716
2020/04/03,Córdoba,Ciudad Real,215,495761,28892,466869,782979,73455
2020/04/03,Córdoba,Granada,108,914678,81752,832926,782979,73455
2020/04/03,Córdoba,Málaga,86,1661785,133320,1528465,782979,73455
2020/04/03,Córdoba,Sevilla,1311,1942389,190195,1752194,782979,73455
2020/04/03,Córdoba,Córdoba,52271,782979,74341,708638,782979,73455
2020/04/03,Córdoba,Badajoz,58,673559,57803,615756,782979,73455
2020/04/03,Córdoba,Jaén,441,633564,43295,590269,782979,73455
2020/04/03,Coruña,Pontevedra,3700,942665,106864,835801,1119596,120835
2020/04/03,Coruña,Coruña,91902,1119596,119719,999877,1119596,120835
2020/04/03,Coruña,Barcelona,18,5664579,605388,5059191,1119596,120835
2020/04/03,Coruña,Lugo,383,329587,30848,298739,1119596,120835
2020/04/03,Cuenca,Cuenca,6446,196329,12605,183724,196329,12758
2020/04/03,Cuenca,Guadalajara,44,257762,23555,234207,196329,12758
2020/04/03,Cuenca,Toledo,154,694844,56419,638425,196329,12758
2020/04/03,Cuenca,Albacete,523,388167,24822,363345,196329,12758
2020/04/03,Cuenca,Ciudad Real,43,495761,28892,466869,196329,12758
2020/04/03,Cuenca,Madrid,42,6663394,657983,6005411,196329,12758
2020/04/03,Cuenca,Valencia,32,2565124,281579,2283545,196329,12758
2020/04/03,Gipuzkoa,Navarra,184,654183,64341,589842,723576,65011
2020/04/03,Gipuzkoa,Araba,38,331549,35749,295800,723576,65011
2020/04/03,Gipuzkoa,Gipuzkoa,47725,723576,63622,659954,723576,65011
2020/04/03,Gipuzkoa,Bizkaia,593,1152934,140584,1012350,723576,65011
2020/04/03,Girona,Barcelona,1600,5664579,605388,5059191,771044,62674
2020/04/03,Girona,Lleida,102,434930,42747,392183,771044,62674
2020/04/03,Girona,Girona,39996,771044,60347,710697,771044,62674
2020/04/03,Granada,Málaga,101,1661785,133320,1528465,914678,80901
2020/04/03,Granada,Córdoba,212,782979,74341,708638,914678,80901
2020/04/03,Granada,Granada,59076,914678,81752,832926,914678,80901
2020/04/03,Granada,Jaén,199,633564,43295,590269,914678,80901
2020/04/03,Granada,Almería,296,716820,66847,649973,914678,80901
2020/04/03,Guadalajara,Guadalajara,14621,257762,23555,234207,257762,24008
2020/04/03,Guadalajara,Madrid,1271,6663394,657983,6005411,257762,24008
2020/04/03,Huelva,Sevilla,960,1942389,190195,1752194,521870,52609
2020/04/03,Huelva,Huelva,37557,521870,50652,471218,521870,52609
2020/04/03,Huelva,Cádiz,465,1240155,111040,1129115,521870,52609
2020/04/03,Huelva,Badajoz,245,673559,57803,615756,521870,52609
2020/04/03,Huesca,Huesca,12199,220461,18500,201961,220461,19928
2020/04/03,Huesca,Zaragoza,155,964724,106466,858258,220461,19928
2020/04/03,Huesca,Lleida,532,434930,42747,392183,220461,19928
2020/04/03,Jaén,Granada,235,914678,81752,832926,633564,42889
2020/04/03,Jaén,Córdoba,605,782979,74341,708638,633564,42889
2020/04/03,Jaén,Jaén,29110,633564,43295,590269,633564,42889
2020/04/03,Las Palmas de Gran Canaria,Las Palmas de Gran Canaria,95672,1120406,109137,1011269,1120406,108446
2020/04/03,León,Ourense,69,307651,34615,273036,460001,46054
2020/04/03,León,Zamora,110,172539,15609,156930,460001,46054
2020/04/03,León,León,34778,460001,46985,413016,460001,46054
2020/04/03,León,Valladolid,36,519546,53315,466231,460001,46054
2020/04/03,León,Asturias,25,1022800,99638,923162,460001,46054
2020/04/03,Lleida,Zaragoza,71,964724,106466,858258,434930,41142
2020/04/03,Lleida,Barcelona,102,5664579,605388,5059191,434930,41142
2020/04/03,Lleida,Huesca,397,220461,18500,201961,434930,41142
2020/04/03,Lleida,Girona,67,771044,60347,710697,434930,41142
2020/04/03,Lleida,Lleida,26616,434930,42747,392183,434930,41142
2020/04/03,Lleida,Tarragona,21,804664,71013,733651,434930,41142
2020/04/03,Lugo,Coruña,408,1119596,119719,999877,329587,31354
2020/04/03,Lugo,Barcelona,18,5664579,605388,5059191,329587,31354
2020/04/03,Lugo,Ourense,121,307651,34615,273036,329587,31354
2020/04/03,Lugo,Lugo,21950,329587,30848,298739,329587,31354
2020/04/03,Lugo,Asturias,576,1022800,99638,923162,329587,31354
2020/04/03,Madrid,Guadalajara,1390,257762,23555,234207,6663394,660581
2020/04/03,Madrid,Madrid,410358,6663394,657983,6005411,6663394,660581
2020/04/03,Madrid,Toledo,2314,694844,56419,638425,6663394,660581
2020/04/03,Madrid,Cuenca,74,196329,12605,183724,6663394,660581
2020/04/03,Madrid,Ávila,70,157640,11969,145671,6663394,660581
2020/04/03,Málaga,Sevilla,143,1942389,190195,1752194,1661785,133593
2020/04/03,Málaga,Melilla,23,86487,10090,76397,1661785,133593
2020/04/03,Málaga,Málaga,103434,1661785,133320,1528465,1661785,133593
2020/04/03,Málaga,Granada,102,914678,81752,832926,1661785,133593
2020/04/03,Málaga,Córdoba,294,782979,74341,708638,1661785,133593
2020/04/03,Málaga,Cádiz,504,1240155,111040,1129115,1661785,133593
2020/04/03,Melilla,Melilla,9820,86487,10090,76397,86487,10064
2020/04/03,Murcia,Albacete,230,388167,24822,363345,1493898,144882
2020/04/03,Murcia,Granada,51,914678,81752,832926,1493898,144882
2020/04/03,Murcia,Murcia,108986,1493898,146378,1347520,1493898,144882
2020/04/03,Murcia,Alicante,1904,1858683,175802,1682881,1493898,144882
2020/04/03,Murcia,Almería,907,716820,66847,649973,1493898,144882
2020/04/03,Navarra,Navarra,44440,654183,64341,589842,654183,65012
2020/04/03,Navarra,Araba,38,331549,35749,295800,654183,65012
2020/04/03,Navarra,Zaragoza,416,964724,106466,858258,654183,65012
2020/04/03,Navarra,Gipuzkoa,163,723576,63622,659954,654183,65012
2020/04/03,Navarra,Rioja,1581,316798,30607,286191,654183,65012
2020/04/03,Ourense,Lugo,145,329587,30848,298739,307651,34686
2020/04/03,Ourense,Ourense,26979,307651,34615,273036,307651,34686
2020/04/03,Ourense,Pontevedra,122,942665,106864,835801,307651,34686
2020/04/03,Ourense,León,61,460001,46985,413016,307651,34686
2020/04/03,Palencia,Valladolid,47,519546,53315,466231,160866,16504
2020/04/03,Palencia,Palencia,11052,160866,15657,145209,160866,16504
2020/04/03,Palencia,Cantabria,173,580795,58598,522197,160866,16504
2020/04/03,Palencia,Burgos,166,357072,28618,328454,160866,16504
2020/04/03,Pontevedra,Ourense,125,307651,34615,273036,942665,106067
2020/04/03,Pontevedra,Pontevedra,82802,942665,106864,835801,942665,106067
2020/04/03,Pontevedra,Coruña,3263,1119596,119719,999877,942665,106067
2020/04/03,Rioja,Araba,434,331549,35749,295800,316798,29500
2020/04/03,Rioja,Navarra,1305,654183,64341,589842,316798,29500
2020/04/03,Rioja,Rioja,21674,316798,30607,286191,316798,29500
2020/04/03,Salamanca,Salamanca,26122,330119,33793,296326,330119,33167
2020/04/03,Salamanca,Ávila,191,157640,11969,145671,330119,33167
2020/04/03,Salamanca,Zamora,62,172539,15609,156930,330119,33167
2020/04/03,Salamanca,Valladolid,142,519546,53315,466231,330119,33167
2020/04/03,Santa Cruz de Tenerife,Las Palmas de Gran Canaria,16,1120406,109137,1011269,1032983,102197
2020/04/03,Santa Cruz de Tenerife,Santa Cruz de Tenerife,88183,1032983,102724,930259,1032983,102197
2020/04/03,Segovia,Ávila,131,157640,11969,145671,153129,14410
2020/04/03,Segovia,Burgos,52,357072,28618,328454,153129,14410
2020/04/03,Segovia,Valladolid,214,519546,53315,466231,153129,14410
2020/04/03,Segovia,Segovia,9083,153129,13726,139403,153129,14410
2020/04/03,Sevilla,Córdoba,1239,782979,74341,708638,1942389,186948
2020/04/03,Sevilla,Sevilla,128385,1942389,190195,1752194,1942389,186948
2020/04/03,Sevilla,Málaga,58,1661785,133320,1528465,1942389,186948
2020/04/03,Sevilla,Huelva,361,521870,50652,471218,1942389,186948
2020/04/03,Sevilla,Cádiz,496,1240155,111040,1129115,1942389,186948
2020/04/03,Soria,Segovia,17,153129,13726,139403,88636,5508
2020/04/03,Soria,Valladolid,21,519546,53315,466231,88636,5508
2020/04/03,Soria,Soria,3683,88636,5396,83240,88636,5508
2020/04/03,Tarragona,Barcelona,640,5664579,605388,5059191,804664,70394
2020/04/03,Tarragona,Castellón,419,579962,50236,529726,804664,70394
2020/04/03,Tarragona,Tarragona,46223,804664,71013,733651,804664,70394
2020/04/03,Tarragona,Lleida,26,434930,42747,392183,804664,70394
2020/04/03,Tarragona,Teruel,58,134137,7079,127058,804664,70394
2020/04/03,Teruel,Teruel,4117,134137,7079,127058,134137,7637
2020/04/03,Teruel,Castellón,62,579962,50236,529726,134137,7637
2020/04/03,Teruel,Tarragona,48,804664,71013,733651,134137,7637
2020/04/03,Toledo,Toledo,29816,694844,56419,638425,694844,55524
2020/04/03,Toledo,Madrid,2357,6663394,657983,6005411,694844,55524
2020/04/03,Toledo,Ciudad Real,101,495761,28892,466869,694844,55524
2020/04/03,Toledo,Ávila,102,157640,11969,145671,694844,55524
2020/04/03,Toledo,Cuenca,29,196329,12605,183724,694844,55524
2020/04/03,Toledo,Cáceres,193,394151,27027,367124,694844,55524
2020/04/03,Valencia,Albacete,288,388167,24822,363345,2565124,277173
2020/04/03,Valencia,Castellón,431,579962,50236,529726,2565124,277173
2020/04/03,Valencia,Alicante,577,1858683,175802,1682881,2565124,277173
2020/04/03,Valencia,Cuenca,66,196329,12605,183724,2565124,277173
2020/04/03,Valencia,Valencia,191600,2565124,281579,2283545,2565124,277173
2020/04/03,Valladolid,Soria,30,88636,5396,83240,519546,51544
2020/04/03,Valladolid,Segovia,213,153129,13726,139403,519546,51544
2020/04/03,Valladolid,Zamora,116,172539,15609,156930,519546,51544
2020/04/03,Valladolid,Burgos,91,357072,28618,328454,519546,51544
2020/04/03,Valladolid,Valladolid,36915,519546,53315,466231,519546,51544
2020/04/03,Valladolid,León,30,460001,46985,413016,519546,51544
2020/04/03,Zamora,Valladolid,31,519546,53315,466231,172539,15498
2020/04/03,Zamora,Salamanca,35,330119,33793,296326,172539,15498
2020/04/03,Zamora,Ourense,28,307651,34615,273036,172539,15498
2020/04/03,Zamora,Zamora,10717,172539,15609,156930,172539,15498
2020/04/03,Zamora,León,71,460001,46985,413016,172539,15498
2020/04/03,Zaragoza,Teruel,36,134137,7079,127058,964724,102805
2020/04/03,Zaragoza,Huesca,156,220461,18500,201961,964724,102805
2020/04/03,Zaragoza,Zaragoza,78437,964724,106466,858258,964724,102805
2020/04/03,Zaragoza,Navarra,361,654183,64341,589842,964724,102805
2020/04/03,Zaragoza,Lleida,93,434930,42747,392183,964724,102805
2020/04/04,Albacete,Albacete,12262,388167,18761,369406,388167,18785
2020/04/04,Albacete,Alicante,101,1858683,132068,1726615,388167,18785
2020/04/04,Albacete,Jaén,21,633564,35651,597913,388167,18785
2020/04/04,Albacete,Cuenca,243,196329,8999,187330,388167,18785
2020/04/04,Albacete,Ciudad Real,355,495761,21320,474441,388167,18785
2020/04/04,Albacete,Murcia,123,1493898,110617,1383281,388167,18785
2020/04/04,Albacete,Valencia,254,2565124,204234,2360890,388167,18785
2020/04/04,Alicante,Murcia,1749,1493898,110617,1383281,1858683,132961
2020/04/04,Alicante,Valencia,426,2565124,204234,2360890,1858683,132961
2020/04/04,Alicante,Alicante,105261,1858683,132068,1726615,1858683,132961
2020/04/04,Alicante,Albacete,156,388167,18761,369406,1858683,132961
2020/04/04,Almería,Murcia,1201,1493898,110617,1383281,716820,49154
2020/04/04,Almería,Granada,263,914678,63999,850679,716820,49154
2020/04/04,Almería,Almería,37761,716820,48447,668373,716820,49154
2020/04/04,Araba,Rioja,335,316798,20450,296348,331549,26555
2020/04/04,Araba,Araba,21418,331549,25946,305603,331549,26555
2020/04/04,Araba,Burgos,476,357072,20016,337056,331549,26555
2020/04/04,Araba,Bizkaia,356,1152934,104076,1048858,331549,26555
2020/04/04,Asturias,León,23,460001,34563,425438,1022800,71788
2020/04/04,Asturias,Cantabria,119,580795,42828,537967,1022800,71788
2020/04/04,Asturias,Asturias,55461,1022800,71493,951307,1022800,71788
2020/04/04,Asturias,Lugo,418,329587,21671,307916,1022800,71788
2020/04/04,Ávila,Cáceres,43,394151,19636,374515,157640,9198
2020/04/04,Ávila,Ávila,6125,157640,8819,148821,157640,9198
2020/04/04,Ávila,Madrid,51,6663394,491947,6171447,157640,9198
2020/04/04,Ávila,Salamanca,198,330119,24821,305298,157640,9198
2020/04/04,Ávila,Segovia,75,153129,10025,143104,157640,9198
2020/04/04,Ávila,Toledo,143,694844,39333,655511,157640,9198
2020/04/04,Badajoz,Córdoba,92,782979,58737,724242,673559,43264
2020/04/04,Badajoz,Huelva,168,521870,37713,484157,673559,43264
2020/04/04,Badajoz,Badajoz,31495,673559,43683,629876,673559,43264
2020/04/04,Badajoz,Ciudad Real,37,495761,21320,474441,673559,43264
2020/04/04,Badajoz,Cáceres,630,394151,19636,374515,673559,43264
2020/04/04,Balears,Balears,47994,1149460,59618,1089842,1149460,60291
2020/04/04,Balears,Valencia,24,2565124,204234,2360890,1149460,60291
2020/04/04,Barcelona,Tarragona,528,804664,51857,752807,5664579,458948
2020/04/04,Barcelona,Barcelona,326724,5664579,457544,5207035,5664579,458948
2020/04/04,Barcelona,Lleida,46,434930,30553,404377,5664579,458948
2020/04/04,Barcelona,Murcia,17,1493898,110617,1383281,5664579,458948
2020/04/04,Barcelona,Girona,1208,771044,42801,728243,5664579,458948
2020/04/04,Bizkaia,Cantabria,364,580795,42828,537967,1152934,103336
2020/04/04,Bizkaia,Gipuzkoa,243,723576,43355,680221,1152934,103336
2020/04/04,Bizkaia,Bizkaia,81172,1152934,104076,1048858,1152934,103336
2020/04/04,Bizkaia,Araba,318,331549,25946,305603,1152934,103336
2020/04/04,Burgos,Segovia,18,153129,10025,143104,357072,20116
2020/04/04,Burgos,Valladolid,71,519546,38471,481075,357072,20116
2020/04/04,Burgos,Burgos,14528,357072,20016,337056,357072,20116
2020/04/04,Burgos,Cantabria,25,580795,42828,537967,357072,20116
2020/04/04,Burgos,Araba,516,331549,25946,305603,357072,20116
2020/04/04,Burgos,Palencia,121,160866,11695,149171,357072,20116
2020/04/04,Cáceres,Ávila,65,157640,8819,148821,394151,19326
2020/04/04,Cáceres,Cáceres,12026,394151,19636,374515,394151,19326
2020/04/04,Cáceres,Badajoz,635,673559,43683,629876,394151,19326
2020/04/04,Cáceres,Toledo,70,694844,39333,655511,394151,19326
2020/04/04,Cádiz,Sevilla,556,1942389,141981,1800408,1240155,86048
2020/04/04,Cádiz,Cádiz,69200,1240155,84670,1155485,1240155,86048
2020/04/04,Cádiz,Málaga,393,1661785,99894,1561891,1240155,86048
2020/04/04,Cádiz,Huelva,502,521870,37713,484157,1240155,86048
2020/04/04,Cantabria,Cantabria,31798,580795,42828,537967,580795,43105
2020/04/04,Cantabria,Palencia,26,160866,11695,149171,580795,43105
2020/04/04,Cantabria,Asturias,110,1022800,71493,951307,580795,43105
2020/04/04,Cantabria,Bizkaia,277,1152934,104076,1048858,580795,43105
2020/04/04,Castellón,Castellón,26101,579962,36907,543055,579962,37155
2020/04/04,Castellón,Valencia,488,2565124,204234,2360890,579962,37155
2020/04/04,Castellón,Teruel,32,134137,3802,130335,579962,37155
2020/04/04,Castellón,Tarragona,528,804664,51857,752807,579962,37155
2020/04/04,Ceuta,Ceuta,5386,84777,5829,78948,84777,5742
2020/04/04,Ciudad Real,Albacete,377,388167,18761,369406,495761,21209
2020/04/04,Ciudad Real,Ciudad Real,13239,495761,21320,474441,495761,21209
2020/04/04,Ciudad Real,Toledo,71,694844,39333,655511,495761,21209
2020/04/04,Ciudad Real,Badajoz,38,673559,43683,629876,495761,21209
2020/04/04,Ciudad Real,Córdoba,326,782979,58737,724242,495761,21209
2020/04/04,Ciudad Real,Jaén,21,633564,35651,597913,495761,21209
2020/04/04,Córdoba,Córdoba,41866,782979,58737,724242,782979,58211
2020/04/04,Córdoba,Granada,122,914678,63999,850679,782979,58211
2020/04/04,Córdoba,Málaga,152,1661785,99894,1561891,782979,58211
2020/04/04,Córdoba,Ciudad Real,219,495761,21320,474441,782979,58211
2020/04/04,Córdoba,Sevilla,1087,1942389,141981,1800408,782979,58211
2020/04/04,Córdoba,Badajoz,42,673559,43683,629876,782979,58211
2020/04/04,Córdoba,Jaén,625,633564,35651,597913,782979,58211
2020/04/04,Coruña,Pontevedra,2771,942665,75841,866824,1119596,88603
2020/04/04,Coruña,Lugo,261,329587,21671,307916,1119596,88603
2020/04/04,Coruña,Coruña,68710,1119596,87779,1031817,1119596,88603
2020/04/04,Cuenca,Toledo,103,694844,39333,655511,196329,8947
2020/04/04,Cuenca,Albacete,450,388167,18761,369406,196329,8947
2020/04/04,Cuenca,Valencia,34,2565124,204234,2360890,196329,8947
2020/04/04,Cuenca,Cuenca,4796,196329,8999,187330,196329,8947
2020/04/04,Cuenca,Madrid,21,6663394,491947,6171447,196329,8947
2020/04/04,Cuenca,Ciudad Real,71,495761,21320,474441,196329,8947
2020/04/04,Gipuzkoa,Gipuzkoa,32600,723576,43355,680221,723576,43848
2020/04/04,Gipuzkoa,Bizkaia,363,1152934,104076,1048858,723576,43848
2020/04/04,Gipuzkoa,Navarra,65,654183,45309,608874,723576,43848
2020/04/04,Girona,Barcelona,1235,5664579,457544,5207035,771044,44559
2020/04/04,Girona,Girona,28888,771044,42801,728243,771044,44559
2020/04/04,Girona,Lleida,64,434930,30553,404377,771044,44559
2020/04/04,Granada,Córdoba,242,782979,58737,724242,914678,63687
2020/04/04,Granada,Almería,160,716820,48447,668373,914678,63687
2020/04/04,Granada,Málaga,106,1661785,99894,1561891,914678,63687
2020/04/04,Granada,Jaén,318,633564,35651,597913,914678,63687
2020/04/04,Granada,Granada,46206,914678,63999,850679,914678,63687
2020/04/04,Guadalajara,Cuenca,20,196329,8999,187330,257762,15035
2020/04/04,Guadalajara,Guadalajara,9754,257762,15664,242098,257762,15035
2020/04/04,Guadalajara,Madrid,796,6663394,491947,6171447,257762,15035
2020/04/04,Huelva,Huelva,27089,521870,37713,484157,521870,37796
2020/04/04,Huelva,Cádiz,442,1240155,84670,1155485,521870,37796
2020/04/04,Huelva,Badajoz,234,673559,43683,629876,521870,37796
2020/04/04,Huelva,Sevilla,513,1942389,141981,1800408,521870,37796
2020/04/04,Huesca,Lleida,321,434930,30553,404377,220461,12627
2020/04/04,Huesca,Huesca,8398,220461,12650,207811,220461,12627
2020/04/04,Huesca,Zaragoza,73,964724,75363,889361,220461,12627
2020/04/04,Jaén,Granada,187,914678,63999,850679,633564,35208
2020/04/04,Jaén,Córdoba,610,782979,58737,724242,633564,35208
2020/04/04,Jaén,Jaén,24986,633564,35651,597913,633564,35208
2020/04/04,Las Palmas de Gran Canaria,Las Palmas de Gran Canaria,64029,1120406,77297,1043109,1120406,76649
2020/04/04,Las Palmas de Gran Canaria,Santa Cruz de Tenerife,22,1032983,71695,961288,1120406,76649
2020/04/04,León,Asturias,26,1022800,71493,951307,460001,34305
2020/04/04,León,Zamora,89,172539,11822,160717,460001,34305
2020/04/04,León,Ourense,71,307651,25514,282137,460001,34305
2020/04/04,León,Valladolid,26,519546,38471,481075,460001,34305
2020/04/04,León,León,25312,460001,34563,425438,460001,34305
2020/04/04,Lleida,Huesca,283,220461,12650,207811,434930,29994
2020/04/04,Lleida,Barcelona,118,5664579,457544,5207035,434930,29994
2020/04/04,Lleida,Girona,62,771044,42801,728243,434930,29994
2020/04/04,Lleida,Zaragoza,85,964724,75363,889361,434930,29994
2020/04/04,Lleida,Lleida,20226,434930,30553,404377,434930,29994
2020/04/04,Lugo,Coruña,334,1119596,87779,1031817,329587,21971
2020/04/04,Lugo,Lugo,15758,329587,21671,307916,329587,21971
2020/04/04,Lugo,Asturias,415,1022800,71493,951307,329587,21971
2020/04/04,Lugo,Ourense,113,307651,25514,282137,329587,21971
2020/04/04,Madrid,Cuenca,29,196329,8999,187330,6663394,494385
2020/04/04,Madrid,Guadalajara,890,257762,15664,242098,6663394,494385
2020/04/04,Madrid,Ávila,65,157640,8819,148821,6663394,494385
2020/04/04,Madrid,Toledo,1538,694844,39333,655511,6663394,494385
2020/04/04,Madrid,Madrid,340585,6663394,491947,6171447,6663394,494385
2020/04/04,Málaga,Melilla,55,86487,8043,78444,1661785,99615
2020/04/04,Málaga,Sevilla,136,1942389,141981,1800408,1661785,99615
2020/04/04,Málaga,Granada,87,914678,63999,850679,1661785,99615
2020/04/04,Málaga,Málaga,77097,1661785,99894,1561891,1661785,99615
2020/04/04,Málaga,Córdoba,148,782979,58737,724242,1661785,99615
2020/04/04,Málaga,Cádiz,445,1240155,84670,1155485,1661785,99615
2020/04/04,Melilla,Melilla,7731,86487,8043,78444,86487,8081
2020/04/04,Murcia,Barcelona,21,5664579,457544,5207035,1493898,109710
2020/04/04,Murcia,Almería,649,716820,48447,668373,1493898,109710
2020/04/04,Murcia,Granada,54,914678,63999,850679,1493898,109710
2020/04/04,Murcia,Alicante,1461,1858683,132068,1726615,1493898,109710
2020/04/04,Murcia,Albacete,146,388167,18761,369406,1493898,109710
2020/04/04,Murcia,Murcia,81933,1493898,110617,1383281,1493898,109710
2020/04/04,Navarra,Gipuzkoa,80,723576,43355,680221,654183,45163
2020/04/04,Navarra,Navarra,31691,654183,45309,608874,654183,45163
2020/04/04,Navarra,Rioja,662,316798,20450,296348,654183,45163
2020/04/04,Navarra,Zaragoza,260,964724,75363,889361,654183,45163
2020/04/04,Ourense,Ourense,20377,307651,25514,282137,307651,25439
2020/04/04,Ourense,León,67,460001,34563,425438,307651,25439
2020/04/04,Ourense,Pontevedra,116,942665,75841,866824,307651,25439
2020/04/04,Ourense,Lugo,92,329587,21671,307916,307651,25439
2020/04/04,Palencia,Burgos,125,357072,20016,337056,160866,11711
2020/04/04,Palencia,Cantabria,27,580795,42828,537967,160866,11711
2020/04/04,Palencia,Palencia,8279,160866,11695,149171,160866,11711
2020/04/04,Palencia,Valladolid,25,519546,38471,481075,160866,11711
2020/04/04,Pontevedra,Ourense,120,307651,25514,282137,942665,75837
2020/04/04,Pontevedra,Pontevedra,59738,942665,75841,866824,942665,75837
2020/04/04,Pontevedra,Coruña,2638,1119596,87779,1031817,942665,75837
2020/04/04,Pontevedra,Lugo,27,329587,21671,307916,942665,75837
2020/04/04,Rioja,Navarra,848,654183,45309,608874,316798,20399
2020/04/04,Rioja,Rioja,14943,316798,20450,296348,316798,20399
2020/04/04,Rioja,Araba,316,331549,25946,305603,316798,20399
2020/04/04,Salamanca,Valladolid,32,519546,38471,481075,330119,24738
2020/04/04,Salamanca,Ávila,103,157640,8819,148821,330119,24738
2020/04/04,Salamanca,Salamanca,19346,330119,24821,305298,330119,24738
2020/04/04,Santa Cruz de Tenerife,Santa Cruz de Tenerife,59114,1032983,71695,961288,1032983,71262
2020/04/04,Segovia,Segovia,6791,153129,10025,143104,153129,10197
2020/04/04,Segovia,Valladolid,157,519546,38471,481075,153129,10197
2020/04/04,Segovia,Burgos,33,357072,20016,337056,153129,10197
2020/04/04,Segovia,Ávila,99,157640,8819,148821,153129,10197
2020/04/04,Sevilla,Badajoz,29,673559,43683,629876,1942389,141192
2020/04/04,Sevilla,Málaga,66,1661785,99894,1561891,1942389,141192
2020/04/04,Sevilla,Córdoba,1198,782979,58737,724242,1942389,141192
2020/04/04,Sevilla,Huelva,257,521870,37713,484157,1942389,141192
2020/04/04,Sevilla,Cádiz,512,1240155,84670,1155485,1942389,141192
2020/04/04,Sevilla,Sevilla,99673,1942389,141981,1800408,1942389,141192
2020/04/04,Soria,Valladolid,23,519546,38471,481075,88636,3706
2020/04/04,Soria,Soria,2553,88636,3706,84930,88636,3706
2020/04/04,Tarragona,Castellón,361,579962,36907,543055,804664,51195
2020/04/04,Tarragona,Lleida,17,434930,30553,404377,804664,51195
2020/04/04,Tarragona,Tarragona,34676,804664,51857,752807,804664,51195
2020/04/04,Tarragona,Zaragoza,17,964724,75363,889361,804664,51195
2020/04/04,Tarragona,Barcelona,424,5664579,457544,5207035,804664,51195
2020/04/04,Teruel,Tarragona,50,804664,51857,752807,134137,3850
2020/04/04,Teruel,Teruel,1771,134137,3802,130335,134137,3850
2020/04/04,Teruel,Zaragoza,37,964724,75363,889361,134137,3850
2020/04/04,Teruel,Castellón,26,579962,36907,543055,134137,3850
2020/04/04,Toledo,Ávila,116,157640,8819,148821,694844,39186
2020/04/04,Toledo,Cáceres,141,394151,19636,374515,694844,39186
2020/04/04,Toledo,Toledo,22068,694844,39333,655511,694844,39186
2020/04/04,Toledo,Madrid,1902,6663394,491947,6171447,694844,39186
2020/04/04,Toledo,Ciudad Real,76,495761,21320,474441,694844,39186
2020/04/04,Valencia,Valencia,145490,2565124,204234,2360890,2565124,202439
2020/04/04,Valencia,Castellón,345,579962,36907,543055,2565124,202439
2020/04/04,Valencia,Alicante,351,1858683,132068,1726615,2565124,202439
2020/04/04,Valencia,Cuenca,60,196329,8999,187330,2565124,202439
2020/04/04,Valencia,Albacete,158,388167,18761,369406,2565124,202439
2020/04/04,Valladolid,Valladolid,26718,519546,38471,481075,519546,37807
2020/04/04,Valladolid,Burgos,79,357072,20016,337056,519546,37807
2020/04/04,Valladolid,Zamora,76,172539,11822,160717,519546,37807
2020/04/04,Valladolid,Segovia,135,153129,10025,143104,519546,37807
2020/04/04,Valladolid,Soria,27,88636,3706,84930,519546,37807
2020/04/04,Valladolid,León,31,460001,34563,425438,519546,37807
2020/04/04,Zamora,León,49,460001,34563,425438,172539,11694
2020/04/04,Zamora,Valladolid,46,519546,38471,481075,172539,11694
2020/04/04,Zamora,Zamora,8258,172539,11822,160717,172539,11694
2020/04/04,Zamora,Salamanca,34,330119,24821,305298,172539,11694
2020/04/04,Zaragoza,Zaragoza,56277,964724,75363,889361,964724,73495
2020/04/04,Zaragoza,Huesca,97,220461,12650,207811,964724,73495
2020/04/04,Zaragoza,Lleida,51,434930,30553,404377,964724,73495
2020/04/04,Zaragoza,Navarra,221,654183,45309,608874,964724,73495
2020/04/05,Albacete,Albacete,15083,388167,19245,368922,388167,19011
2020/04/05,Albacete,Ciudad Real,237,495761,16097,479664,388167,19011
2020/04/05,Albacete,Murcia,70,1493898,81773,1412125,388167,19011
2020/04/05,Albacete,Valencia,185,2565124,158161,2406963,388167,19011
2020/04/05,Albacete,Cuenca,73,196329,5919,190410,388167,19011
2020/04/05,Albacete,Alicante,88,1858683,107348,1751335,388167,19011
2020/04/05,Albacete,Jaén,37,633564,31239,602325,388167,19011
2020/04/05,Alicante,Alicante,88867,1858683,107348,1751335,1858683,107488
2020/04/05,Alicante,Murcia,1528,1493898,81773,1412125,1858683,107488
2020/04/05,Alicante,Valencia,444,2565124,158161,2406963,1858683,107488
2020/04/05,Alicante,Albacete,140,388167,19245,368922,1858683,107488
2020/04/05,Almería,Almería,22311,716820,29413,687407,716820,29035
2020/04/05,Almería,Granada,310,914678,54940,859738,716820,29035
2020/04/05,Almería,Murcia,388,1493898,81773,1412125,716820,29035
2020/04/05,Almería,Melilla,17,86487,5603,80884,716820,29035
2020/04/05,Araba,Araba,17982,331549,21058,310491,331549,21756
2020/04/05,Araba,Bizkaia,267,1152934,89640,1063294,331549,21756
2020/04/05,Araba,Rioja,242,316798,15281,301517,331549,21756
2020/04/05,Araba,Burgos,620,357072,15010,342062,331549,21756
2020/04/05,Asturias,Lugo,452,329587,16078,313509,1022800,53821
2020/04/05,Asturias,Asturias,42290,1022800,53613,969187,1022800,53821
2020/04/05,Asturias,León,16,460001,26605,433396,1022800,53821
2020/04/05,Asturias,Cantabria,155,580795,34069,546726,1022800,53821
2020/04/05,Ávila,Toledo,51,694844,28822,666022,157640,7331
2020/04/05,Ávila,Segovia,78,153129,7695,145434,157640,7331
2020/04/05,Ávila,Ávila,4988,157640,7105,150535,157640,7331
2020/04/05,Ávila,Salamanca,199,330119,20711,309408,157640,7331
2020/04/05,Ávila,Cáceres,50,394151,15829,378322,157640,7331
2020/04/05,Badajoz,Huelva,192,521870,30508,491362,673559,34066
2020/04/05,Badajoz,Cáceres,487,394151,15829,378322,673559,34066
2020/04/05,Badajoz,Córdoba,72,782979,51489,731490,673559,34066
2020/04/05,Badajoz,Badajoz,26018,673559,34451,639108,673559,34066
2020/04/05,Badajoz,Sevilla,34,1942389,115524,1826865,673559,34066
2020/04/05,Badajoz,Ciudad Real,44,495761,16097,479664,673559,34066
2020/04/05,Balears,Balears,39258,1149460,48285,1101175,1149460,48170
2020/04/05,Barcelona,Alicante,20,1858683,107348,1751335,5664579,372837
2020/04/05,Barcelona,Tarragona,302,804664,40246,764418,5664579,372837
2020/04/05,Barcelona,Girona,1025,771044,32377,738667,5664579,372837
2020/04/05,Barcelona,Huesca,19,220461,9933,210528,5664579,372837
2020/04/05,Barcelona,Barcelona,276432,5664579,371678,5292901,5664579,372837
2020/04/05,Barcelona,Lleida,30,434930,23293,411637,5664579,372837
2020/04/05,Bizkaia,Gipuzkoa,297,723576,34113,689463,1152934,89956
2020/04/05,Bizkaia,Bizkaia,73635,1152934,89640,1063294,1152934,89956
2020/04/05,Bizkaia,Araba,228,331549,21058,310491,1152934,89956
2020/04/05,Bizkaia,Cantabria,373,580795,34069,546726,1152934,89956
2020/04/05,Burgos,Araba,346,331549,21058,310491,357072,15023
2020/04/05,Burgos,Palencia,181,160866,9424,151442,357072,15023
2020/04/05,Burgos,Valladolid,51,519546,30191,489355,357072,15023
2020/04/05,Burgos,Burgos,11087,357072,15010,342062,357072,15023
2020/04/05,Cáceres,Toledo,54,694844,28822,666022,394151,15608
2020/04/05,Cáceres,Badajoz,479,673559,34451,639108,394151,15608
2020/04/05,Cáceres,Sevilla,18,1942389,115524,1826865,394151,15608
2020/04/05,Cáceres,Ávila,43,157640,7105,150535,394151,15608
2020/04/05,Cáceres,Granada,16,914678,54940,859738,394151,15608
2020/04/05,Cáceres,Cáceres,10308,394151,15829,378322,394151,15608
2020/04/05,Cádiz,Cádiz,62157,1240155,73214,1166941,1240155,73275
2020/04/05,Cádiz,Sevilla,396,1942389,115524,1826865,1240155,73275
2020/04/05,Cádiz,Málaga,371,1661785,79639,1582146,1240155,73275
2020/04/05,Cádiz,Huelva,602,521870,30508,491362,1240155,73275
2020/04/05,Cantabria,Cantabria,26103,580795,34069,546726,580795,33771
2020/04/05,Cantabria,Asturias,112,1022800,53613,969187,580795,33771
2020/04/05,Cantabria,Palencia,28,160866,9424,151442,580795,33771
2020/04/05,Cantabria,Bizkaia,304,1152934,89640,1063294,580795,33771
2020/04/05,Castellón,Castellón,21375,579962,28744,551218,579962,29056
2020/04/05,Castellón,Valencia,421,2565124,158161,2406963,579962,29056
2020/04/05,Castellón,Tarragona,499,804664,40246,764418,579962,29056
2020/04/05,Castellón,Teruel,19,134137,2770,131367,579962,29056
2020/04/05,Ceuta,Ceuta,3893,84777,4146,80631,84777,4121
2020/04/05,Ceuta,Cádiz,18,1240155,73214,1166941,84777,4121
2020/04/05,Ciudad Real,Albacete,334,388167,19245,368922,495761,16422
2020/04/05,Ciudad Real,Ciudad Real,10841,495761,16097,479664,495761,16422
2020/04/05,Ciudad Real,Córdoba,483,782979,51489,731490,495761,16422
2020/04/05,Ciudad Real,Badajoz,52,673559,34451,639108,495761,16422
2020/04/05,Ciudad Real,Jaén,17,633564,31239,602325,495761,16422
2020/04/05,Córdoba,Badajoz,113,673559,34451,639108,782979,51200
2020/04/05,Córdoba,Granada,173,914678,54940,859738,782979,51200
2020/04/05,Córdoba,Córdoba,39702,782979,51489,731490,782979,51200
2020/04/05,Córdoba,Málaga,69,1661785,79639,1582146,782979,51200
2020/04/05,Córdoba,Jaén,596,633564,31239,602325,782979,51200
2020/04/05,Córdoba,Ciudad Real,212,495761,16097,479664,782979,51200
2020/04/05,Córdoba,Sevilla,762,1942389,115524,1826865,782979,51200
2020/04/05,Coruña,Lugo,204,329587,16078,313509,1119596,67486
2020/04/05,Coruña,Coruña,52919,1119596,67384,1052212,1119596,67486
2020/04/05,Coruña,Pontevedra,2470,942665,57942,884723,1119596,67486
2020/04/05,Cuenca,Cuenca,3165,196329,5919,190410,196329,6113
2020/04/05,Cuenca,Albacete,345,388167,19245,368922,196329,6113
2020/04/05,Cuenca,Valencia,46,2565124,158161,2406963,196329,6113
2020/04/05,Cuenca,Guadalajara,21,257762,13049,244713,196329,6113
2020/04/05,Cuenca,Madrid,21,6663394,402057,6261337,196329,6113
2020/04/05,Gipuzkoa,Gipuzkoa,26636,723576,34113,689463,723576,34916
2020/04/05,Gipuzkoa,Cádiz,20,1240155,73214,1166941,723576,34916
2020/04/05,Gipuzkoa,Bizkaia,229,1152934,89640,1063294,723576,34916
2020/04/05,Gipuzkoa,Huelva,32,521870,30508,491362,723576,34916
2020/04/05,Gipuzkoa,Navarra,75,654183,35066,619117,723576,34916
2020/04/05,Girona,Girona,22589,771044,32377,738667,771044,33593
2020/04/05,Girona,Lleida,62,434930,23293,411637,771044,33593
2020/04/05,Girona,Barcelona,931,5664579,371678,5292901,771044,33593
2020/04/05,Girona,Tarragona,21,804664,40246,764418,771044,33593
2020/04/05,Granada,Málaga,80,1661785,79639,1582146,914678,54395
2020/04/05,Granada,Almería,276,716820,29413,687407,914678,54395
2020/04/05,Granada,Jaén,261,633564,31239,602325,914678,54395
2020/04/05,Granada,Córdoba,244,782979,51489,731490,914678,54395
2020/04/05,Granada,Granada,40740,914678,54940,859738,914678,54395
2020/04/05,Guadalajara,Madrid,632,6663394,402057,6261337,257762,12956
2020/04/05,Guadalajara,Guadalajara,8614,257762,13049,244713,257762,12956
2020/04/05,Huelva,Huelva,23255,521870,30508,491362,521870,30195
2020/04/05,Huelva,Badajoz,190,673559,34451,639108,521870,30195
2020/04/05,Huelva,Sevilla,351,1942389,115524,1826865,521870,30195
2020/04/05,Huelva,Cádiz,568,1240155,73214,1166941,521870,30195
2020/04/05,Huesca,Lleida,383,434930,23293,411637,220461,10196
2020/04/05,Huesca,Huesca,6947,220461,9933,210528,220461,10196
2020/04/05,Jaén,Granada,296,914678,54940,859738,633564,30476
2020/04/05,Jaén,Córdoba,413,782979,51489,731490,633564,30476
2020/04/05,Jaén,Almería,19,716820,29413,687407,633564,30476
2020/04/05,Jaén,Jaén,22816,633564,31239,602325,633564,30476
2020/04/05,Las Palmas de Gran Canaria,Bizkaia,17,1152934,89640,1063294,1120406,57952
2020/04/05,Las Palmas de Gran Canaria,Alicante,26,1858683,107348,1751335,1120406,57952
2020/04/05,Las Palmas de Gran Canaria,Las Palmas de Gran Canaria,48206,1120406,58016,1062390,1120406,57952
2020/04/05,León,Asturias,38,1022800,53613,969187,460001,26582
2020/04/05,León,León,20027,460001,26605,433396,460001,26582
2020/04/05,Lleida,Zaragoza,42,964724,55974,908750,434930,22660
2020/04/05,Lleida,Huesca,212,220461,9933,210528,434930,22660
2020/04/05,Lleida,Lleida,15402,434930,23293,411637,434930,22660
2020/04/05,Lleida,Barcelona,60,5664579,371678,5292901,434930,22660
2020/04/05,Lleida,Girona,72,771044,32377,738667,434930,22660
2020/04/05,Lugo,Ourense,29,307651,19772,287879,329587,16180
2020/04/05,Lugo,Asturias,331,1022800,53613,969187,329587,16180
2020/04/05,Lugo,Coruña,213,1119596,67384,1052212,329587,16180
2020/04/05,Lugo,Lugo,11698,329587,16078,313509,329587,16180
2020/04/05,Madrid,Albacete,24,388167,19245,368922,6663394,404427
2020/04/05,Madrid,Madrid,288576,6663394,402057,6261337,6663394,404427
2020/04/05,Madrid,Toledo,1271,694844,28822,666022,6663394,404427
2020/04/05,Madrid,Alicante,16,1858683,107348,1751335,6663394,404427
2020/04/05,Madrid,Granada,19,914678,54940,859738,6663394,404427
2020/04/05,Madrid,Segovia,18,153129,7695,145434,6663394,404427
2020/04/05,Madrid,Cuenca,32,196329,5919,190410,6663394,404427
2020/04/05,Madrid,Ávila,21,157640,7105,150535,6663394,404427
2020/04/05,Madrid,Cáceres,17,394151,15829,378322,6663394,404427
2020/04/05,Madrid,Guadalajara,683,257762,13049,244713,6663394,404427
2020/04/05,Málaga,Cádiz,472,1240155,73214,1166941,1661785,79516
2020/04/05,Málaga,Málaga,63908,1661785,79639,1582146,1661785,79516
2020/04/05,Málaga,Granada,64,914678,54940,859738,1661785,79516
2020/04/05,Málaga,Sevilla,105,1942389,115524,1826865,1661785,79516
2020/04/05,Málaga,Córdoba,131,782979,51489,731490,1661785,79516
2020/04/05,Melilla,Melilla,5462,86487,5603,80884,86487,5602
2020/04/05,Murcia,Almería,592,716820,29413,687407,1493898,81216
2020/04/05,Murcia,Alicante,1235,1858683,107348,1751335,1493898,81216
2020/04/05,Murcia,Albacete,77,388167,19245,368922,1493898,81216
2020/04/05,Murcia,Valencia,18,2565124,158161,2406963,1493898,81216
2020/04/05,Murcia,Murcia,64383,1493898,81773,1412125,1493898,81216
2020/04/05,Navarra,Zaragoza,144,964724,55974,908750,654183,35093
2020/04/05,Navarra,Gipuzkoa,89,723576,34113,689463,654183,35093
2020/04/05,Navarra,Rioja,358,316798,15281,301517,654183,35093
2020/04/05,Navarra,Navarra,25354,654183,35066,619117,654183,35093
2020/04/05,Ourense,Pontevedra,82,942665,57942,884723,307651,19417
2020/04/05,Ourense,Lugo,48,329587,16078,313509,307651,19417
2020/04/05,Ourense,León,30,460001,26605,433396,307651,19417
2020/04/05,Ourense,Ourense,15574,307651,19772,287879,307651,19417
2020/04/05,Palencia,Burgos,117,357072,15010,342062,160866,9372
2020/04/05,Palencia,Palencia,6907,160866,9424,151442,160866,9372
2020/04/05,Pontevedra,Coruña,2368,1119596,67384,1052212,942665,58004
2020/04/05,Pontevedra,Pontevedra,45866,942665,57942,884723,942665,58004
2020/04/05,Pontevedra,Ourense,148,307651,19772,287879,942665,58004
2020/04/05,Rioja,Araba,222,331549,21058,310491,316798,15343
2020/04/05,Rioja,Rioja,11469,316798,15281,301517,316798,15343
2020/04/05,Rioja,Navarra,673,654183,35066,619117,316798,15343
2020/04/05,Salamanca,Cáceres,55,394151,15829,378322,330119,20402
2020/04/05,Salamanca,Ávila,98,157640,7105,150535,330119,20402
2020/04/05,Salamanca,Salamanca,16150,330119,20711,309408,330119,20402
2020/04/05,Santa Cruz de Tenerife,Santa Cruz de Tenerife,45033,1032983,53701,979282,1032983,53526
2020/04/05,Segovia,Segovia,5243,153129,7695,145434,153129,7915
2020/04/05,Segovia,Valladolid,65,519546,30191,489355,153129,7915
2020/04/05,Segovia,Ávila,64,157640,7105,150535,153129,7915
2020/04/05,Sevilla,Sevilla,86691,1942389,115524,1826865,1942389,114950
2020/04/05,Sevilla,Córdoba,811,782979,51489,731490,1942389,114950
2020/04/05,Sevilla,Huelva,200,521870,30508,491362,1942389,114950
2020/04/05,Sevilla,Cádiz,545,1240155,73214,1166941,1942389,114950
2020/04/05,Sevilla,Melilla,17,86487,5603,80884,1942389,114950
2020/04/05,Sevilla,Málaga,38,1661785,79639,1582146,1942389,114950
2020/04/05,Soria,Burgos,25,357072,15010,342062,88636,3097
2020/04/05,Soria,Valladolid,36,519546,30191,489355,88636,3097
2020/04/05,Soria,Soria,2265,88636,2949,85687,88636,3097
2020/04/05,Tarragona,Castellón,363,579962,28744,551218,804664,39969
2020/04/05,Tarragona,Teruel,38,134137,2770,131367,804664,39969
2020/04/05,Tarragona,Tarragona,27640,804664,40246,764418,804664,39969
2020/04/05,Tarragona,Barcelona,518,5664579,371678,5292901,804664,39969
2020/04/05,Tarragona,Granada,16,914678,54940,859738,804664,39969
2020/04/05,Teruel,Tarragona,18,804664,40246,764418,134137,2829
2020/04/05,Teruel,Teruel,1435,134137,2770,131367,134137,2829
2020/04/05,Toledo,Cáceres,151,394151,15829,378322,694844,28694
2020/04/05,Toledo,Toledo,16193,694844,28822,666022,694844,28694
2020/04/05,Toledo,Madrid,1273,6663394,402057,6261337,694844,28694
2020/04/05,Toledo,Ciudad Real,35,495761,16097,479664,694844,28694
2020/04/05,Toledo,Ávila,74,157640,7105,150535,694844,28694
2020/04/05,Valencia,Castellón,305,579962,28744,551218,2565124,156718
2020/04/05,Valencia,Alicante,298,1858683,107348,1751335,2565124,156718
2020/04/05,Valencia,Cuenca,35,196329,5919,190410,2565124,156718
2020/04/05,Valencia,Albacete,168,388167,19245,368922,2565124,156718
2020/04/05,Valencia,Valencia,115361,2565124,158161,2406963,2565124,156718
2020/04/05,Valladolid,Segovia,34,153129,7695,145434,519546,29785
2020/04/05,Valladolid,Burgos,63,357072,15010,342062,519546,29785
2020/04/05,Valladolid,Valladolid,22156,519546,30191,489355,519546,29785
2020/04/05,Zamora,Zamora,6306,172539,8413,164126,172539,8620
2020/04/05,Zamora,Salamanca,16,330119,20711,309408,172539,8620
2020/04/05,Zaragoza,Teruel,16,134137,2770,131367,964724,55482
2020/04/05,Zaragoza,Navarra,152,654183,35066,619117,964724,55482
2020/04/05,Zaragoza,Lleida,110,434930,23293,411637,964724,55482
2020/04/05,Zaragoza,Zaragoza,41941,964724,55974,908750,964724,55482
2020/04/05,Zaragoza,Huesca,67,220461,9933,210528,964724,55482
2020/04/06,Albacete,Jaén,74,633564,46655,586909,388167,31393
2020/04/06,Albacete,Cuenca,344,196329,11180,185149,388167,31393
2020/04/06,Albacete,Alicante,182,1858683,167721,1690962,388167,31393
2020/04/06,Albacete,Murcia,145,1493898,150850,1343048,388167,31393
2020/04/06,Albacete,Valencia,317,2565124,268461,2296663,388167,31393
2020/04/06,Albacete,Ciudad Real,420,495761,27185,468576,388167,31393
2020/04/06,Albacete,Albacete,22823,388167,31920,356247,388167,31393
2020/04/06,Alicante,Valencia,792,2565124,268461,2296663,1858683,169582
2020/04/06,Alicante,Albacete,192,388167,31920,356247,1858683,169582
2020/04/06,Alicante,Sevilla,16,1942389,177896,1764493,1858683,169582
2020/04/06,Alicante,Murcia,2720,1493898,150850,1343048,1858683,169582
2020/04/06,Alicante,Alicante,128840,1858683,167721,1690962,1858683,169582
2020/04/06,Almería,Murcia,1491,1493898,150850,1343048,716820,60386
2020/04/06,Almería,Granada,407,914678,83220,831458,716820,60386
2020/04/06,Almería,Almería,47114,716820,58925,657895,716820,60386
2020/04/06,Araba,Araba,27530,331549,33390,298159,331549,37092
2020/04/06,Araba,Rioja,940,316798,29336,287462,331549,37092
2020/04/06,Araba,Burgos,948,357072,26573,330499,331549,37092
2020/04/06,Araba,Gipuzkoa,23,723576,60883,662693,331549,37092
2020/04/06,Araba,Bizkaia,509,1152934,133772,1019162,331549,37092
2020/04/06,Araba,Navarra,35,654183,60616,593567,331549,37092
2020/04/06,Asturias,Asturias,68954,1022800,90480,932320,1022800,90548
2020/04/06,Asturias,Cantabria,138,580795,54913,525882,1022800,90548
2020/04/06,Asturias,León,34,460001,43363,416638,1022800,90548
2020/04/06,Asturias,Lugo,767,329587,28497,301090,1022800,90548
2020/04/06,Asturias,Coruña,19,1119596,110720,1008876,1022800,90548
2020/04/06,Ávila,Ávila,7372,157640,10911,146729,157640,11478
2020/04/06,Ávila,Salamanca,200,330119,33009,297110,157640,11478
2020/04/06,Ávila,Segovia,64,153129,12307,140822,157640,11478
2020/04/06,Ávila,Madrid,50,6663394,601528,6061866,157640,11478
2020/04/06,Ávila,Toledo,74,694844,50522,644322,157640,11478
2020/04/06,Ávila,Cáceres,51,394151,26012,368139,157640,11478
2020/04/06,Badajoz,Badajoz,42063,673559,57682,615877,673559,56510
2020/04/06,Badajoz,Sevilla,16,1942389,177896,1764493,673559,56510
2020/04/06,Badajoz,Ciudad Real,54,495761,27185,468576,673559,56510
2020/04/06,Badajoz,Córdoba,62,782979,72914,710065,673559,56510
2020/04/06,Badajoz,Cáceres,734,394151,26012,368139,673559,56510
2020/04/06,Badajoz,Huelva,268,521870,48799,473071,673559,56510
2020/04/06,Balears,Balears,69119,1149460,82215,1067245,1149460,82473
2020/04/06,Barcelona,Tarragona,500,804664,65047,739617,5664579,554116
2020/04/06,Barcelona,Albacete,19,388167,31920,356247,5664579,554116
2020/04/06,Barcelona,Girona,1414,771044,53966,717078,5664579,554116
2020/04/06,Barcelona,Barcelona,352027,5664579,553089,5111490,5664579,554116
2020/04/06,Barcelona,Málaga,16,1661785,130581,1531204,5664579,554116
2020/04/06,Barcelona,Valencia,16,2565124,268461,2296663,5664579,554116
2020/04/06,Barcelona,Lleida,69,434930,39985,394945,5664579,554116
2020/04/06,Bizkaia,Gipuzkoa,440,723576,60883,662693,1152934,131453
2020/04/06,Bizkaia,Bizkaia,98347,1152934,133772,1019162,1152934,131453
2020/04/06,Bizkaia,Burgos,37,357072,26573,330499,1152934,131453
2020/04/06,Bizkaia,Araba,438,331549,33390,298159,1152934,131453
2020/04/06,Bizkaia,Cantabria,623,580795,54913,525882,1152934,131453
2020/04/06,Burgos,Burgos,19414,357072,26573,330499,357072,27392
2020/04/06,Burgos,Araba,540,331549,33390,298159,357072,27392
2020/04/06,Burgos,Navarra,17,654183,60616,593567,357072,27392
2020/04/06,Burgos,Segovia,18,153129,12307,140822,357072,27392
2020/04/06,Burgos,Valladolid,77,519546,50051,469495,357072,27392
2020/04/06,Burgos,Palencia,173,160866,14243,146623,357072,27392
2020/04/06,Cáceres,Toledo,77,694844,50522,644322,394151,25837
2020/04/06,Cáceres,Badajoz,844,673559,57682,615877,394151,25837
2020/04/06,Cáceres,Cáceres,16634,394151,26012,368139,394151,25837
2020/04/06,Cáceres,Ávila,67,157640,10911,146729,394151,25837
2020/04/06,Cádiz,Málaga,685,1661785,130581,1531204,1240155,110631
2020/04/06,Cádiz,Huelva,728,521870,48799,473071,1240155,110631
2020/04/06,Cádiz,Cádiz,90376,1240155,109836,1130319,1240155,110631
2020/04/06,Cádiz,Sevilla,549,1942389,177896,1764493,1240155,110631
2020/04/06,Cantabria,Asturias,117,1022800,90480,932320,580795,52304
2020/04/06,Cantabria,Bizkaia,354,1152934,133772,1019162,580795,52304
2020/04/06,Cantabria,Cantabria,37794,580795,54913,525882,580795,52304
2020/04/06,Cantabria,Palencia,35,160866,14243,146623,580795,52304
2020/04/06,Castellón,Castellón,35271,579962,48619,531343,579962,50374
2020/04/06,Castellón,Valencia,549,2565124,268461,2296663,579962,50374
2020/04/06,Castellón,Teruel,29,134137,6118,128019,579962,50374
2020/04/06,Castellón,Tarragona,796,804664,65047,739617,579962,50374
2020/04/06,Castellón,Málaga,16,1661785,130581,1531204,579962,50374
2020/04/06,Ceuta,Ceuta,6368,84777,6594,78183,84777,6741
2020/04/06,Ceuta,Cádiz,25,1240155,109836,1130319,84777,6741
2020/04/06,Ciudad Real,Córdoba,471,782979,72914,710065,495761,26868
2020/04/06,Ciudad Real,Toledo,43,694844,50522,644322,495761,26868
2020/04/06,Ciudad Real,Albacete,344,388167,31920,356247,495761,26868
2020/04/06,Ciudad Real,Ciudad Real,16800,495761,27185,468576,495761,26868
2020/04/06,Ciudad Real,Badajoz,39,673559,57682,615877,495761,26868
2020/04/06,Ciudad Real,Jaén,17,633564,46655,586909,495761,26868
2020/04/06,Córdoba,Sevilla,1142,1942389,177896,1764493,782979,71584
2020/04/06,Córdoba,Ciudad Real,246,495761,27185,468576,782979,71584
2020/04/06,Córdoba,Córdoba,50996,782979,72914,710065,782979,71584
2020/04/06,Córdoba,Badajoz,57,673559,57682,615877,782979,71584
2020/04/06,Córdoba,Granada,126,914678,83220,831458,782979,71584
2020/04/06,Córdoba,Málaga,219,1661785,130581,1531204,782979,71584
2020/04/06,Córdoba,Jaén,692,633564,46655,586909,782979,71584
2020/04/06,Coruña,Coruña,84314,1119596,110720,1008876,1119596,111572
2020/04/06,Coruña,Pontevedra,3576,942665,96548,846117,1119596,111572
2020/04/06,Coruña,Lugo,358,329587,28497,301090,1119596,111572
2020/04/06,Cuenca,Guadalajara,19,257762,20876,236886,196329,12231
2020/04/06,Cuenca,Ciudad Real,72,495761,27185,468576,196329,12231
2020/04/06,Cuenca,Albacete,714,388167,31920,356247,196329,12231
2020/04/06,Cuenca,Cuenca,5737,196329,11180,185149,196329,12231
2020/04/06,Cuenca,Toledo,57,694844,50522,644322,196329,12231
2020/04/06,Cuenca,Madrid,51,6663394,601528,6061866,196329,12231
2020/04/06,Cuenca,Valencia,53,2565124,268461,2296663,196329,12231
2020/04/06,Gipuzkoa,Gipuzkoa,44764,723576,60883,662693,723576,63515
2020/04/06,Gipuzkoa,Araba,54,331549,33390,298159,723576,63515
2020/04/06,Gipuzkoa,Navarra,189,654183,60616,593567,723576,63515
2020/04/06,Gipuzkoa,Bizkaia,656,1152934,133772,1019162,723576,63515
2020/04/06,Girona,Girona,35132,771044,53966,717078,771044,56462
2020/04/06,Girona,Lleida,37,434930,39985,394945,771044,56462
2020/04/06,Girona,Barcelona,1407,5664579,553089,5111490,771044,56462
2020/04/06,Granada,Jaén,268,633564,46655,586909,914678,82274
2020/04/06,Granada,Almería,300,716820,58925,657895,914678,82274
2020/04/06,Granada,Granada,58325,914678,83220,831458,914678,82274
2020/04/06,Granada,Córdoba,251,782979,72914,710065,914678,82274
2020/04/06,Granada,Málaga,147,1661785,130581,1531204,914678,82274
2020/04/06,Guadalajara,Guadalajara,12751,257762,20876,236886,257762,21535
2020/04/06,Guadalajara,Madrid,803,6663394,601528,6061866,257762,21535
2020/04/06,Huelva,Córdoba,17,782979,72914,710065,521870,50444
2020/04/06,Huelva,Sevilla,938,1942389,177896,1764493,521870,50444
2020/04/06,Huelva,Cádiz,622,1240155,109836,1130319,521870,50444
2020/04/06,Huelva,Badajoz,296,673559,57682,615877,521870,50444
2020/04/06,Huelva,Huelva,37375,521870,48799,473071,521870,50444
2020/04/06,Huesca,Huesca,11093,220461,17037,203424,220461,19143
2020/04/06,Huesca,Lleida,505,434930,39985,394945,220461,19143
2020/04/06,Huesca,Zaragoza,168,964724,97128,867596,220461,19143
2020/04/06,Jaén,Córdoba,635,782979,72914,710065,633564,45317
2020/04/06,Jaén,Jaén,31921,633564,46655,586909,633564,45317
2020/04/06,Jaén,Albacete,16,388167,31920,356247,633564,45317
2020/04/06,Jaén,Granada,295,914678,83220,831458,633564,45317
2020/04/06,Las Palmas de Gran Canaria,Las Palmas de Gran Canaria,94361,1120406,104133,1016273,1120406,103527
2020/04/06,León,Zamora,169,172539,14275,158264,460001,42794
2020/04/06,León,Palencia,26,160866,14243,146623,460001,42794
2020/04/06,León,Asturias,38,1022800,90480,932320,460001,42794
2020/04/06,León,León,31951,460001,43363,416638,460001,42794
2020/04/06,Lleida,Girona,45,771044,53966,717078,434930,38324
2020/04/06,Lleida,Barcelona,117,5664579,553089,5111490,434930,38324
2020/04/06,Lleida,Zaragoza,45,964724,97128,867596,434930,38324
2020/04/06,Lleida,Tarragona,16,804664,65047,739617,434930,38324
2020/04/06,Lleida,Lleida,24413,434930,39985,394945,434930,38324
2020/04/06,Lleida,Huesca,381,220461,17037,203424,434930,38324
2020/04/06,Lugo,Ourense,66,307651,32193,275458,329587,28718
2020/04/06,Lugo,Coruña,430,1119596,110720,1008876,329587,28718
2020/04/06,Lugo,Lugo,19894,329587,28497,301090,329587,28718
2020/04/06,Lugo,Asturias,575,1022800,90480,932320,329587,28718
2020/04/06,Madrid,Cuenca,66,196329,11180,185149,6663394,604375
2020/04/06,Madrid,Guadalajara,1073,257762,20876,236886,6663394,604375
2020/04/06,Madrid,Jaén,16,633564,46655,586909,6663394,604375
2020/04/06,Madrid,Madrid,359934,6663394,601528,6061866,6663394,604375
2020/04/06,Madrid,Toledo,1957,694844,50522,644322,6663394,604375
2020/04/06,Madrid,Ávila,120,157640,10911,146729,6663394,604375
2020/04/06,Málaga,Córdoba,264,782979,72914,710065,1661785,131023
2020/04/06,Málaga,Cádiz,577,1240155,109836,1130319,1661785,131023
2020/04/06,Málaga,Granada,160,914678,83220,831458,1661785,131023
2020/04/06,Málaga,Almería,18,716820,58925,657895,1661785,131023
2020/04/06,Málaga,Málaga,103824,1661785,130581,1531204,1661785,131023
2020/04/06,Málaga,Sevilla,212,1942389,177896,1764493,1661785,131023
2020/04/06,Melilla,Melilla,8640,86487,8710,77777,86487,8735
2020/04/06,Murcia,Albacete,247,388167,31920,356247,1493898,150016
2020/04/06,Murcia,Granada,52,914678,83220,831458,1493898,150016
2020/04/06,Murcia,Alicante,2205,1858683,167721,1690962,1493898,150016
2020/04/06,Murcia,Almería,1138,716820,58925,657895,1493898,150016
2020/04/06,Murcia,Murcia,115947,1493898,150850,1343048,1493898,150016
2020/04/06,Murcia,Jaén,18,633564,46655,586909,1493898,150016
2020/04/06,Navarra,Gipuzkoa,144,723576,60883,662693,654183,61435
2020/04/06,Navarra,Navarra,41038,654183,60616,593567,654183,61435
2020/04/06,Navarra,Rioja,1524,316798,29336,287462,654183,61435
2020/04/06,Navarra,Alicante,28,1858683,167721,1690962,654183,61435
2020/04/06,Navarra,Zaragoza,370,964724,97128,867596,654183,61435
2020/04/06,Ourense,Coruña,19,1119596,110720,1008876,307651,31972
2020/04/06,Ourense,Ourense,24373,307651,32193,275458,307651,31972
2020/04/06,Ourense,Lugo,44,329587,28497,301090,307651,31972
2020/04/06,Ourense,León,78,460001,43363,416638,307651,31972
2020/04/06,Ourense,Pontevedra,118,942665,96548,846117,307651,31972
2020/04/06,Palencia,Cantabria,113,580795,54913,525882,160866,15197
2020/04/06,Palencia,Burgos,161,357072,26573,330499,160866,15197
2020/04/06,Palencia,Valladolid,45,519546,50051,469495,160866,15197
2020/04/06,Palencia,Palencia,10168,160866,14243,146623,160866,15197
2020/04/06,Pontevedra,Coruña,3133,1119596,110720,1008876,942665,95770
2020/04/06,Pontevedra,Pontevedra,72900,942665,96548,846117,942665,95770
2020/04/06,Pontevedra,Ourense,177,307651,32193,275458,942665,95770
2020/04/06,Pontevedra,Málaga,16,1661785,130581,1531204,942665,95770
2020/04/06,Rioja,Rioja,20642,316798,29336,287462,316798,28068
2020/04/06,Rioja,Araba,338,331549,33390,298159,316798,28068
2020/04/06,Rioja,Navarra,1230,654183,60616,593567,316798,28068
2020/04/06,Salamanca,Cáceres,17,394151,26012,368139,330119,32398
2020/04/06,Salamanca,Salamanca,25384,330119,33009,297110,330119,32398
2020/04/06,Salamanca,Ávila,128,157640,10911,146729,330119,32398
2020/04/06,Salamanca,Zamora,26,172539,14275,158264,330119,32398
2020/04/06,Santa Cruz de Tenerife,Las Palmas de Gran Canaria,245,1120406,104133,1016273,1032983,97657
2020/04/06,Santa Cruz de Tenerife,Santa Cruz de Tenerife,86592,1032983,97583,935400,1032983,97657
2020/04/06,Segovia,Valladolid,162,519546,50051,469495,153129,13465
2020/04/06,Segovia,Segovia,8094,153129,12307,140822,153129,13465
2020/04/06,Segovia,Ávila,119,157640,10911,146729,153129,13465
2020/04/06,Segovia,Burgos,43,357072,26573,330499,153129,13465
2020/04/06,Sevilla,Cádiz,701,1240155,109836,1130319,1942389,175338
2020/04/06,Sevilla,Málaga,117,1661785,130581,1531204,1942389,175338
2020/04/06,Sevilla,Córdoba,1146,782979,72914,710065,1942389,175338
2020/04/06,Sevilla,Sevilla,119268,1942389,177896,1764493,1942389,175338
2020/04/06,Sevilla,Almería,20,716820,58925,657895,1942389,175338
2020/04/06,Sevilla,Huelva,236,521870,48799,473071,1942389,175338
2020/04/06,Sevilla,Badajoz,17,673559,57682,615877,1942389,175338
2020/04/06,Soria,Valladolid,24,519546,50051,469495,88636,5614
2020/04/06,Soria,Soria,3910,88636,5083,83553,88636,5614
2020/04/06,Tarragona,Castellón,459,579962,48619,531343,804664,64568
2020/04/06,Tarragona,Barcelona,486,5664579,553089,5111490,804664,64568
2020/04/06,Tarragona,Teruel,45,134137,6118,128019,804664,64568
2020/04/06,Tarragona,Tarragona,41855,804664,65047,739617,804664,64568
2020/04/06,Teruel,Teruel,3487,134137,6118,128019,134137,6863
2020/04/06,Teruel,Tarragona,102,804664,65047,739617,134137,6863
2020/04/06,Teruel,Castellón,89,579962,48619,531343,134137,6863
2020/04/06,Teruel,Zaragoza,31,964724,97128,867596,134137,6863
2020/04/06,Toledo,Madrid,1908,6663394,601528,6061866,694844,50380
2020/04/06,Toledo,Ávila,64,157640,10911,146729,694844,50380
2020/04/06,Toledo,Toledo,26381,694844,50522,644322,694844,50380
2020/04/06,Toledo,Ciudad Real,98,495761,27185,468576,694844,50380
2020/04/06,Toledo,Cáceres,63,394151,26012,368139,694844,50380
2020/04/06,Valencia,Albacete,298,388167,31920,356247,2565124,262268
2020/04/06,Valencia,Cuenca,73,196329,11180,185149,2565124,262268
2020/04/06,Valencia,Sevilla,16,1942389,177896,1764493,2565124,262268
2020/04/06,Valencia,Valencia,166533,2565124,268461,2296663,2565124,262268
2020/04/06,Valencia,Castellón,525,579962,48619,531343,2565124,262268
2020/04/06,Valencia,Alicante,701,1858683,167721,1690962,2565124,262268
2020/04/06,Valladolid,Segovia,175,153129,12307,140822,519546,48209
2020/04/06,Valladolid,Ávila,26,157640,10911,146729,519546,48209
2020/04/06,Valladolid,Burgos,70,357072,26573,330499,519546,48209
2020/04/06,Valladolid,Zamora,34,172539,14275,158264,519546,48209
2020/04/06,Valladolid,Valladolid,33958,519546,50051,469495,519546,48209
2020/04/06,Zamora,Zamora,9989,172539,14275,158264,172539,14356
2020/04/06,Zamora,Valladolid,36,519546,50051,469495,172539,14356
2020/04/06,Zamora,León,30,460001,43363,416638,172539,14356
2020/04/06,Zaragoza,Zaragoza,68803,964724,97128,867596,964724,93848
2020/04/06,Zaragoza,Huesca,156,220461,17037,203424,964724,93848
2020/04/06,Zaragoza,Lleida,84,434930,39985,394945,964724,93848
2020/04/06,Zaragoza,Navarra,275,654183,60616,593567,964724,93848
2020/04/07,Albacete,Valencia,286,2565124,284091,2281033,388167,26933
2020/04/07,Albacete,Alicante,152,1858683,176663,1682020,388167,26933
2020/04/07,Albacete,Cuenca,300,196329,12493,183836,388167,26933
2020/04/07,Albacete,Jaén,20,633564,46781,586783,388167,26933
2020/04/07,Albacete,Albacete,16812,388167,27128,361039,388167,26933
2020/04/07,Albacete,Murcia,206,1493898,153337,1340561,388167,26933
2020/04/07,Albacete,Ciudad Real,519,495761,29211,466550,388167,26933
2020/04/07,Alicante,Murcia,2108,1493898,153337,1340561,1858683,178415
2020/04/07,Alicante,Albacete,213,388167,27128,361039,1858683,178415
2020/04/07,Alicante,Alicante,136662,1858683,176663,1682020,1858683,178415
2020/04/07,Alicante,Valencia,620,2565124,284091,2281033,1858683,178415
2020/04/07,Almería,Almería,53750,716820,67114,649706,716820,68334
2020/04/07,Almería,Granada,369,914678,85661,829017,716820,68334
2020/04/07,Almería,Murcia,1771,1493898,153337,1340561,716820,68334
2020/04/07,Araba,Gipuzkoa,97,723576,66258,657318,331549,40414
2020/04/07,Araba,Navarra,65,654183,64911,589272,331549,40414
2020/04/07,Araba,Bizkaia,507,1152934,142982,1009952,331549,40414
2020/04/07,Araba,Burgos,894,357072,29400,327672,331549,40414
2020/04/07,Araba,Rioja,1082,316798,30248,286550,331549,40414
2020/04/07,Araba,Araba,29965,331549,36585,294964,331549,40414
2020/04/07,Asturias,Asturias,75838,1022800,98702,924098,1022800,98687
2020/04/07,Asturias,Lugo,661,329587,29693,299894,1022800,98687
2020/04/07,Asturias,Cantabria,161,580795,58285,522510,1022800,98687
2020/04/07,Asturias,León,40,460001,45996,414005,1022800,98687
2020/04/07,Ávila,Toledo,127,694844,55635,639209,157640,12348
2020/04/07,Ávila,Ávila,7898,157640,11744,145896,157640,12348
2020/04/07,Ávila,Cáceres,101,394151,25007,369144,157640,12348
2020/04/07,Ávila,Segovia,80,153129,14046,139083,157640,12348
2020/04/07,Ávila,Salamanca,136,330119,33256,296863,157640,12348
2020/04/07,Ávila,Madrid,74,6663394,649665,6013729,157640,12348
2020/04/07,Badajoz,Badajoz,39755,673559,56267,617292,673559,55618
2020/04/07,Badajoz,Córdoba,77,782979,76073,706906,673559,55618
2020/04/07,Badajoz,Cáceres,643,394151,25007,369144,673559,55618
2020/04/07,Badajoz,Huelva,157,521870,52135,469735,673559,55618
2020/04/07,Badajoz,Ciudad Real,35,495761,29211,466550,673559,55618
2020/04/07,Badajoz,Sevilla,22,1942389,191740,1750649,673559,55618
2020/04/07,Balears,Balears,69902,1149460,85098,1064362,1149460,85926
2020/04/07,Balears,Valencia,21,2565124,284091,2281033,1149460,85926
2020/04/07,Barcelona,Lleida,88,434930,41502,393428,5664579,594514
2020/04/07,Barcelona,Girona,1607,771044,58300,712744,5664579,594514
2020/04/07,Barcelona,Barcelona,384932,5664579,592555,5072024,5664579,594514
2020/04/07,Barcelona,Tarragona,696,804664,69122,735542,5664579,594514
2020/04/07,Bizkaia,Bizkaia,105161,1152934,142982,1009952,1152934,140350
2020/04/07,Bizkaia,Burgos,17,357072,29400,327672,1152934,140350
2020/04/07,Bizkaia,Gipuzkoa,429,723576,66258,657318,1152934,140350
2020/04/07,Bizkaia,Araba,497,331549,36585,294964,1152934,140350
2020/04/07,Bizkaia,Cantabria,941,580795,58285,522510,1152934,140350
2020/04/07,Burgos,Bizkaia,24,1152934,142982,1009952,357072,30161
2020/04/07,Burgos,Burgos,21314,357072,29400,327672,357072,30161
2020/04/07,Burgos,Segovia,19,153129,14046,139083,357072,30161
2020/04/07,Burgos,Palencia,171,160866,15651,145215,357072,30161
2020/04/07,Burgos,Rioja,19,316798,30248,286550,357072,30161
2020/04/07,Burgos,Valladolid,84,519546,53972,465574,357072,30161
2020/04/07,Burgos,Araba,587,331549,36585,294964,357072,30161
2020/04/07,Cáceres,Ávila,66,157640,11744,145896,394151,24756
2020/04/07,Cáceres,Toledo,93,694844,55635,639209,394151,24756
2020/04/07,Cáceres,Badajoz,673,673559,56267,617292,394151,24756
2020/04/07,Cáceres,Cáceres,15381,394151,25007,369144,394151,24756
2020/04/07,Cádiz,Sevilla,737,1942389,191740,1750649,1240155,115680
2020/04/07,Cádiz,Cádiz,91685,1240155,113687,1126468,1240155,115680
2020/04/07,Cádiz,Huelva,634,521870,52135,469735,1240155,115680
2020/04/07,Cádiz,Málaga,654,1661785,134481,1527304,1240155,115680
2020/04/07,Cantabria,Asturias,125,1022800,98702,924098,580795,56911
2020/04/07,Cantabria,Bizkaia,367,1152934,142982,1009952,580795,56911
2020/04/07,Cantabria,Palencia,24,160866,15651,145215,580795,56911
2020/04/07,Cantabria,Cantabria,41387,580795,58285,522510,580795,56911
2020/04/07,Castellón,Teruel,73,134137,6181,127956,579962,53453
2020/04/07,Castellón,Valencia,601,2565124,284091,2281033,579962,53453
2020/04/07,Castellón,Tarragona,684,804664,69122,735542,579962,53453
2020/04/07,Castellón,Castellón,37200,579962,51549,528413,579962,53453
2020/04/07,Ceuta,Ceuta,7140,84777,7604,77173,84777,7605
2020/04/07,Ciudad Real,Toledo,61,694844,55635,639209,495761,28785
2020/04/07,Ciudad Real,Albacete,443,388167,27128,361039,495761,28785
2020/04/07,Ciudad Real,Ciudad Real,17522,495761,29211,466550,495761,28785
2020/04/07,Ciudad Real,Córdoba,355,782979,76073,706906,495761,28785
2020/04/07,Córdoba,Ciudad Real,218,495761,29211,466550,782979,75036
2020/04/07,Córdoba,Granada,126,914678,85661,829017,782979,75036
2020/04/07,Córdoba,Jaén,554,633564,46781,586783,782979,75036
2020/04/07,Córdoba,Córdoba,52675,782979,76073,706906,782979,75036
2020/04/07,Córdoba,Málaga,155,1661785,134481,1527304,782979,75036
2020/04/07,Córdoba,Sevilla,1240,1942389,191740,1750649,782979,75036
2020/04/07,Coruña,Lugo,437,329587,29693,299894,1119596,119448
2020/04/07,Coruña,Pontevedra,3506,942665,103232,839433,1119596,119448
2020/04/07,Coruña,Coruña,90648,1119596,118293,1001303,1119596,119448
2020/04/07,Cuenca,Albacete,527,388167,27128,361039,196329,13045
2020/04/07,Cuenca,Ciudad Real,51,495761,29211,466550,196329,13045
2020/04/07,Cuenca,Valencia,40,2565124,284091,2281033,196329,13045
2020/04/07,Cuenca,Cuenca,6433,196329,12493,183836,196329,13045
2020/04/07,Cuenca,Guadalajara,19,257762,23709,234053,196329,13045
2020/04/07,Cuenca,Toledo,68,694844,55635,639209,196329,13045
2020/04/07,Cuenca,Madrid,48,6663394,649665,6013729,196329,13045
2020/04/07,Gipuzkoa,Navarra,121,654183,64911,589272,723576,68634
2020/04/07,Gipuzkoa,Araba,32,331549,36585,294964,723576,68634
2020/04/07,Gipuzkoa,Bizkaia,563,1152934,142982,1009952,723576,68634
2020/04/07,Gipuzkoa,Gipuzkoa,49584,723576,66258,657318,723576,68634
2020/04/07,Girona,Lleida,74,434930,41502,393428,771044,62106
2020/04/07,Girona,Girona,37876,771044,58300,712744,771044,62106
2020/04/07,Girona,Barcelona,1470,5664579,592555,5072024,771044,62106
2020/04/07,Granada,Almería,208,716820,67114,649706,914678,84675
2020/04/07,Granada,Málaga,104,1661785,134481,1527304,914678,84675
2020/04/07,Granada,Jaén,278,633564,46781,586783,914678,84675
2020/04/07,Granada,Granada,61483,914678,85661,829017,914678,84675
2020/04/07,Granada,Córdoba,207,782979,76073,706906,914678,84675
2020/04/07,Guadalajara,Cuenca,24,196329,12493,183836,257762,23926
2020/04/07,Guadalajara,Madrid,1153,6663394,649665,6013729,257762,23926
2020/04/07,Guadalajara,Guadalajara,14478,257762,23709,234053,257762,23926
2020/04/07,Huelva,Badajoz,273,673559,56267,617292,521870,54028
2020/04/07,Huelva,Sevilla,936,1942389,191740,1750649,521870,54028
2020/04/07,Huelva,Cádiz,402,1240155,113687,1126468,521870,54028
2020/04/07,Huelva,Huelva,38550,521870,52135,469735,521870,54028
2020/04/07,Huesca,Huesca,12085,220461,18482,201979,220461,20157
2020/04/07,Huesca,Zaragoza,95,964724,105515,859209,220461,20157
2020/04/07,Huesca,Lleida,368,434930,41502,393428,220461,20157
2020/04/07,Jaén,Jaén,31485,633564,46781,586783,633564,45925
2020/04/07,Jaén,Córdoba,673,782979,76073,706906,633564,45925
2020/04/07,Jaén,Granada,227,914678,85661,829017,633564,45925
2020/04/07,Las Palmas de Gran Canaria,Las Palmas de Gran Canaria,93887,1120406,108395,1012011,1120406,107323
2020/04/07,León,Valladolid,27,519546,53972,465574,460001,45542
2020/04/07,León,León,33333,460001,45996,414005,460001,45542
2020/04/07,León,Palencia,30,160866,15651,145215,460001,45542
2020/04/07,León,Ourense,53,307651,34104,273547,460001,45542
2020/04/07,León,Asturias,33,1022800,98702,924098,460001,45542
2020/04/07,León,Zamora,168,172539,15651,156888,460001,45542
2020/04/07,Lleida,Girona,86,771044,58300,712744,434930,40091
2020/04/07,Lleida,Huesca,408,220461,18482,201979,434930,40091
2020/04/07,Lleida,Zaragoza,84,964724,105515,859209,434930,40091
2020/04/07,Lleida,Lleida,25164,434930,41502,393428,434930,40091
2020/04/07,Lleida,Barcelona,110,5664579,592555,5072024,434930,40091
2020/04/07,Lugo,Asturias,587,1022800,98702,924098,329587,29982
2020/04/07,Lugo,Lugo,20597,329587,29693,299894,329587,29982
2020/04/07,Lugo,Coruña,345,1119596,118293,1001303,329587,29982
2020/04/07,Lugo,Ourense,79,307651,34104,273547,329587,29982
2020/04/07,Madrid,Ávila,112,157640,11744,145896,6663394,650926
2020/04/07,Madrid,Guadalajara,1438,257762,23709,234053,6663394,650926
2020/04/07,Madrid,Toledo,2298,694844,55635,639209,6663394,650926
2020/04/07,Madrid,Madrid,399869,6663394,649665,6013729,6663394,650926
2020/04/07,Madrid,Melilla,21,86487,10127,76360,6663394,650926
2020/04/07,Madrid,Cuenca,35,196329,12493,183836,6663394,650926
2020/04/07,Málaga,Cádiz,520,1240155,113687,1126468,1661785,134395
2020/04/07,Málaga,Sevilla,227,1942389,191740,1750649,1661785,134395
2020/04/07,Málaga,Córdoba,262,782979,76073,706906,1661785,134395
2020/04/07,Málaga,Granada,124,914678,85661,829017,1661785,134395
2020/04/07,Málaga,Málaga,104423,1661785,134481,1527304,1661785,134395
2020/04/07,Melilla,Melilla,9829,86487,10127,76360,86487,10182
2020/04/07,Murcia,Almería,979,716820,67114,649706,1493898,151207
2020/04/07,Murcia,Albacete,222,388167,27128,361039,1493898,151207
2020/04/07,Murcia,Barcelona,38,5664579,592555,5072024,1493898,151207
2020/04/07,Murcia,Murcia,114171,1493898,153337,1340561,1493898,151207
2020/04/07,Murcia,Granada,77,914678,85661,829017,1493898,151207
2020/04/07,Murcia,Alicante,1885,1858683,176663,1682020,1493898,151207
2020/04/07,Navarra,Gipuzkoa,133,723576,66258,657318,654183,66060
2020/04/07,Navarra,Rioja,1395,316798,30248,286550,654183,66060
2020/04/07,Navarra,Araba,29,331549,36585,294964,654183,66060
2020/04/07,Navarra,Zaragoza,343,964724,105515,859209,654183,66060
2020/04/07,Navarra,Navarra,44660,654183,64911,589272,654183,66060
2020/04/07,Ourense,Lugo,163,329587,29693,299894,307651,34011
2020/04/07,Ourense,Pontevedra,141,942665,103232,839433,307651,34011
2020/04/07,Ourense,Ourense,26333,307651,34104,273547,307651,34011
2020/04/07,Ourense,León,73,460001,45996,414005,307651,34011
2020/04/07,Palencia,Burgos,128,357072,29400,327672,160866,16419
2020/04/07,Palencia,Palencia,10975,160866,15651,145215,160866,16419
2020/04/07,Palencia,Cantabria,117,580795,58285,522510,160866,16419
2020/04/07,Palencia,Valladolid,16,519546,53972,465574,160866,16419
2020/04/07,Pontevedra,Ourense,150,307651,34104,273547,942665,102790
2020/04/07,Pontevedra,Pontevedra,79452,942665,103232,839433,942665,102790
2020/04/07,Pontevedra,Coruña,3114,1119596,118293,1001303,942665,102790
2020/04/07,Rioja,Navarra,1266,654183,64911,589272,316798,29059
2020/04/07,Rioja,Araba,440,331549,36585,294964,316798,29059
2020/04/07,Rioja,Rioja,21371,316798,30248,286550,316798,29059
2020/04/07,Salamanca,Ávila,183,157640,11744,145896,330119,32711
2020/04/07,Salamanca,Salamanca,25551,330119,33256,296863,330119,32711
2020/04/07,Santa Cruz de Tenerife,Las Palmas de Gran Canaria,24,1120406,108395,1012011,1032983,102352
2020/04/07,Santa Cruz de Tenerife,Santa Cruz de Tenerife,87826,1032983,102686,930297,1032983,102352
2020/04/07,Segovia,Segovia,9276,153129,14046,139083,153129,14795
2020/04/07,Segovia,Ávila,78,157640,11744,145896,153129,14795
2020/04/07,Segovia,Valladolid,192,519546,53972,465574,153129,14795
2020/04/07,Segovia,Burgos,106,357072,29400,327672,153129,14795
2020/04/07,Sevilla,Cádiz,601,1240155,113687,1126468,1942389,189091
2020/04/07,Sevilla,Málaga,72,1661785,134481,1527304,1942389,189091
2020/04/07,Sevilla,Sevilla,128212,1942389,191740,1750649,1942389,189091
2020/04/07,Sevilla,Huelva,469,521870,52135,469735,1942389,189091
2020/04/07,Sevilla,Córdoba,1399,782979,76073,706906,1942389,189091
2020/04/07,Soria,Valladolid,31,519546,53972,465574,88636,5891
2020/04/07,Soria,Soria,3764,88636,5377,83259,88636,5891
2020/04/07,Soria,Segovia,17,153129,14046,139083,88636,5891
2020/04/07,Tarragona,Barcelona,515,5664579,592555,5072024,804664,68685
2020/04/07,Tarragona,Tarragona,44289,804664,69122,735542,804664,68685
2020/04/07,Tarragona,Teruel,33,134137,6181,127956,804664,68685
2020/04/07,Tarragona,Castellón,544,579962,51549,528413,804664,68685
2020/04/07,Teruel,Castellón,32,579962,51549,528413,134137,6903
2020/04/07,Teruel,Tarragona,42,804664,69122,735542,134137,6903
2020/04/07,Teruel,Teruel,3062,134137,6181,127956,134137,6903
2020/04/07,Toledo,Ávila,78,157640,11744,145896,694844,55065
2020/04/07,Toledo,Ciudad Real,106,495761,29211,466550,694844,55065
2020/04/07,Toledo,Cáceres,117,394151,25007,369144,694844,55065
2020/04/07,Toledo,Cuenca,27,196329,12493,183836,694844,55065
2020/04/07,Toledo,Toledo,28950,694844,55635,639209,694844,55065
2020/04/07,Toledo,Madrid,2195,6663394,649665,6013729,694844,55065
2020/04/07,Valencia,Albacete,285,388167,27128,361039,2565124,277862
2020/04/07,Valencia,Cuenca,61,196329,12493,183836,2565124,277862
2020/04/07,Valencia,Castellón,434,579962,51549,528413,2565124,277862
2020/04/07,Valencia,Alicante,576,1858683,176663,1682020,2565124,277862
2020/04/07,Valencia,Valencia,191200,2565124,284091,2281033,2565124,277862
2020/04/07,Valladolid,Zamora,27,172539,15651,156888,519546,52120
2020/04/07,Valladolid,Soria,27,88636,5377,83259,519546,52120
2020/04/07,Valladolid,Segovia,214,153129,14046,139083,519546,52120
2020/04/07,Valladolid,León,27,460001,45996,414005,519546,52120
2020/04/07,Valladolid,Ávila,22,157640,11744,145896,519546,52120
2020/04/07,Valladolid,Burgos,75,357072,29400,327672,519546,52120
2020/04/07,Valladolid,Valladolid,37323,519546,53972,465574,519546,52120
2020/04/07,Zamora,León,24,460001,45996,414005,172539,15504
2020/04/07,Zamora,Valladolid,103,519546,53972,465574,172539,15504
2020/04/07,Zamora,Zamora,10529,172539,15651,156888,172539,15504
2020/04/07,Zaragoza,Zaragoza,77615,964724,105515,859209,964724,101579
2020/04/07,Zaragoza,Soria,21,88636,5377,83259,964724,101579
2020/04/07,Zaragoza,Huesca,177,220461,18482,201979,964724,101579
2020/04/07,Zaragoza,Teruel,33,134137,6181,127956,964724,101579
2020/04/07,Zaragoza,Navarra,374,654183,64911,589272,964724,101579
2020/04/07,Zaragoza,Lleida,54,434930,41502,393428,964724,101579
2020/04/08,Albacete,Alicante,163,1858683,176485,1682198,388167,26088
2020/04/08,Albacete,Murcia,263,1493898,155555,1338343,388167,26088
2020/04/08,Albacete,Ciudad Real,454,495761,29746,466015,388167,26088
2020/04/08,Albacete,Cuenca,483,196329,13248,183081,388167,26088
2020/04/08,Albacete,Albacete,15854,388167,26101,362066,388167,26088
2020/04/08,Albacete,Valencia,280,2565124,286052,2279072,388167,26088
2020/04/08,Alicante,Valencia,549,2565124,286052,2279072,1858683,178099
2020/04/08,Alicante,Murcia,2118,1493898,155555,1338343,1858683,178099
2020/04/08,Alicante,Albacete,195,388167,26101,362066,1858683,178099
2020/04/08,Alicante,Alicante,135520,1858683,176485,1682198,1858683,178099
2020/04/08,Almería,Murcia,1798,1493898,155555,1338343,716820,68532
2020/04/08,Almería,Granada,305,914678,84842,829836,716820,68532
2020/04/08,Almería,Almería,53858,716820,66840,649980,716820,68532
2020/04/08,Araba,Bizkaia,600,1152934,143132,1009802,331549,40384
2020/04/08,Araba,Rioja,1093,316798,30780,286018,331549,40384
2020/04/08,Araba,Araba,29742,331549,36586,294963,331549,40384
2020/04/08,Araba,Navarra,62,654183,66083,588100,331549,40384
2020/04/08,Araba,Burgos,876,357072,29412,327660,331549,40384
2020/04/08,Araba,Gipuzkoa,56,723576,66128,657448,331549,40384
2020/04/08,Asturias,León,23,460001,47099,412902,1022800,99960
2020/04/08,Asturias,Lugo,627,329587,30273,299314,1022800,99960
2020/04/08,Asturias,Asturias,76998,1022800,100035,922765,1022800,99960
2020/04/08,Asturias,Cantabria,151,580795,59463,521332,1022800,99960
2020/04/08,Ávila,Cáceres,57,394151,26299,367852,157640,12613
2020/04/08,Ávila,Toledo,106,694844,55365,639479,157640,12613
2020/04/08,Ávila,Ávila,8063,157640,12009,145631,157640,12613
2020/04/08,Ávila,Segovia,71,153129,13811,139318,157640,12613
2020/04/08,Ávila,Madrid,73,6663394,651814,6011580,157640,12613
2020/04/08,Ávila,Salamanca,254,330119,33392,296727,157640,12613
2020/04/08,Badajoz,Cáceres,683,394151,26299,367852,673559,59093
2020/04/08,Badajoz,Córdoba,105,782979,76790,706189,673559,59093
2020/04/08,Badajoz,Huelva,193,521870,52194,469676,673559,59093
2020/04/08,Badajoz,Ciudad Real,36,495761,29746,466015,673559,59093
2020/04/08,Badajoz,Badajoz,42779,673559,59935,613624,673559,59093
2020/04/08,Badajoz,Sevilla,21,1942389,189209,1753180,673559,59093
2020/04/08,Balears,Balears,68652,1149460,84135,1065325,1149460,85245
2020/04/08,Balears,Valencia,37,2565124,286052,2279072,1149460,85245
2020/04/08,Barcelona,Girona,1548,771044,58645,712399,5664579,589338
2020/04/08,Barcelona,Tarragona,747,804664,70633,734031,5664579,589338
2020/04/08,Barcelona,Lleida,129,434930,43404,391526,5664579,589338
2020/04/08,Barcelona,Barcelona,381585,5664579,587217,5077362,5664579,589338
2020/04/08,Bizkaia,Gipuzkoa,446,723576,66128,657448,1152934,139831
2020/04/08,Bizkaia,Araba,499,331549,36586,294963,1152934,139831
2020/04/08,Bizkaia,Burgos,18,357072,29412,327660,1152934,139831
2020/04/08,Bizkaia,Bizkaia,105552,1152934,143132,1009802,1152934,139831
2020/04/08,Bizkaia,Cantabria,895,580795,59463,521332,1152934,139831
2020/04/08,Burgos,Araba,564,331549,36586,294963,357072,29986
2020/04/08,Burgos,Burgos,21278,357072,29412,327660,357072,29986
2020/04/08,Burgos,Palencia,200,160866,15730,145136,357072,29986
2020/04/08,Burgos,Valladolid,87,519546,54175,465371,357072,29986
2020/04/08,Burgos,Segovia,17,153129,13811,139318,357072,29986
2020/04/08,Burgos,Soria,24,88636,5557,83079,357072,29986
2020/04/08,Cáceres,Badajoz,928,673559,59935,613624,394151,26349
2020/04/08,Cáceres,Cáceres,16524,394151,26299,367852,394151,26349
2020/04/08,Cáceres,Toledo,96,694844,55365,639479,394151,26349
2020/04/08,Cáceres,Ávila,84,157640,12009,145631,394151,26349
2020/04/08,Cádiz,Ceuta,18,84777,7571,77206,1240155,114245
2020/04/08,Cádiz,Sevilla,748,1942389,189209,1753180,1240155,114245
2020/04/08,Cádiz,Málaga,628,1661785,132292,1529493,1240155,114245
2020/04/08,Cádiz,Huelva,571,521870,52194,469676,1240155,114245
2020/04/08,Cádiz,Cádiz,89989,1240155,111769,1128386,1240155,114245
2020/04/08,Cantabria,Palencia,23,160866,15730,145136,580795,58003
2020/04/08,Cantabria,Bizkaia,392,1152934,143132,1009802,580795,58003
2020/04/08,Cantabria,Cantabria,42711,580795,59463,521332,580795,58003
2020/04/08,Cantabria,Asturias,159,1022800,100035,922765,580795,58003
2020/04/08,Castellón,Valencia,522,2565124,286052,2279072,579962,52614
2020/04/08,Castellón,Castellón,36306,579962,51129,528833,579962,52614
2020/04/08,Castellón,Tarragona,693,804664,70633,734031,579962,52614
2020/04/08,Ceuta,Cádiz,21,1240155,111769,1128386,84777,7608
2020/04/08,Ceuta,Ceuta,7107,84777,7571,77206,84777,7608
2020/04/08,Ciudad Real,Albacete,479,388167,26101,362066,495761,29449
2020/04/08,Ciudad Real,Córdoba,376,782979,76790,706189,495761,29449
2020/04/08,Ciudad Real,Toledo,74,694844,55365,639479,495761,29449
2020/04/08,Ciudad Real,Ciudad Real,18410,495761,29746,466015,495761,29449
2020/04/08,Ciudad Real,Badajoz,48,673559,59935,613624,495761,29449
2020/04/08,Córdoba,Granada,121,914678,84842,829836,782979,75430
2020/04/08,Córdoba,Jaén,553,633564,47499,586065,782979,75430
2020/04/08,Córdoba,Ciudad Real,236,495761,29746,466015,782979,75430
2020/04/08,Córdoba,Badajoz,57,673559,59935,613624,782979,75430
2020/04/08,Córdoba,Sevilla,1294,1942389,189209,1753180,782979,75430
2020/04/08,Córdoba,Málaga,256,1661785,132292,1529493,782979,75430
2020/04/08,Córdoba,Córdoba,53290,782979,76790,706189,782979,75430
2020/04/08,Coruña,Lugo,438,329587,30273,299314,1119596,119851
2020/04/08,Coruña,Coruña,91264,1119596,119164,1000432,1119596,119851
2020/04/08,Coruña,Pontevedra,3428,942665,105324,837341,1119596,119851
2020/04/08,Cuenca,Ciudad Real,90,495761,29746,466015,196329,13205
2020/04/08,Cuenca,Albacete,545,388167,26101,362066,196329,13205
2020/04/08,Cuenca,Madrid,48,6663394,651814,6011580,196329,13205
2020/04/08,Cuenca,Valencia,36,2565124,286052,2279072,196329,13205
2020/04/08,Cuenca,Toledo,107,694844,55365,639479,196329,13205
2020/04/08,Cuenca,Cuenca,6833,196329,13248,183081,196329,13205
2020/04/08,Gipuzkoa,Gipuzkoa,49495,723576,66128,657448,723576,67984
2020/04/08,Gipuzkoa,Araba,24,331549,36586,294963,723576,67984
2020/04/08,Gipuzkoa,Bizkaia,617,1152934,143132,1009802,723576,67984
2020/04/08,Gipuzkoa,Navarra,109,654183,66083,588100,723576,67984
2020/04/08,Girona,Murcia,20,1493898,155555,1338343,771044,61928
2020/04/08,Girona,Lleida,91,434930,43404,391526,771044,61928
2020/04/08,Girona,Girona,38047,771044,58645,712399,771044,61928
2020/04/08,Girona,Barcelona,1355,5664579,587217,5077362,771044,61928
2020/04/08,Granada,Granada,60827,914678,84842,829836,914678,84108
2020/04/08,Granada,Almería,289,716820,66840,649980,914678,84108
2020/04/08,Granada,Málaga,120,1661785,132292,1529493,914678,84108
2020/04/08,Granada,Jaén,291,633564,47499,586065,914678,84108
2020/04/08,Granada,Córdoba,235,782979,76790,706189,914678,84108
2020/04/08,Granada,Murcia,18,1493898,155555,1338343,914678,84108
2020/04/08,Guadalajara,Cuenca,22,196329,13248,183081,257762,23708
2020/04/08,Guadalajara,Guadalajara,14337,257762,23439,234323,257762,23708
2020/04/08,Guadalajara,Madrid,1214,6663394,651814,6011580,257762,23708
2020/04/08,Huelva,Sevilla,963,1942389,189209,1753180,521870,53779
2020/04/08,Huelva,Badajoz,278,673559,59935,613624,521870,53779
2020/04/08,Huelva,Cádiz,423,1240155,111769,1128386,521870,53779
2020/04/08,Huelva,Huelva,38433,521870,52194,469676,521870,53779
2020/04/08,Huesca,Huesca,12454,220461,18818,201643,220461,20423
2020/04/08,Huesca,Lleida,509,434930,43404,391526,220461,20423
2020/04/08,Huesca,Zaragoza,121,964724,105663,859061,220461,20423
2020/04/08,Jaén,Jaén,32233,633564,47499,586065,633564,46728
2020/04/08,Jaén,Córdoba,653,782979,76790,706189,633564,46728
2020/04/08,Jaén,Granada,269,914678,84842,829836,633564,46728
2020/04/08,Jaén,Albacete,17,388167,26101,362066,633564,46728
2020/04/08,Las Palmas de Gran Canaria,Las Palmas de Gran Canaria,95040,1120406,109492,1010914,1120406,108368
2020/04/08,León,Asturias,33,1022800,100035,922765,460001,46445
2020/04/08,León,Ourense,28,307651,34620,273031,460001,46445
2020/04/08,León,León,34489,460001,47099,412902,460001,46445
2020/04/08,León,Palencia,27,160866,15730,145136,460001,46445
2020/04/08,León,Zamora,116,172539,15940,156599,460001,46445
2020/04/08,Lleida,Zaragoza,61,964724,105663,859061,434930,41327
2020/04/08,Lleida,Huesca,530,220461,18818,201643,434930,41327
2020/04/08,Lleida,Barcelona,112,5664579,587217,5077362,434930,41327
2020/04/08,Lleida,Girona,50,771044,58645,712399,434930,41327
2020/04/08,Lleida,Lleida,26806,434930,43404,391526,434930,41327
2020/04/08,Lugo,Coruña,375,1119596,119164,1000432,329587,30817
2020/04/08,Lugo,Lugo,21282,329587,30273,299314,329587,30817
2020/04/08,Lugo,Asturias,574,1022800,100035,922765,329587,30817
2020/04/08,Lugo,Ourense,86,307651,34620,273031,329587,30817
2020/04/08,Madrid,Ávila,70,157640,12009,145631,6663394,652476
2020/04/08,Madrid,Madrid,401650,6663394,651814,6011580,6663394,652476
2020/04/08,Madrid,Guadalajara,1439,257762,23439,234323,6663394,652476
2020/04/08,Madrid,Cuenca,59,196329,13248,183081,6663394,652476
2020/04/08,Madrid,Toledo,2181,694844,55365,639479,6663394,652476
2020/04/08,Málaga,Granada,87,914678,84842,829836,1661785,132527
2020/04/08,Málaga,Sevilla,186,1942389,189209,1753180,1661785,132527
2020/04/08,Málaga,Melilla,20,86487,10065,76422,1661785,132527
2020/04/08,Málaga,Málaga,102159,1661785,132292,1529493,1661785,132527
2020/04/08,Málaga,Cádiz,520,1240155,111769,1128386,1661785,132527
2020/04/08,Málaga,Córdoba,257,782979,76790,706189,1661785,132527
2020/04/08,Melilla,Melilla,9688,86487,10065,76422,86487,9965
2020/04/08,Murcia,Almería,1060,716820,66840,649980,1493898,154615
2020/04/08,Murcia,Albacete,192,388167,26101,362066,1493898,154615
2020/04/08,Murcia,Murcia,116471,1493898,155555,1338343,1493898,154615
2020/04/08,Murcia,Granada,72,914678,84842,829836,1493898,154615
2020/04/08,Murcia,Alicante,1937,1858683,176485,1682198,1493898,154615
2020/04/08,Navarra,Rioja,1423,316798,30780,286018,654183,66515
2020/04/08,Navarra,Araba,32,331549,36586,294963,654183,66515
2020/04/08,Navarra,Gipuzkoa,153,723576,66128,657448,654183,66515
2020/04/08,Navarra,Navarra,45185,654183,66083,588100,654183,66515
2020/04/08,Navarra,Zaragoza,427,964724,105663,859061,654183,66515
2020/04/08,Ourense,León,108,460001,47099,412902,307651,34650
2020/04/08,Ourense,Lugo,129,329587,30273,299314,307651,34650
2020/04/08,Ourense,Pontevedra,133,942665,105324,837341,307651,34650
2020/04/08,Ourense,Ourense,26972,307651,34620,273031,307651,34650
2020/04/08,Palencia,Burgos,137,357072,29412,327660,160866,16512
2020/04/08,Palencia,Valladolid,24,519546,54175,465371,160866,16512
2020/04/08,Palencia,Cantabria,103,580795,59463,521332,160866,16512
2020/04/08,Palencia,Palencia,11011,160866,15730,145136,160866,16512
2020/04/08,Pontevedra,Lugo,30,329587,30273,299314,942665,104935
2020/04/08,Pontevedra,Coruña,3253,1119596,119164,1000432,942665,104935
2020/04/08,Pontevedra,Ourense,148,307651,34620,273031,942665,104935
2020/04/08,Pontevedra,Pontevedra,81678,942665,105324,837341,942665,104935
2020/04/08,Rioja,Navarra,1678,654183,66083,588100,316798,30151
2020/04/08,Rioja,Araba,413,331549,36586,294963,316798,30151
2020/04/08,Rioja,Rioja,21935,316798,30780,286018,316798,30151
2020/04/08,Salamanca,Ávila,151,157640,12009,145631,330119,32897
2020/04/08,Salamanca,Salamanca,25372,330119,33392,296727,330119,32897
2020/04/08,Santa Cruz de Tenerife,Santa Cruz de Tenerife,87876,1032983,103125,929858,1032983,102565
2020/04/08,Segovia,Ávila,89,157640,12009,145631,153129,14566
2020/04/08,Segovia,Burgos,82,357072,29412,327660,153129,14566
2020/04/08,Segovia,Segovia,8969,153129,13811,139318,153129,14566
2020/04/08,Segovia,Valladolid,154,519546,54175,465371,153129,14566
2020/04/08,Sevilla,Sevilla,125953,1942389,189209,1753180,1942389,186861
2020/04/08,Sevilla,Huelva,338,521870,52194,469676,1942389,186861
2020/04/08,Sevilla,Málaga,49,1661785,132292,1529493,1942389,186861
2020/04/08,Sevilla,Cádiz,659,1240155,111769,1128386,1942389,186861
2020/04/08,Sevilla,Córdoba,1511,782979,76790,706189,1942389,186861
2020/04/08,Soria,Soria,3940,88636,5557,83079,88636,5883
2020/04/08,Soria,Valladolid,34,519546,54175,465371,88636,5883
2020/04/08,Tarragona,Tarragona,45824,804664,70633,734031,804664,70272
2020/04/08,Tarragona,Barcelona,515,5664579,587217,5077362,804664,70272
2020/04/08,Tarragona,Zaragoza,48,964724,105663,859061,804664,70272
2020/04/08,Tarragona,Teruel,28,134137,6125,128012,804664,70272
2020/04/08,Tarragona,Castellón,569,579962,51129,528833,804664,70272
2020/04/08,Teruel,Castellón,64,579962,51129,528833,134137,6770
2020/04/08,Teruel,Teruel,3150,134137,6125,128012,134137,6770
2020/04/08,Teruel,Tarragona,66,804664,70633,734031,134137,6770
2020/04/08,Toledo,Cáceres,133,394151,26299,367852,694844,54860
2020/04/08,Toledo,Ávila,143,157640,12009,145631,694844,54860
2020/04/08,Toledo,Toledo,28832,694844,55365,639479,694844,54860
2020/04/08,Toledo,Ciudad Real,166,495761,29746,466015,694844,54860
2020/04/08,Toledo,Madrid,2333,6663394,651814,6011580,694844,54860
2020/04/08,Valencia,Albacete,287,388167,26101,362066,2565124,281478
2020/04/08,Valencia,Valencia,192568,2565124,286052,2279072,2565124,281478
2020/04/08,Valencia,Cuenca,85,196329,13248,183081,2565124,281478
2020/04/08,Valencia,Castellón,444,579962,51129,528833,2565124,281478
2020/04/08,Valencia,Madrid,17,6663394,651814,6011580,2565124,281478
2020/04/08,Valencia,Alicante,676,1858683,176485,1682198,2565124,281478
2020/04/08,Valladolid,Valladolid,37334,519546,54175,465371,519546,52327
2020/04/08,Valladolid,León,33,460001,47099,412902,519546,52327
2020/04/08,Valladolid,Zamora,34,172539,15940,156599,519546,52327
2020/04/08,Valladolid,Burgos,89,357072,29412,327660,519546,52327
2020/04/08,Valladolid,Soria,24,88636,5557,83079,519546,52327
2020/04/08,Valladolid,Segovia,208,153129,13811,139318,519546,52327
2020/04/08,Valladolid,Palencia,31,160866,15730,145136,519546,52327
2020/04/08,Zamora,Zamora,10975,172539,15940,156599,172539,15912
2020/04/08,Zamora,León,109,460001,47099,412902,172539,15912
2020/04/08,Zaragoza,Teruel,40,134137,6125,128012,964724,101924
2020/04/08,Zaragoza,Navarra,331,654183,66083,588100,964724,101924
2020/04/08,Zaragoza,Huesca,183,220461,18818,201643,964724,101924
2020/04/08,Zaragoza,Lleida,106,434930,43404,391526,964724,101924
2020/04/08,Zaragoza,Zaragoza,77018,964724,105663,859061,964724,101924
2020/04/09,Albacete,Jaén,25,633564,37595,595969,388167,24111
2020/04/09,Albacete,Valencia,268,2565124,277068,2288056,388167,24111
2020/04/09,Albacete,Cuenca,267,196329,8699,187630,388167,24111
2020/04/09,Albacete,Ciudad Real,365,495761,20523,475238,388167,24111
2020/04/09,Albacete,Albacete,17573,388167,24441,363726,388167,24111
2020/04/09,Albacete,Almería,17,716820,45070,671750,388167,24111
2020/04/09,Albacete,Alicante,105,1858683,172532,1686151,388167,24111
2020/04/09,Albacete,Murcia,281,1493898,118994,1374904,388167,24111
2020/04/09,Alicante,Murcia,2425,1493898,118994,1374904,1858683,176127
2020/04/09,Alicante,Alicante,135771,1858683,172532,1686151,1858683,176127
2020/04/09,Alicante,Valencia,764,2565124,277068,2288056,1858683,176127
2020/04/09,Alicante,Albacete,179,388167,24441,363726,1858683,176127
2020/04/09,Almería,Almería,35354,716820,45070,671750,716820,46440
2020/04/09,Almería,Murcia,1276,1493898,118994,1374904,716820,46440
2020/04/09,Almería,Granada,276,914678,69580,845098,716820,46440
2020/04/09,Araba,Gipuzkoa,94,723576,42110,681466,331549,25748
2020/04/09,Araba,Rioja,440,316798,20524,296274,331549,25748
2020/04/09,Araba,Burgos,559,357072,19418,337654,331549,25748
2020/04/09,Araba,Araba,20856,331549,24821,306728,331549,25748
2020/04/09,Araba,Bizkaia,225,1152934,102258,1050676,331549,25748
2020/04/09,Asturias,Asturias,51025,1022800,65656,957144,1022800,66147
2020/04/09,Asturias,Cantabria,82,580795,41337,539458,1022800,66147
2020/04/09,Asturias,Lugo,584,329587,19974,309613,1022800,66147
2020/04/09,Ávila,Cáceres,64,394151,20570,373581,157640,9622
2020/04/09,Ávila,Toledo,56,694844,35083,659761,157640,9622
2020/04/09,Ávila,Segovia,53,153129,9794,143335,157640,9622
2020/04/09,Ávila,Ávila,6033,157640,8734,148906,157640,9622
2020/04/09,Ávila,Madrid,22,6663394,479108,6184286,157640,9622
2020/04/09,Ávila,Salamanca,747,330119,25327,304792,157640,9622
2020/04/09,Ávila,Melilla,16,86487,6673,79814,157640,9622
2020/04/09,Badajoz,Cáceres,746,394151,20570,373581,673559,44519
2020/04/09,Badajoz,Huelva,232,521870,39405,482465,673559,44519
2020/04/09,Badajoz,Ciudad Real,48,495761,20523,475238,673559,44519
2020/04/09,Badajoz,Córdoba,17,782979,61497,721482,673559,44519
2020/04/09,Badajoz,Badajoz,33683,673559,44784,628775,673559,44519
2020/04/09,Balears,Alicante,17,1858683,172532,1686151,1149460,64604
2020/04/09,Balears,Balears,53328,1149460,64146,1085314,1149460,64604
2020/04/09,Barcelona,Girona,1480,771044,56883,714161,5664579,577360
2020/04/09,Barcelona,Lleida,93,434930,42925,392005,5664579,577360
2020/04/09,Barcelona,Barcelona,378759,5664579,575375,5089204,5664579,577360
2020/04/09,Barcelona,Tarragona,465,804664,69013,735651,5664579,577360
2020/04/09,Barcelona,Balears,16,1149460,64146,1085314,5664579,577360
2020/04/09,Bizkaia,Bizkaia,81230,1152934,102258,1050676,1152934,101835
2020/04/09,Bizkaia,Gipuzkoa,310,723576,42110,681466,1152934,101835
2020/04/09,Bizkaia,Araba,211,331549,24821,306728,1152934,101835
2020/04/09,Bizkaia,Cantabria,487,580795,41337,539458,1152934,101835
2020/04/09,Burgos,Araba,475,331549,24821,306728,357072,19617
2020/04/09,Burgos,Palencia,191,160866,11338,149528,357072,19617
2020/04/09,Burgos,Valladolid,102,519546,37514,482032,357072,19617
2020/04/09,Burgos,Segovia,19,153129,9794,143335,357072,19617
2020/04/09,Burgos,Burgos,14190,357072,19418,337654,357072,19617
2020/04/09,Cáceres,Ávila,113,157640,8734,148906,394151,20582
2020/04/09,Cáceres,Badajoz,632,673559,44784,628775,394151,20582
2020/04/09,Cáceres,Toledo,63,694844,35083,659761,394151,20582
2020/04/09,Cáceres,Cáceres,13812,394151,20570,373581,394151,20582
2020/04/09,Cádiz,Ceuta,21,84777,4858,79919,1240155,90978
2020/04/09,Cádiz,Málaga,576,1661785,97434,1564351,1240155,90978
2020/04/09,Cádiz,Cádiz,76756,1240155,90139,1150016,1240155,90978
2020/04/09,Cádiz,Sevilla,778,1942389,142371,1800018,1240155,90978
2020/04/09,Cádiz,Huelva,733,521870,39405,482465,1240155,90978
2020/04/09,Cantabria,Cantabria,30295,580795,41337,539458,580795,40879
2020/04/09,Cantabria,Bizkaia,348,1152934,102258,1050676,580795,40879
2020/04/09,Cantabria,Asturias,128,1022800,65656,957144,580795,40879
2020/04/09,Castellón,Balears,18,1149460,64146,1085314,579962,50784
2020/04/09,Castellón,Castellón,36366,579962,49879,530083,579962,50784
2020/04/09,Castellón,Valencia,608,2565124,277068,2288056,579962,50784
2020/04/09,Castellón,Tarragona,742,804664,69013,735651,579962,50784
2020/04/09,Castellón,Teruel,37,134137,4241,129896,579962,50784
2020/04/09,Castellón,Alicante,20,1858683,172532,1686151,579962,50784
2020/04/09,Ceuta,Ceuta,4532,84777,4858,79919,84777,4939
2020/04/09,Ceuta,Cádiz,61,1240155,90139,1150016,84777,4939
2020/04/09,Ceuta,Melilla,16,86487,6673,79814,84777,4939
2020/04/09,Ciudad Real,Badajoz,64,673559,44784,628775,495761,20318
2020/04/09,Ciudad Real,Toledo,44,694844,35083,659761,495761,20318
2020/04/09,Ciudad Real,Jaén,23,633564,37595,595969,495761,20318
2020/04/09,Ciudad Real,Córdoba,478,782979,61497,721482,495761,20318
2020/04/09,Ciudad Real,Albacete,411,388167,24441,363726,495761,20318
2020/04/09,Ciudad Real,Ciudad Real,13210,495761,20523,475238,495761,20318
2020/04/09,Córdoba,Badajoz,108,673559,44784,628775,782979,61156
2020/04/09,Córdoba,Málaga,155,1661785,97434,1564351,782979,61156
2020/04/09,Córdoba,Ciudad Real,267,495761,20523,475238,782979,61156
2020/04/09,Córdoba,Granada,163,914678,69580,845098,782979,61156
2020/04/09,Córdoba,Sevilla,1263,1942389,142371,1800018,782979,61156
2020/04/09,Córdoba,Jaén,704,633564,37595,595969,782979,61156
2020/04/09,Córdoba,Córdoba,46244,782979,61497,721482,782979,61156
2020/04/09,Coruña,Lugo,232,329587,19974,309613,1119596,80252
2020/04/09,Coruña,Coruña,62914,1119596,80045,1039551,1119596,80252
2020/04/09,Coruña,Pontevedra,2880,942665,69255,873410,1119596,80252
2020/04/09,Cuenca,Albacete,492,388167,24441,363726,196329,8368
2020/04/09,Cuenca,Ciudad Real,59,495761,20523,475238,196329,8368
2020/04/09,Cuenca,Toledo,64,694844,35083,659761,196329,8368
2020/04/09,Cuenca,Guadalajara,20,257762,14765,242997,196329,8368
2020/04/09,Cuenca,Madrid,23,6663394,479108,6184286,196329,8368
2020/04/09,Cuenca,Cuenca,4214,196329,8699,187630,196329,8368
2020/04/09,Cuenca,Valencia,47,2565124,277068,2288056,196329,8368
2020/04/09,Gipuzkoa,Bizkaia,435,1152934,102258,1050676,723576,42828
2020/04/09,Gipuzkoa,Gipuzkoa,31870,723576,42110,681466,723576,42828
2020/04/09,Gipuzkoa,Navarra,66,654183,45817,608366,723576,42828
2020/04/09,Girona,Murcia,48,1493898,118994,1374904,771044,59883
2020/04/09,Girona,Girona,37719,771044,56883,714161,771044,59883
2020/04/09,Girona,Lleida,65,434930,42925,392005,771044,59883
2020/04/09,Girona,Barcelona,1508,5664579,575375,5089204,771044,59883
2020/04/09,Granada,Murcia,24,1493898,118994,1374904,914678,69104
2020/04/09,Granada,Córdoba,268,782979,61497,721482,914678,69104
2020/04/09,Granada,Granada,50673,914678,69580,845098,914678,69104
2020/04/09,Granada,Jaén,312,633564,37595,595969,914678,69104
2020/04/09,Granada,Málaga,127,1661785,97434,1564351,914678,69104
2020/04/09,Granada,Almería,252,716820,45070,671750,914678,69104
2020/04/09,Guadalajara,Madrid,732,6663394,479108,6184286,257762,14190
2020/04/09,Guadalajara,Guadalajara,9059,257762,14765,242997,257762,14190
2020/04/09,Guadalajara,Cuenca,25,196329,8699,187630,257762,14190
2020/04/09,Huelva,Cádiz,707,1240155,90139,1150016,521870,40026
2020/04/09,Huelva,Sevilla,769,1942389,142371,1800018,521870,40026
2020/04/09,Huelva,Huelva,30635,521870,39405,482465,521870,40026
2020/04/09,Huelva,Badajoz,269,673559,44784,628775,521870,40026
2020/04/09,Huelva,Jaén,17,633564,37595,595969,521870,40026
2020/04/09,Huesca,Huesca,8822,220461,13752,206709,220461,14769
2020/04/09,Huesca,Zaragoza,136,964724,71112,893612,220461,14769
2020/04/09,Huesca,Tarragona,19,804664,69013,735651,220461,14769
2020/04/09,Huesca,Lleida,733,434930,42925,392005,220461,14769
2020/04/09,Jaén,Granada,315,914678,69580,845098,633564,36474
2020/04/09,Jaén,Jaén,26999,633564,37595,595969,633564,36474
2020/04/09,Jaén,Córdoba,628,782979,61497,721482,633564,36474
2020/04/09,Jaén,Sevilla,16,1942389,142371,1800018,633564,36474
2020/04/09,Las Palmas de Gran Canaria,Las Palmas de Gran Canaria,64564,1120406,75133,1045273,1120406,74601
2020/04/09,León,Ourense,35,307651,23789,283862,460001,32693
2020/04/09,León,Asturias,16,1022800,65656,957144,460001,32693
2020/04/09,León,León,24866,460001,33288,426713,460001,32693
2020/04/09,León,Zamora,51,172539,11381,161158,460001,32693
2020/04/09,Lleida,Girona,85,771044,56883,714161,434930,41536
2020/04/09,Lleida,Lleida,27588,434930,42925,392005,434930,41536
2020/04/09,Lleida,Huesca,494,220461,13752,206709,434930,41536
2020/04/09,Lleida,Barcelona,117,5664579,575375,5089204,434930,41536
2020/04/09,Lleida,Zaragoza,110,964724,71112,893612,434930,41536
2020/04/09,Lugo,Lugo,14320,329587,19974,309613,329587,20458
2020/04/09,Lugo,Balears,16,1149460,64146,1085314,329587,20458
2020/04/09,Lugo,Ourense,39,307651,23789,283862,329587,20458
2020/04/09,Lugo,Asturias,467,1022800,65656,957144,329587,20458
2020/04/09,Lugo,Coruña,331,1119596,80045,1039551,329587,20458
2020/04/09,Madrid,Ávila,49,157640,8734,148906,6663394,480272
2020/04/09,Madrid,Alicante,45,1858683,172532,1686151,6663394,480272
2020/04/09,Madrid,Guadalajara,830,257762,14765,242997,6663394,480272
2020/04/09,Madrid,Cuenca,45,196329,8699,187630,6663394,480272
2020/04/09,Madrid,Madrid,331043,6663394,479108,6184286,6663394,480272
2020/04/09,Madrid,Toledo,1649,694844,35083,659761,6663394,480272
2020/04/09,Málaga,Málaga,77283,1661785,97434,1564351,1661785,97995
2020/04/09,Málaga,Granada,71,914678,69580,845098,1661785,97995
2020/04/09,Málaga,Córdoba,143,782979,61497,721482,1661785,97995
2020/04/09,Málaga,Melilla,55,86487,6673,79814,1661785,97995
2020/04/09,Málaga,Almería,17,716820,45070,671750,1661785,97995
2020/04/09,Málaga,Cádiz,477,1240155,90139,1150016,1661785,97995
2020/04/09,Málaga,Sevilla,210,1942389,142371,1800018,1661785,97995
2020/04/09,Melilla,Melilla,6372,86487,6673,79814,86487,6422
2020/04/09,Murcia,Alicante,1929,1858683,172532,1686151,1493898,117172
2020/04/09,Murcia,Albacete,258,388167,24441,363726,1493898,117172
2020/04/09,Murcia,Almería,998,716820,45070,671750,1493898,117172
2020/04/09,Murcia,Cuenca,17,196329,8699,187630,1493898,117172
2020/04/09,Murcia,Granada,16,914678,69580,845098,1493898,117172
2020/04/09,Murcia,Murcia,90214,1493898,118994,1374904,1493898,117172
2020/04/09,Navarra,Araba,37,331549,24821,306728,654183,44994
2020/04/09,Navarra,Zaragoza,214,964724,71112,893612,654183,44994
2020/04/09,Navarra,Gipuzkoa,136,723576,42110,681466,654183,44994
2020/04/09,Navarra,Navarra,32111,654183,45817,608366,654183,44994
2020/04/09,Navarra,Rioja,806,316798,20524,296274,654183,44994
2020/04/09,Ourense,Lugo,39,329587,19974,309613,307651,23634
2020/04/09,Ourense,Ourense,18882,307651,23789,283862,307651,23634
2020/04/09,Ourense,León,84,460001,33288,426713,307651,23634
2020/04/09,Ourense,Pontevedra,121,942665,69255,873410,307651,23634
2020/04/09,Palencia,Palencia,8317,160866,11338,149528,160866,11418
2020/04/09,Palencia,Burgos,136,357072,19418,337654,160866,11418
2020/04/09,Palencia,Valladolid,44,519546,37514,482032,160866,11418
2020/04/09,Pontevedra,Ourense,132,307651,23789,283862,942665,69523
2020/04/09,Pontevedra,Pontevedra,54437,942665,69255,873410,942665,69523
2020/04/09,Pontevedra,Coruña,2903,1119596,80045,1039551,942665,69523
2020/04/09,Rioja,Navarra,1082,654183,45817,608366,316798,20456
2020/04/09,Rioja,Rioja,14899,316798,20524,296274,316798,20456
2020/04/09,Rioja,Araba,306,331549,24821,306728,316798,20456
2020/04/09,Salamanca,Cáceres,17,394151,20570,373581,330119,24153
2020/04/09,Salamanca,Ávila,44,157640,8734,148906,330119,24153
2020/04/09,Salamanca,Salamanca,19210,330119,25327,304792,330119,24153
2020/04/09,Santa Cruz de Tenerife,Santa Cruz de Tenerife,62675,1032983,72788,960195,1032983,72763
2020/04/09,Segovia,Segovia,6624,153129,9794,143335,153129,10032
2020/04/09,Segovia,Burgos,26,357072,19418,337654,153129,10032
2020/04/09,Segovia,Ávila,59,157640,8734,148906,153129,10032
2020/04/09,Segovia,Valladolid,180,519546,37514,482032,153129,10032
2020/04/09,Sevilla,Córdoba,1486,782979,61497,721482,1942389,140953
2020/04/09,Sevilla,Huelva,365,521870,39405,482465,1942389,140953
2020/04/09,Sevilla,Badajoz,33,673559,44784,628775,1942389,140953
2020/04/09,Sevilla,Sevilla,102792,1942389,142371,1800018,1942389,140953
2020/04/09,Sevilla,Cádiz,697,1240155,90139,1150016,1942389,140953
2020/04/09,Sevilla,Málaga,109,1661785,97434,1564351,1942389,140953
2020/04/09,Soria,Valladolid,33,519546,37514,482032,88636,4031
2020/04/09,Soria,Soria,2890,88636,3857,84779,88636,4031
2020/04/09,Soria,Burgos,31,357072,19418,337654,88636,4031
2020/04/09,Tarragona,Teruel,58,134137,4241,129896,804664,68805
2020/04/09,Tarragona,Castellón,535,579962,49879,530083,804664,68805
2020/04/09,Tarragona,Barcelona,513,5664579,575375,5089204,804664,68805
2020/04/09,Tarragona,Tarragona,46381,804664,69013,735651,804664,68805
2020/04/09,Tarragona,Zaragoza,43,964724,71112,893612,804664,68805
2020/04/09,Teruel,Tarragona,78,804664,69013,735651,134137,4455
2020/04/09,Teruel,Teruel,2276,134137,4241,129896,134137,4455
2020/04/09,Teruel,Castellón,47,579962,49879,530083,134137,4455
2020/04/09,Toledo,Madrid,1483,6663394,479108,6184286,694844,34452
2020/04/09,Toledo,Cáceres,86,394151,20570,373581,694844,34452
2020/04/09,Toledo,Ciudad Real,48,495761,20523,475238,694844,34452
2020/04/09,Toledo,Toledo,19358,694844,35083,659761,694844,34452
2020/04/09,Toledo,Ávila,72,157640,8734,148906,694844,34452
2020/04/09,Valencia,Cuenca,84,196329,8699,187630,2565124,272616
2020/04/09,Valencia,Almería,17,716820,45070,671750,2565124,272616
2020/04/09,Valencia,Albacete,268,388167,24441,363726,2565124,272616
2020/04/09,Valencia,Valencia,180093,2565124,277068,2288056,2565124,272616
2020/04/09,Valencia,Sevilla,17,1942389,142371,1800018,2565124,272616
2020/04/09,Valencia,Alicante,525,1858683,172532,1686151,2565124,272616
2020/04/09,Valencia,Castellón,517,579962,49879,530083,2565124,272616
2020/04/09,Valencia,Madrid,28,6663394,479108,6184286,2565124,272616
2020/04/09,Valladolid,Burgos,97,357072,19418,337654,519546,36676
2020/04/09,Valladolid,Palencia,18,160866,11338,149528,519546,36676
2020/04/09,Valladolid,Segovia,136,153129,9794,143335,519546,36676
2020/04/09,Valladolid,Valladolid,26966,519546,37514,482032,519546,36676
2020/04/09,Zamora,Salamanca,42,330119,25327,304792,172539,11566
2020/04/09,Zamora,León,132,460001,33288,426713,172539,11566
2020/04/09,Zamora,Zamora,8341,172539,11381,161158,172539,11566
2020/04/09,Zaragoza,Zaragoza,50819,964724,71112,893612,964724,69333
2020/04/09,Zaragoza,Huesca,187,220461,13752,206709,964724,69333
2020/04/09,Zaragoza,Navarra,405,654183,45817,608366,964724,69333
2020/04/09,Zaragoza,Teruel,48,134137,4241,129896,964724,69333
2020/04/09,Zaragoza,Lleida,57,434930,42925,392005,964724,69333
2020/04/10,Albacete,Albacete,15145,388167,19992,368175,388167,20080
2020/04/10,Albacete,Alicante,141,1858683,121638,1737045,388167,20080
2020/04/10,Albacete,Murcia,87,1493898,88615,1405283,388167,20080
2020/04/10,Albacete,Valencia,248,2565124,182542,2382582,388167,20080
2020/04/10,Albacete,Ciudad Real,255,495761,15246,480515,388167,20080
2020/04/10,Albacete,Jaén,17,633564,28772,604792,388167,20080
2020/04/10,Albacete,Cuenca,222,196329,6001,190328,388167,20080
2020/04/10,Alicante,Valencia,427,2565124,182542,2382582,1858683,122322
2020/04/10,Alicante,Murcia,1806,1493898,88615,1405283,1858683,122322
2020/04/10,Alicante,Albacete,157,388167,19992,368175,1858683,122322
2020/04/10,Alicante,Alicante,99362,1858683,121638,1737045,1858683,122322
2020/04/10,Almería,Almería,24380,716820,32347,684473,716820,32559
2020/04/10,Almería,Murcia,538,1493898,88615,1405283,716820,32559
2020/04/10,Almería,Alicante,35,1858683,121638,1737045,716820,32559
2020/04/10,Almería,Granada,262,914678,59426,855252,716820,32559
2020/04/10,Araba,Rioja,419,316798,17344,299454,331549,23442
2020/04/10,Araba,Burgos,537,357072,15611,341461,331549,23442
2020/04/10,Araba,Araba,18549,331549,21966,309583,331549,23442
2020/04/10,Araba,Gipuzkoa,32,723576,37110,686466,331549,23442
2020/04/10,Araba,Bizkaia,394,1152934,94170,1058764,331549,23442
2020/04/10,Asturias,Asturias,42964,1022800,55352,967448,1022800,55772
2020/04/10,Asturias,Cantabria,109,580795,36220,544575,1022800,55772
2020/04/10,Asturias,León,29,460001,29073,430928,1022800,55772
2020/04/10,Asturias,Lugo,485,329587,17050,312537,1022800,55772
2020/04/10,Ávila,Segovia,66,153129,8070,145059,157640,8169
2020/04/10,Ávila,Toledo,126,694844,29768,665076,157640,8169
2020/04/10,Ávila,Madrid,30,6663394,423231,6240163,157640,8169
2020/04/10,Ávila,Cáceres,84,394151,17714,376437,157640,8169
2020/04/10,Ávila,Salamanca,129,330119,22116,308003,157640,8169
2020/04/10,Ávila,Ávila,5549,157640,7779,149861,157640,8169
2020/04/10,Badajoz,Ciudad Real,34,495761,15246,480515,673559,37068
2020/04/10,Badajoz,Cáceres,617,394151,17714,376437,673559,37068
2020/04/10,Badajoz,Huelva,209,521870,36329,485541,673559,37068
2020/04/10,Badajoz,Córdoba,33,782979,51414,731565,673559,37068
2020/04/10,Badajoz,Badajoz,28114,673559,37193,636366,673559,37068
2020/04/10,Balears,Balears,43269,1149460,53372,1096088,1149460,53221
2020/04/10,Barcelona,Barcelona,303727,5664579,417148,5247431,5664579,417845
2020/04/10,Barcelona,Tarragona,422,804664,46801,757863,5664579,417845
2020/04/10,Barcelona,Lleida,64,434930,28200,406730,5664579,417845
2020/04/10,Barcelona,Girona,1312,771044,38619,732425,5664579,417845
2020/04/10,Bizkaia,Gipuzkoa,272,723576,37110,686466,1152934,93670
2020/04/10,Bizkaia,Araba,174,331549,21966,309583,1152934,93670
2020/04/10,Bizkaia,Bizkaia,75184,1152934,94170,1058764,1152934,93670
2020/04/10,Bizkaia,Cantabria,418,580795,36220,544575,1152934,93670
2020/04/10,Burgos,Valladolid,23,519546,31703,487843,357072,15643
2020/04/10,Burgos,Palencia,155,160866,8991,151875,357072,15643
2020/04/10,Burgos,Burgos,11714,357072,15611,341461,357072,15643
2020/04/10,Burgos,Araba,316,331549,21966,309583,357072,15643
2020/04/10,Cáceres,Cáceres,11360,394151,17714,376437,394151,17575
2020/04/10,Cáceres,Toledo,62,694844,29768,665076,394151,17575
2020/04/10,Cáceres,Ávila,40,157640,7779,149861,394151,17575
2020/04/10,Cáceres,Badajoz,487,673559,37193,636366,394151,17575
2020/04/10,Cádiz,Málaga,552,1661785,86481,1575304,1240155,81607
2020/04/10,Cádiz,Cádiz,68706,1240155,81090,1159065,1240155,81607
2020/04/10,Cádiz,Huelva,710,521870,36329,485541,1240155,81607
2020/04/10,Cádiz,Sevilla,597,1942389,125505,1816884,1240155,81607
2020/04/10,Cádiz,Almería,19,716820,32347,684473,1240155,81607
2020/04/10,Cantabria,Asturias,99,1022800,55352,967448,580795,35820
2020/04/10,Cantabria,Bizkaia,352,1152934,94170,1058764,580795,35820
2020/04/10,Cantabria,Cantabria,26893,580795,36220,544575,580795,35820
2020/04/10,Castellón,Tarragona,912,804664,46801,757863,579962,33903
2020/04/10,Castellón,Teruel,33,134137,3368,130769,579962,33903
2020/04/10,Castellón,Castellón,24194,579962,33904,546058,579962,33903
2020/04/10,Castellón,Valencia,549,2565124,182542,2382582,579962,33903
2020/04/10,Ceuta,Cádiz,41,1240155,81090,1159065,84777,4719
2020/04/10,Ceuta,Ceuta,4293,84777,4511,80266,84777,4719
2020/04/10,Ciudad Real,Toledo,18,694844,29768,665076,495761,15218
2020/04/10,Ciudad Real,Albacete,242,388167,19992,368175,495761,15218
2020/04/10,Ciudad Real,Jaén,18,633564,28772,604792,495761,15218
2020/04/10,Ciudad Real,Córdoba,389,782979,51414,731565,495761,15218
2020/04/10,Ciudad Real,Ciudad Real,10212,495761,15246,480515,495761,15218
2020/04/10,Córdoba,Granada,109,914678,59426,855252,782979,51126
2020/04/10,Córdoba,Badajoz,17,673559,37193,636366,782979,51126
2020/04/10,Córdoba,Sevilla,805,1942389,125505,1816884,782979,51126
2020/04/10,Córdoba,Málaga,70,1661785,86481,1575304,782979,51126
2020/04/10,Córdoba,Jaén,394,633564,28772,604792,782979,51126
2020/04/10,Córdoba,Ciudad Real,172,495761,15246,480515,782979,51126
2020/04/10,Córdoba,Córdoba,38903,782979,51414,731565,782979,51126
2020/04/10,Coruña,Lugo,244,329587,17050,312537,1119596,70049
2020/04/10,Coruña,Pontevedra,2799,942665,61015,881650,1119596,70049
2020/04/10,Coruña,Coruña,53730,1119596,69528,1050068,1119596,70049
2020/04/10,Cuenca,Toledo,25,694844,29768,665076,196329,6024
2020/04/10,Cuenca,Albacete,309,388167,19992,368175,196329,6024
2020/04/10,Cuenca,Valencia,39,2565124,182542,2382582,196329,6024
2020/04/10,Cuenca,Alicante,17,1858683,121638,1737045,196329,6024
2020/04/10,Cuenca,Cuenca,3177,196329,6001,190328,196329,6024
2020/04/10,Gipuzkoa,Bizkaia,348,1152934,94170,1058764,723576,37211
2020/04/10,Gipuzkoa,Navarra,69,654183,38328,615855,723576,37211
2020/04/10,Gipuzkoa,Gipuzkoa,27582,723576,37110,686466,723576,37211
2020/04/10,Gipuzkoa,Araba,28,331549,21966,309583,723576,37211
2020/04/10,Girona,Barcelona,1096,5664579,417148,5247431,771044,40027
2020/04/10,Girona,Lleida,53,434930,28200,406730,771044,40027
2020/04/10,Girona,Girona,26419,771044,38619,732425,771044,40027
2020/04/10,Granada,Málaga,70,1661785,86481,1575304,914678,58843
2020/04/10,Granada,Almería,173,716820,32347,684473,914678,58843
2020/04/10,Granada,Córdoba,132,782979,51414,731565,914678,58843
2020/04/10,Granada,Jaén,111,633564,28772,604792,914678,58843
2020/04/10,Granada,Granada,44289,914678,59426,855252,914678,58843
2020/04/10,Guadalajara,Guadalajara,7843,257762,12597,245165,257762,12152
2020/04/10,Guadalajara,Madrid,532,6663394,423231,6240163,257762,12152
2020/04/10,Huelva,Huelva,27778,521870,36329,485541,521870,36784
2020/04/10,Huelva,Sevilla,720,1942389,125505,1816884,521870,36784
2020/04/10,Huelva,Cádiz,647,1240155,81090,1159065,521870,36784
2020/04/10,Huelva,Badajoz,208,673559,37193,636366,521870,36784
2020/04/10,Huesca,Zaragoza,107,964724,62477,902247,220461,11895
2020/04/10,Huesca,Lleida,429,434930,28200,406730,220461,11895
2020/04/10,Huesca,Huesca,7510,220461,11196,209265,220461,11895
2020/04/10,Jaén,Granada,131,914678,59426,855252,633564,28319
2020/04/10,Jaén,Córdoba,295,782979,51414,731565,633564,28319
2020/04/10,Jaén,Jaén,20830,633564,28772,604792,633564,28319
2020/04/10,Las Palmas de Gran Canaria,Las Palmas de Gran Canaria,50249,1120406,60129,1060277,1120406,59873
2020/04/10,León,León,21600,460001,29073,430928,460001,29015
2020/04/10,León,Ourense,63,307651,20694,286957,460001,29015
2020/04/10,León,Asturias,40,1022800,55352,967448,460001,29015
2020/04/10,León,Valladolid,29,519546,31703,487843,460001,29015
2020/04/10,León,Zamora,80,172539,9348,163191,460001,29015
2020/04/10,Lleida,Huesca,305,220461,11196,209265,434930,27533
2020/04/10,Lleida,Barcelona,59,5664579,417148,5247431,434930,27533
2020/04/10,Lleida,Lleida,18236,434930,28200,406730,434930,27533
2020/04/10,Lleida,Zaragoza,61,964724,62477,902247,434930,27533
2020/04/10,Lleida,Girona,36,771044,38619,732425,434930,27533
2020/04/10,Lugo,Coruña,253,1119596,69528,1050068,329587,17149
2020/04/10,Lugo,Ourense,16,307651,20694,286957,329587,17149
2020/04/10,Lugo,Lugo,12039,329587,17050,312537,329587,17149
2020/04/10,Lugo,Asturias,320,1022800,55352,967448,329587,17149
2020/04/10,Madrid,Barcelona,16,5664579,417148,5247431,6663394,426527
2020/04/10,Madrid,Madrid,293661,6663394,423231,6240163,6663394,426527
2020/04/10,Madrid,Cuenca,30,196329,6001,190328,6663394,426527
2020/04/10,Madrid,Ciudad Real,16,495761,15246,480515,6663394,426527
2020/04/10,Madrid,Guadalajara,709,257762,12597,245165,6663394,426527
2020/04/10,Madrid,Toledo,1311,694844,29768,665076,6663394,426527
2020/04/10,Málaga,Granada,86,914678,59426,855252,1661785,86651
2020/04/10,Málaga,Sevilla,161,1942389,125505,1816884,1661785,86651
2020/04/10,Málaga,Cádiz,445,1240155,81090,1159065,1661785,86651
2020/04/10,Málaga,Málaga,68589,1661785,86481,1575304,1661785,86651
2020/04/10,Málaga,Córdoba,106,782979,51414,731565,1661785,86651
2020/04/10,Melilla,Melilla,6368,86487,6411,80076,86487,6401
2020/04/10,Murcia,Almería,604,716820,32347,684473,1493898,88736
2020/04/10,Murcia,Granada,21,914678,59426,855252,1493898,88736
2020/04/10,Murcia,Alicante,1646,1858683,121638,1737045,1493898,88736
2020/04/10,Murcia,Murcia,69002,1493898,88615,1405283,1493898,88736
2020/04/10,Murcia,Albacete,93,388167,19992,368175,1493898,88736
2020/04/10,Navarra,Rioja,537,316798,17344,299454,654183,38077
2020/04/10,Navarra,Huelva,17,521870,36329,485541,654183,38077
2020/04/10,Navarra,Zaragoza,204,964724,62477,902247,654183,38077
2020/04/10,Navarra,Alicante,30,1858683,121638,1737045,654183,38077
2020/04/10,Navarra,Gipuzkoa,122,723576,37110,686466,654183,38077
2020/04/10,Navarra,Navarra,26489,654183,38328,615855,654183,38077
2020/04/10,Ourense,Pontevedra,77,942665,61015,881650,307651,20559
2020/04/10,Ourense,León,71,460001,29073,430928,307651,20559
2020/04/10,Ourense,Lugo,40,329587,17050,312537,307651,20559
2020/04/10,Ourense,Ourense,16083,307651,20694,286957,307651,20559
2020/04/10,Palencia,Burgos,132,357072,15611,341461,160866,9186
2020/04/10,Palencia,Palencia,6749,160866,8991,151875,160866,9186
2020/04/10,Pontevedra,Ourense,151,307651,20694,286957,942665,60551
2020/04/10,Pontevedra,Pontevedra,47726,942665,61015,881650,942665,60551
2020/04/10,Pontevedra,Coruña,2375,1119596,69528,1050068,942665,60551
2020/04/10,Rioja,Araba,325,331549,21966,309583,316798,17268
2020/04/10,Rioja,Rioja,12604,316798,17344,299454,316798,17268
2020/04/10,Rioja,Navarra,700,654183,38328,615855,316798,17268
2020/04/10,Salamanca,Cáceres,49,394151,17714,376437,330119,21837
2020/04/10,Salamanca,Salamanca,17214,330119,22116,308003,330119,21837
2020/04/10,Salamanca,Ávila,102,157640,7779,149861,330119,21837
2020/04/10,Santa Cruz de Tenerife,Santa Cruz de Tenerife,46641,1032983,55954,977029,1032983,55847
2020/04/10,Segovia,Ávila,56,157640,7779,149861,153129,8308
2020/04/10,Segovia,Segovia,5363,153129,8070,145059,153129,8308
2020/04/10,Segovia,Valladolid,54,519546,31703,487843,153129,8308
2020/04/10,Sevilla,Sevilla,91198,1942389,125505,1816884,1942389,124307
2020/04/10,Sevilla,Málaga,41,1661785,86481,1575304,1942389,124307
2020/04/10,Sevilla,Albacete,17,388167,19992,368175,1942389,124307
2020/04/10,Sevilla,Badajoz,20,673559,37193,636366,1942389,124307
2020/04/10,Sevilla,Huelva,276,521870,36329,485541,1942389,124307
2020/04/10,Sevilla,Cádiz,508,1240155,81090,1159065,1942389,124307
2020/04/10,Sevilla,Córdoba,856,782979,51414,731565,1942389,124307
2020/04/10,Soria,Valladolid,24,519546,31703,487843,88636,3019
2020/04/10,Soria,Soria,2196,88636,3004,85632,88636,3019
2020/04/10,Tarragona,Castellón,406,579962,33904,546058,804664,45342
2020/04/10,Tarragona,Zaragoza,42,964724,62477,902247,804664,45342
2020/04/10,Tarragona,Barcelona,487,5664579,417148,5247431,804664,45342
2020/04/10,Tarragona,Tarragona,31502,804664,46801,757863,804664,45342
2020/04/10,Teruel,Albacete,17,388167,19992,368175,134137,3409
2020/04/10,Teruel,Zaragoza,18,964724,62477,902247,134137,3409
2020/04/10,Teruel,Castellón,30,579962,33904,546058,134137,3409
2020/04/10,Teruel,Teruel,1673,134137,3368,130769,134137,3409
2020/04/10,Toledo,Cáceres,97,394151,17714,376437,694844,29398
2020/04/10,Toledo,Ciudad Real,33,495761,15246,480515,694844,29398
2020/04/10,Toledo,Ávila,58,157640,7779,149861,694844,29398
2020/04/10,Toledo,Toledo,16749,694844,29768,665076,694844,29398
2020/04/10,Toledo,Madrid,1275,6663394,423231,6240163,694844,29398
2020/04/10,Valencia,Alicante,272,1858683,121638,1737045,2565124,180427
2020/04/10,Valencia,Albacete,158,388167,19992,368175,2565124,180427
2020/04/10,Valencia,Valencia,128460,2565124,182542,2382582,2565124,180427
2020/04/10,Valencia,Castellón,330,579962,33904,546058,2565124,180427
2020/04/10,Valencia,Cuenca,69,196329,6001,190328,2565124,180427
2020/04/10,Valladolid,Burgos,68,357072,15611,341461,519546,31037
2020/04/10,Valladolid,Valladolid,23073,519546,31703,487843,519546,31037
2020/04/10,Valladolid,Huelva,17,521870,36329,485541,519546,31037
2020/04/10,Valladolid,Palencia,16,160866,8991,151875,519546,31037
2020/04/10,Valladolid,Segovia,76,153129,8070,145059,519546,31037
2020/04/10,Zamora,Zamora,6684,172539,9348,163191,172539,9521
2020/04/10,Zaragoza,Lleida,76,434930,28200,406730,964724,61422
2020/04/10,Zaragoza,Zaragoza,45571,964724,62477,902247,964724,61422
2020/04/10,Zaragoza,Navarra,250,654183,38328,615855,964724,61422
2020/04/10,Zaragoza,Huesca,61,220461,11196,209265,964724,61422
2020/04/10,Zaragoza,Sevilla,19,1942389,125505,1816884,964724,61422
2020/04/10,Zaragoza,Teruel,18,134137,3368,130769,964724,61422
2020/04/11,Albacete,Albacete,18937,388167,24606,363561,388167,24674
2020/04/11,Albacete,Alicante,101,1858683,134425,1724258,388167,24674
2020/04/11,Albacete,Cuenca,324,196329,7702,188627,388167,24674
2020/04/11,Albacete,Jaén,50,633564,36383,597181,388167,24674
2020/04/11,Albacete,Murcia,222,1493898,111189,1382709,388167,24674
2020/04/11,Albacete,Valencia,280,2565124,203236,2361888,388167,24674
2020/04/11,Albacete,Ciudad Real,254,495761,20096,475665,388167,24674
2020/04/11,Alicante,Alicante,109245,1858683,134425,1724258,1858683,136063
2020/04/11,Alicante,Valencia,627,2565124,203236,2361888,1858683,136063
2020/04/11,Alicante,Murcia,1960,1493898,111189,1382709,1858683,136063
2020/04/11,Alicante,Albacete,145,388167,24606,363561,1858683,136063
2020/04/11,Almería,Granada,337,914678,70402,844276,716820,45281
2020/04/11,Almería,Alicante,18,1858683,134425,1724258,716820,45281
2020/04/11,Almería,Murcia,990,1493898,111189,1382709,716820,45281
2020/04/11,Almería,Cádiz,17,1240155,92762,1147393,716820,45281
2020/04/11,Almería,Almería,35831,716820,44784,672036,716820,45281
2020/04/11,Araba,Burgos,581,357072,18533,338539,331549,26626
2020/04/11,Araba,Bizkaia,352,1152934,106291,1046643,331549,26626
2020/04/11,Araba,Rioja,331,316798,18598,298200,331549,26626
2020/04/11,Araba,Gipuzkoa,30,723576,44152,679424,331549,26626
2020/04/11,Araba,Málaga,16,1661785,103056,1558729,331549,26626
2020/04/11,Araba,Araba,21795,331549,25576,305973,331549,26626
2020/04/11,Araba,Navarra,30,654183,44266,609917,331549,26626
2020/04/11,Asturias,Lugo,515,329587,20575,309012,1022800,66648
2020/04/11,Asturias,Cantabria,160,580795,42431,538364,1022800,66648
2020/04/11,Asturias,Asturias,52138,1022800,66391,956409,1022800,66648
2020/04/11,Ávila,Toledo,113,694844,36347,658497,157640,8861
2020/04/11,Ávila,Ávila,6023,157640,8444,149196,157640,8861
2020/04/11,Ávila,Salamanca,193,330119,25041,305078,157640,8861
2020/04/11,Ávila,Cáceres,73,394151,20387,373764,157640,8861
2020/04/11,Ávila,Madrid,57,6663394,465897,6197497,157640,8861
2020/04/11,Ávila,Segovia,63,153129,9298,143831,157640,8861
2020/04/11,Badajoz,Badajoz,33634,673559,44289,629270,673559,43799
2020/04/11,Badajoz,Huelva,248,521870,40714,481156,673559,43799
2020/04/11,Badajoz,Ciudad Real,52,495761,20096,475665,673559,43799
2020/04/11,Badajoz,Cáceres,622,394151,20387,373764,673559,43799
2020/04/11,Badajoz,Córdoba,126,782979,61669,721310,673559,43799
2020/04/11,Balears,Balears,53784,1149460,64734,1084726,1149460,65059
2020/04/11,Barcelona,Alicante,17,1858683,134425,1724258,5664579,444023
2020/04/11,Barcelona,Tarragona,430,804664,48818,755846,5664579,444023
2020/04/11,Barcelona,Barcelona,318681,5664579,443781,5220798,5664579,444023
2020/04/11,Barcelona,Lleida,46,434930,29978,404952,5664579,444023
2020/04/11,Barcelona,Girona,1205,771044,40006,731038,5664579,444023
2020/04/11,Barcelona,Málaga,16,1661785,103056,1558729,5664579,444023
2020/04/11,Bizkaia,Gipuzkoa,309,723576,44152,679424,1152934,105580
2020/04/11,Bizkaia,Araba,322,331549,25576,305973,1152934,105580
2020/04/11,Bizkaia,Bizkaia,84518,1152934,106291,1046643,1152934,105580
2020/04/11,Bizkaia,Cantabria,460,580795,42431,538364,1152934,105580
2020/04/11,Burgos,Bizkaia,24,1152934,106291,1046643,357072,18496
2020/04/11,Burgos,Burgos,14172,357072,18533,338539,357072,18496
2020/04/11,Burgos,Palencia,157,160866,10569,150297,357072,18496
2020/04/11,Burgos,Cáceres,21,394151,20387,373764,357072,18496
2020/04/11,Burgos,Araba,415,331549,25576,305973,357072,18496
2020/04/11,Burgos,Valladolid,30,519546,36816,482730,357072,18496
2020/04/11,Cáceres,Ávila,71,157640,8444,149196,394151,20422
2020/04/11,Cáceres,Cáceres,13786,394151,20387,373764,394151,20422
2020/04/11,Cáceres,Badajoz,676,673559,44289,629270,394151,20422
2020/04/11,Cáceres,Toledo,66,694844,36347,658497,394151,20422
2020/04/11,Cádiz,Ceuta,40,84777,5478,79299,1240155,92634
2020/04/11,Cádiz,Málaga,500,1661785,103056,1558729,1240155,92634
2020/04/11,Cádiz,Huelva,729,521870,40714,481156,1240155,92634
2020/04/11,Cádiz,Cádiz,78771,1240155,92762,1147393,1240155,92634
2020/04/11,Cádiz,Sevilla,682,1942389,145778,1796611,1240155,92634
2020/04/11,Cantabria,Palencia,25,160866,10569,150297,580795,41523
2020/04/11,Cantabria,Bizkaia,323,1152934,106291,1046643,580795,41523
2020/04/11,Cantabria,Asturias,104,1022800,66391,956409,580795,41523
2020/04/11,Cantabria,Cantabria,31717,580795,42431,538364,580795,41523
2020/04/11,Castellón,Castellón,27309,579962,37034,542928,579962,37785
2020/04/11,Castellón,Valencia,543,2565124,203236,2361888,579962,37785
2020/04/11,Castellón,Teruel,61,134137,3622,130515,579962,37785
2020/04/11,Castellón,Tarragona,716,804664,48818,755846,579962,37785
2020/04/11,Ceuta,Ceuta,5198,84777,5478,79299,84777,5507
2020/04/11,Ceuta,Cádiz,54,1240155,92762,1147393,84777,5507
2020/04/11,Ciudad Real,Albacete,417,388167,24606,363561,495761,20311
2020/04/11,Ciudad Real,Jaén,69,633564,36383,597181,495761,20311
2020/04/11,Ciudad Real,Ciudad Real,13600,495761,20096,475665,495761,20311
2020/04/11,Ciudad Real,Córdoba,427,782979,61669,721310,495761,20311
2020/04/11,Ciudad Real,Badajoz,35,673559,44289,629270,495761,20311
2020/04/11,Córdoba,Córdoba,46359,782979,61669,721310,782979,60999
2020/04/11,Córdoba,Badajoz,43,673559,44289,629270,782979,60999
2020/04/11,Córdoba,Jaén,579,633564,36383,597181,782979,60999
2020/04/11,Córdoba,Ciudad Real,224,495761,20096,475665,782979,60999
2020/04/11,Córdoba,Málaga,216,1661785,103056,1558729,782979,60999
2020/04/11,Córdoba,Sevilla,1179,1942389,145778,1796611,782979,60999
2020/04/11,Córdoba,Granada,127,914678,70402,844276,782979,60999
2020/04/11,Coruña,Lugo,258,329587,20575,309012,1119596,84940
2020/04/11,Coruña,Coruña,66406,1119596,84349,1035247,1119596,84940
2020/04/11,Coruña,Pontevedra,3205,942665,73632,869033,1119596,84940
2020/04/11,Cuenca,Valencia,45,2565124,203236,2361888,196329,7833
2020/04/11,Cuenca,Cuenca,4343,196329,7702,188627,196329,7833
2020/04/11,Cuenca,Toledo,44,694844,36347,658497,196329,7833
2020/04/11,Cuenca,Ciudad Real,42,495761,20096,475665,196329,7833
2020/04/11,Cuenca,Albacete,349,388167,24606,363561,196329,7833
2020/04/11,Gipuzkoa,Cádiz,16,1240155,92762,1147393,723576,45071
2020/04/11,Gipuzkoa,Araba,27,331549,25576,305973,723576,45071
2020/04/11,Gipuzkoa,Gipuzkoa,34272,723576,44152,679424,723576,45071
2020/04/11,Gipuzkoa,Bizkaia,498,1152934,106291,1046643,723576,45071
2020/04/11,Gipuzkoa,Navarra,75,654183,44266,609917,723576,45071
2020/04/11,Gipuzkoa,Jaén,18,633564,36383,597181,723576,45071
2020/04/11,Girona,Girona,27514,771044,40006,731038,771044,40466
2020/04/11,Girona,Lleida,67,434930,29978,404952,771044,40466
2020/04/11,Girona,Barcelona,1171,5664579,443781,5220798,771044,40466
2020/04/11,Granada,Murcia,22,1493898,111189,1382709,914678,70614
2020/04/11,Granada,Granada,51719,914678,70402,844276,914678,70614
2020/04/11,Granada,Málaga,170,1661785,103056,1558729,914678,70614
2020/04/11,Granada,Jaén,335,633564,36383,597181,914678,70614
2020/04/11,Granada,Córdoba,304,782979,61669,721310,914678,70614
2020/04/11,Granada,Almería,302,716820,44784,672036,914678,70614
2020/04/11,Guadalajara,Madrid,673,6663394,465897,6197497,257762,14449
2020/04/11,Guadalajara,Teruel,25,134137,3622,130515,257762,14449
2020/04/11,Guadalajara,Guadalajara,9456,257762,14713,243049,257762,14449
2020/04/11,Huelva,Cádiz,761,1240155,92762,1147393,521870,40973
2020/04/11,Huelva,Badajoz,244,673559,44289,629270,521870,40973
2020/04/11,Huelva,Sevilla,785,1942389,145778,1796611,521870,40973
2020/04/11,Huelva,Huelva,31575,521870,40714,481156,521870,40973
2020/04/11,Huesca,Huesca,8021,220461,11526,208935,220461,12082
2020/04/11,Huesca,Zaragoza,157,964724,68780,895944,220461,12082
2020/04/11,Huesca,Lleida,351,434930,29978,404952,220461,12082
2020/04/11,Jaén,Jaén,26393,633564,36383,597181,633564,35902
2020/04/11,Jaén,Albacete,17,388167,24606,363561,633564,35902
2020/04/11,Jaén,Granada,345,914678,70402,844276,633564,35902
2020/04/11,Jaén,Córdoba,555,782979,61669,721310,633564,35902
2020/04/11,Las Palmas de Gran Canaria,Las Palmas de Gran Canaria,61979,1120406,72955,1047451,1120406,72561
2020/04/11,León,Ourense,38,307651,25985,281666,460001,33547
2020/04/11,León,León,25461,460001,33821,426180,460001,33547
2020/04/11,León,Asturias,40,1022800,66391,956409,460001,33547
2020/04/11,Lleida,Huesca,172,220461,11526,208935,434930,29553
2020/04/11,Lleida,Lleida,20527,434930,29978,404952,434930,29553
2020/04/11,Lleida,Girona,75,771044,40006,731038,434930,29553
2020/04/11,Lleida,Barcelona,89,5664579,443781,5220798,434930,29553
2020/04/11,Lleida,Zaragoza,72,964724,68780,895944,434930,29553
2020/04/11,Lugo,Asturias,396,1022800,66391,956409,329587,21008
2020/04/11,Lugo,Ourense,104,307651,25985,281666,329587,21008
2020/04/11,Lugo,Lugo,14989,329587,20575,309012,329587,21008
2020/04/11,Lugo,Coruña,286,1119596,84349,1035247,329587,21008
2020/04/11,Madrid,Alicante,17,1858683,134425,1724258,6663394,467909
2020/04/11,Madrid,Toledo,1636,694844,36347,658497,6663394,467909
2020/04/11,Madrid,Madrid,320830,6663394,465897,6197497,6663394,467909
2020/04/11,Madrid,Cuenca,46,196329,7702,188627,6663394,467909
2020/04/11,Madrid,Guadalajara,728,257762,14713,243049,6663394,467909
2020/04/11,Madrid,Valencia,51,2565124,203236,2361888,6663394,467909
2020/04/11,Málaga,Granada,132,914678,70402,844276,1661785,103338
2020/04/11,Málaga,Málaga,82792,1661785,103056,1558729,1661785,103338
2020/04/11,Málaga,Córdoba,159,782979,61669,721310,1661785,103338
2020/04/11,Málaga,Cádiz,427,1240155,92762,1147393,1661785,103338
2020/04/11,Málaga,Almería,23,716820,44784,672036,1661785,103338
2020/04/11,Málaga,Sevilla,231,1942389,145778,1796611,1661785,103338
2020/04/11,Málaga,Melilla,67,86487,7528,78959,1661785,103338
2020/04/11,Melilla,Melilla,7330,86487,7528,78959,86487,7477
2020/04/11,Murcia,Alicante,1818,1858683,134425,1724258,1493898,110977
2020/04/11,Murcia,Murcia,87190,1493898,111189,1382709,1493898,110977
2020/04/11,Murcia,Almería,1068,716820,44784,672036,1493898,110977
2020/04/11,Murcia,Albacete,176,388167,24606,363561,1493898,110977
2020/04/11,Murcia,Sevilla,22,1942389,145778,1796611,1493898,110977
2020/04/11,Murcia,Cuenca,17,196329,7702,188627,1493898,110977
2020/04/11,Navarra,Jaén,21,633564,36383,597181,654183,43696
2020/04/11,Navarra,Zaragoza,212,964724,68780,895944,654183,43696
2020/04/11,Navarra,Navarra,31444,654183,44266,609917,654183,43696
2020/04/11,Navarra,Rioja,721,316798,18598,298200,654183,43696
2020/04/11,Navarra,Gipuzkoa,97,723576,44152,679424,654183,43696
2020/04/11,Ourense,Ourense,21310,307651,25985,281666,307651,26214
2020/04/11,Ourense,León,99,460001,33821,426180,307651,26214
2020/04/11,Ourense,Pontevedra,140,942665,73632,869033,307651,26214
2020/04/11,Ourense,Lugo,89,329587,20575,309012,307651,26214
2020/04/11,Palencia,Palencia,7781,160866,10569,150297,160866,10770
2020/04/11,Palencia,Burgos,137,357072,18533,338539,160866,10770
2020/04/11,Palencia,Cantabria,36,580795,42431,538364,160866,10770
2020/04/11,Pontevedra,Coruña,2793,1119596,84349,1035247,942665,72907
2020/04/11,Pontevedra,Ourense,147,307651,25985,281666,942665,72907
2020/04/11,Pontevedra,Pontevedra,57798,942665,73632,869033,942665,72907
2020/04/11,Pontevedra,Lugo,27,329587,20575,309012,942665,72907
2020/04/11,Rioja,Navarra,990,654183,44266,609917,316798,18475
2020/04/11,Rioja,Araba,203,331549,25576,305973,316798,18475
2020/04/11,Rioja,Rioja,13821,316798,18598,298200,316798,18475
2020/04/11,Salamanca,Salamanca,19846,330119,25041,305078,330119,24858
2020/04/11,Salamanca,Ávila,95,157640,8444,149196,330119,24858
2020/04/11,Salamanca,Cáceres,21,394151,20387,373764,330119,24858
2020/04/11,Santa Cruz de Tenerife,Santa Cruz de Tenerife,61761,1032983,71575,961408,1032983,71409
2020/04/11,Segovia,Segovia,6491,153129,9298,143831,153129,9577
2020/04/11,Segovia,Ávila,82,157640,8444,149196,153129,9577
2020/04/11,Segovia,Valladolid,127,519546,36816,482730,153129,9577
2020/04/11,Sevilla,Málaga,93,1661785,103056,1558729,1942389,144622
2020/04/11,Sevilla,Cádiz,676,1240155,92762,1147393,1942389,144622
2020/04/11,Sevilla,Sevilla,104921,1942389,145778,1796611,1942389,144622
2020/04/11,Sevilla,Huelva,304,521870,40714,481156,1942389,144622
2020/04/11,Sevilla,Córdoba,1308,782979,61669,721310,1942389,144622
2020/04/11,Soria,Soria,2361,88636,3215,85421,88636,3237
2020/04/11,Soria,Valladolid,36,519546,36816,482730,88636,3237
2020/04/11,Tarragona,Tarragona,33672,804664,48818,755846,804664,47974
2020/04/11,Tarragona,Lleida,25,434930,29978,404952,804664,47974
2020/04/11,Tarragona,Teruel,110,134137,3622,130515,804664,47974
2020/04/11,Tarragona,Castellón,361,579962,37034,542928,804664,47974
2020/04/11,Tarragona,Barcelona,404,5664579,443781,5220798,804664,47974
2020/04/11,Tarragona,Albacete,17,388167,24606,363561,804664,47974
2020/04/11,Tarragona,Zaragoza,38,964724,68780,895944,804664,47974
2020/04/11,Teruel,Teruel,1873,134137,3622,130515,134137,3542
2020/04/11,Teruel,Castellón,31,579962,37034,542928,134137,3542
2020/04/11,Teruel,Tarragona,18,804664,48818,755846,134137,3542
2020/04/11,Toledo,Ciudad Real,93,495761,20096,475665,694844,35882
2020/04/11,Toledo,Toledo,20658,694844,36347,658497,694844,35882
2020/04/11,Toledo,Ávila,115,157640,8444,149196,694844,35882
2020/04/11,Toledo,Madrid,1569,6663394,465897,6197497,694844,35882
2020/04/11,Toledo,Albacete,22,388167,24606,363561,694844,35882
2020/04/11,Toledo,Cáceres,118,394151,20387,373764,694844,35882
2020/04/11,Valencia,Alicante,489,1858683,134425,1724258,2565124,200995
2020/04/11,Valencia,Albacete,228,388167,24606,363561,2565124,200995
2020/04/11,Valencia,Cuenca,65,196329,7702,188627,2565124,200995
2020/04/11,Valencia,Castellón,351,579962,37034,542928,2565124,200995
2020/04/11,Valencia,Valencia,140860,2565124,203236,2361888,2565124,200995
2020/04/11,Valladolid,Valladolid,26716,519546,36816,482730,519546,36514
2020/04/11,Valladolid,Burgos,84,357072,18533,338539,519546,36514
2020/04/11,Valladolid,Zamora,82,172539,10896,161643,519546,36514
2020/04/11,Valladolid,Soria,25,88636,3215,85421,519546,36514
2020/04/11,Valladolid,Segovia,107,153129,9298,143831,519546,36514
2020/04/11,Zamora,Valladolid,51,519546,36816,482730,172539,11139
2020/04/11,Zamora,Zamora,8258,172539,10896,161643,172539,11139
2020/04/11,Zamora,Salamanca,19,330119,25041,305078,172539,11139
2020/04/11,Zaragoza,Teruel,16,134137,3622,130515,964724,68342
2020/04/11,Zaragoza,Navarra,250,654183,44266,609917,964724,68342
2020/04/11,Zaragoza,Huesca,78,220461,11526,208935,964724,68342
2020/04/11,Zaragoza,Lleida,59,434930,29978,404952,964724,68342
2020/04/11,Zaragoza,Zaragoza,51494,964724,68780,895944,964724,68342
2020/04/12,Albacete,Murcia,110,1493898,83089,1410809,388167,19333
2020/04/12,Albacete,Alicante,76,1858683,106716,1751967,388167,19333
2020/04/12,Albacete,Valencia,196,2565124,162843,2402281,388167,19333
2020/04/12,Albacete,Albacete,15106,388167,19507,368660,388167,19333
2020/04/12,Albacete,Jaén,83,633564,31908,601656,388167,19333
2020/04/12,Albacete,Cuenca,145,196329,6167,190162,388167,19333
2020/04/12,Albacete,Ciudad Real,233,495761,16746,479015,388167,19333
2020/04/12,Alicante,Cáceres,18,394151,17420,376731,1858683,107280
2020/04/12,Alicante,Albacete,145,388167,19507,368660,1858683,107280
2020/04/12,Alicante,Murcia,1399,1493898,83089,1410809,1858683,107280
2020/04/12,Alicante,Alicante,88553,1858683,106716,1751967,1858683,107280
2020/04/12,Alicante,Valencia,536,2565124,162843,2402281,1858683,107280
2020/04/12,Almería,Almería,22260,716820,30005,686815,716820,29410
2020/04/12,Almería,Murcia,520,1493898,83089,1410809,716820,29410
2020/04/12,Almería,Melilla,17,86487,6121,80366,716820,29410
2020/04/12,Almería,Granada,265,914678,57169,857509,716820,29410
2020/04/12,Araba,Burgos,505,357072,14868,342204,331549,21722
2020/04/12,Araba,Bizkaia,260,1152934,90525,1062409,331549,21722
2020/04/12,Araba,Rioja,146,316798,15007,301791,331549,21722
2020/04/12,Araba,Araba,17996,331549,21231,310318,331549,21722
2020/04/12,Asturias,Lugo,378,329587,17193,312394,1022800,54291
2020/04/12,Asturias,León,39,460001,27676,432325,1022800,54291
2020/04/12,Asturias,Cantabria,121,580795,34482,546313,1022800,54291
2020/04/12,Asturias,Asturias,42866,1022800,53944,968856,1022800,54291
2020/04/12,Ávila,Ávila,5233,157640,7431,150209,157640,7617
2020/04/12,Ávila,Madrid,117,6663394,403272,6260122,157640,7617
2020/04/12,Ávila,Cáceres,93,394151,17420,376731,157640,7617
2020/04/12,Ávila,Segovia,84,153129,7592,145537,157640,7617
2020/04/12,Ávila,Toledo,97,694844,28814,666030,157640,7617
2020/04/12,Ávila,Salamanca,205,330119,20893,309226,157640,7617
2020/04/12,Badajoz,Córdoba,19,782979,53050,729929,673559,36035
2020/04/12,Badajoz,Sevilla,97,1942389,118726,1823663,673559,36035
2020/04/12,Badajoz,Huelva,148,521870,33654,488216,673559,36035
2020/04/12,Badajoz,Ciudad Real,60,495761,16746,479015,673559,36035
2020/04/12,Badajoz,Badajoz,27644,673559,36241,637318,673559,36035
2020/04/12,Badajoz,Cáceres,570,394151,17420,376731,673559,36035
2020/04/12,Balears,Albacete,16,388167,19507,368660,1149460,49553
2020/04/12,Balears,Balears,40223,1149460,49488,1099972,1149460,49553
2020/04/12,Barcelona,Alicante,18,1858683,106716,1751967,5664579,376096
2020/04/12,Barcelona,Girona,1180,771044,34244,736800,5664579,376096
2020/04/12,Barcelona,Barcelona,277961,5664579,374724,5289855,5664579,376096
2020/04/12,Barcelona,Lleida,27,434930,23784,411146,5664579,376096
2020/04/12,Barcelona,Granada,16,914678,57169,857509,5664579,376096
2020/04/12,Barcelona,Tarragona,356,804664,41367,763297,5664579,376096
2020/04/12,Bizkaia,Cantabria,331,580795,34482,546313,1152934,90206
2020/04/12,Bizkaia,Gipuzkoa,217,723576,34717,688859,1152934,90206
2020/04/12,Bizkaia,Bizkaia,73729,1152934,90525,1062409,1152934,90206
2020/04/12,Bizkaia,Araba,188,331549,21231,310318,1152934,90206
2020/04/12,Burgos,Araba,395,331549,21231,310318,357072,15181
2020/04/12,Burgos,Palencia,148,160866,8981,151885,357072,15181
2020/04/12,Burgos,Valladolid,38,519546,31124,488422,357072,15181
2020/04/12,Burgos,Burgos,11278,357072,14868,342204,357072,15181
2020/04/12,Cáceres,Ávila,67,157640,7431,150209,394151,17132
2020/04/12,Cáceres,Toledo,68,694844,28814,666030,394151,17132
2020/04/12,Cáceres,Badajoz,588,673559,36241,637318,394151,17132
2020/04/12,Cáceres,Cáceres,11612,394151,17420,376731,394151,17132
2020/04/12,Cádiz,Huelva,575,521870,33654,488216,1240155,76344
2020/04/12,Cádiz,Cádiz,64782,1240155,76347,1163808,1240155,76344
2020/04/12,Cádiz,Sevilla,548,1942389,118726,1823663,1240155,76344
2020/04/12,Cádiz,Málaga,445,1661785,81340,1580445,1240155,76344
2020/04/12,Cantabria,Asturias,68,1022800,53944,968856,580795,34172
2020/04/12,Cantabria,Bizkaia,306,1152934,90525,1062409,580795,34172
2020/04/12,Cantabria,Cantabria,26383,580795,34482,546313,580795,34172
2020/04/12,Castellón,Castellón,21870,579962,29390,550572,579962,29780
2020/04/12,Castellón,Tarragona,579,804664,41367,763297,579962,29780
2020/04/12,Castellón,Valencia,458,2565124,162843,2402281,579962,29780
2020/04/12,Castellón,Teruel,38,134137,2989,131148,579962,29780
2020/04/12,Ceuta,Ceuta,3861,84777,4126,80651,84777,4210
2020/04/12,Ceuta,Cádiz,51,1240155,76347,1163808,84777,4210
2020/04/12,Ciudad Real,Ciudad Real,11214,495761,16746,479015,495761,17075
2020/04/12,Ciudad Real,Badajoz,43,673559,36241,637318,495761,17075
2020/04/12,Ciudad Real,Toledo,17,694844,28814,666030,495761,17075
2020/04/12,Ciudad Real,Jaén,18,633564,31908,601656,495761,17075
2020/04/12,Ciudad Real,Córdoba,421,782979,53050,729929,495761,17075
2020/04/12,Ciudad Real,Albacete,309,388167,19507,368660,495761,17075
2020/04/12,Córdoba,Jaén,672,633564,31908,601656,782979,52386
2020/04/12,Córdoba,Málaga,89,1661785,81340,1580445,782979,52386
2020/04/12,Córdoba,Ciudad Real,214,495761,16746,479015,782979,52386
2020/04/12,Córdoba,Sevilla,907,1942389,118726,1823663,782979,52386
2020/04/12,Córdoba,Córdoba,40314,782979,53050,729929,782979,52386
2020/04/12,Córdoba,Granada,129,914678,57169,857509,782979,52386
2020/04/12,Coruña,Pontevedra,2424,942665,60784,881881,1119596,68709
2020/04/12,Coruña,Coruña,54315,1119596,68688,1050908,1119596,68709
2020/04/12,Coruña,Lugo,248,329587,17193,312394,1119596,68709
2020/04/12,Cuenca,Albacete,305,388167,19507,368660,196329,6339
2020/04/12,Cuenca,Valencia,44,2565124,162843,2402281,196329,6339
2020/04/12,Cuenca,Madrid,23,6663394,403272,6260122,196329,6339
2020/04/12,Cuenca,Cuenca,3404,196329,6167,190162,196329,6339
2020/04/12,Cuenca,Ciudad Real,35,495761,16746,479015,196329,6339
2020/04/12,Gipuzkoa,Navarra,74,654183,34838,619345,723576,35986
2020/04/12,Gipuzkoa,Bizkaia,245,1152934,90525,1062409,723576,35986
2020/04/12,Gipuzkoa,Araba,116,331549,21231,310318,723576,35986
2020/04/12,Gipuzkoa,Gipuzkoa,27155,723576,34717,688859,723576,35986
2020/04/12,Girona,Lleida,61,434930,23784,411146,771044,35032
2020/04/12,Girona,Barcelona,995,5664579,374724,5289855,771044,35032
2020/04/12,Girona,Girona,23896,771044,34244,736800,771044,35032
2020/04/12,Girona,Jaén,20,633564,31908,601656,771044,35032
2020/04/12,Granada,Córdoba,320,782979,53050,729929,914678,56742
2020/04/12,Granada,Málaga,77,1661785,81340,1580445,914678,56742
2020/04/12,Granada,Jaén,281,633564,31908,601656,914678,56742
2020/04/12,Granada,Granada,42112,914678,57169,857509,914678,56742
2020/04/12,Granada,Almería,175,716820,30005,686815,914678,56742
2020/04/12,Guadalajara,Guadalajara,8666,257762,13149,244613,257762,12960
2020/04/12,Guadalajara,Cuenca,23,196329,6167,190162,257762,12960
2020/04/12,Guadalajara,Madrid,676,6663394,403272,6260122,257762,12960
2020/04/12,Huelva,Cádiz,710,1240155,76347,1163808,521870,33283
2020/04/12,Huelva,Sevilla,318,1942389,118726,1823663,521870,33283
2020/04/12,Huelva,Badajoz,236,673559,36241,637318,521870,33283
2020/04/12,Huelva,Huelva,25597,521870,33654,488216,521870,33283
2020/04/12,Huesca,Huesca,6272,220461,9597,210864,220461,9707
2020/04/12,Huesca,Zaragoza,33,964724,56267,908457,220461,9707
2020/04/12,Huesca,Lleida,224,434930,23784,411146,220461,9707
2020/04/12,Jaén,Ciudad Real,16,495761,16746,479015,633564,31310
2020/04/12,Jaén,Granada,316,914678,57169,857509,633564,31310
2020/04/12,Jaén,Albacete,17,388167,19507,368660,633564,31310
2020/04/12,Jaén,Jaén,23410,633564,31908,601656,633564,31310
2020/04/12,Jaén,Córdoba,635,782979,53050,729929,633564,31310
2020/04/12,Las Palmas de Gran Canaria,Las Palmas de Gran Canaria,47044,1120406,57298,1063108,1120406,57151
2020/04/12,León,Asturias,31,1022800,53944,968856,460001,27464
2020/04/12,León,Zamora,39,172539,8330,164209,460001,27464
2020/04/12,León,León,21200,460001,27676,432325,460001,27464
2020/04/12,León,Valladolid,28,519546,31124,488422,460001,27464
2020/04/12,León,Ourense,64,307651,20745,286906,460001,27464
2020/04/12,León,Palencia,16,160866,8981,151885,460001,27464
2020/04/12,Lleida,Barcelona,37,5664579,374724,5289855,434930,23618
2020/04/12,Lleida,Huesca,195,220461,9597,210864,434930,23618
2020/04/12,Lleida,Zaragoza,34,964724,56267,908457,434930,23618
2020/04/12,Lleida,Girona,61,771044,34244,736800,434930,23618
2020/04/12,Lleida,Lleida,16064,434930,23784,411146,434930,23618
2020/04/12,Lugo,Ourense,40,307651,20745,286906,329587,17100
2020/04/12,Lugo,León,16,460001,27676,432325,329587,17100
2020/04/12,Lugo,Asturias,397,1022800,53944,968856,329587,17100
2020/04/12,Lugo,Lugo,12561,329587,17193,312394,329587,17100
2020/04/12,Lugo,Coruña,197,1119596,68688,1050908,329587,17100
2020/04/12,Madrid,Alicante,17,1858683,106716,1751967,6663394,405902
2020/04/12,Madrid,Madrid,289309,6663394,403272,6260122,6663394,405902
2020/04/12,Madrid,Huelva,22,521870,33654,488216,6663394,405902
2020/04/12,Madrid,Cuenca,49,196329,6167,190162,6663394,405902
2020/04/12,Madrid,Guadalajara,634,257762,13149,244613,6663394,405902
2020/04/12,Madrid,Ávila,116,157640,7431,150209,6663394,405902
2020/04/12,Madrid,Toledo,1255,694844,28814,666030,6663394,405902
2020/04/12,Málaga,Granada,57,914678,57169,857509,1661785,81376
2020/04/12,Málaga,Cádiz,408,1240155,76347,1163808,1661785,81376
2020/04/12,Málaga,Málaga,65303,1661785,81340,1580445,1661785,81376
2020/04/12,Málaga,Córdoba,170,782979,53050,729929,1661785,81376
2020/04/12,Málaga,Sevilla,96,1942389,118726,1823663,1661785,81376
2020/04/12,Melilla,Melilla,5972,86487,6121,80366,86487,5996
2020/04/12,Murcia,Albacete,101,388167,19507,368660,1493898,82755
2020/04/12,Murcia,Granada,53,914678,57169,857509,1493898,82755
2020/04/12,Murcia,Almería,603,716820,30005,686815,1493898,82755
2020/04/12,Murcia,Murcia,66761,1493898,83089,1410809,1493898,82755
2020/04/12,Murcia,Alicante,1121,1858683,106716,1751967,1493898,82755
2020/04/12,Navarra,Gipuzkoa,99,723576,34717,688859,654183,35026
2020/04/12,Navarra,Navarra,25329,654183,34838,619345,654183,35026
2020/04/12,Navarra,Alicante,41,1858683,106716,1751967,654183,35026
2020/04/12,Navarra,Zaragoza,180,964724,56267,908457,654183,35026
2020/04/12,Navarra,Rioja,400,316798,15007,301791,654183,35026
2020/04/12,Ourense,León,82,460001,27676,432325,307651,20665
2020/04/12,Ourense,Ourense,16621,307651,20745,286906,307651,20665
2020/04/12,Ourense,Lugo,44,329587,17193,312394,307651,20665
2020/04/12,Ourense,Pontevedra,95,942665,60784,881881,307651,20665
2020/04/12,Palencia,Burgos,123,357072,14868,342204,160866,9109
2020/04/12,Palencia,Palencia,6741,160866,8981,151885,160866,9109
2020/04/12,Palencia,Cantabria,31,580795,34482,546313,160866,9109
2020/04/12,Pontevedra,Albacete,17,388167,19507,368660,942665,60702
2020/04/12,Pontevedra,Ourense,112,307651,20745,286906,942665,60702
2020/04/12,Pontevedra,Pontevedra,48576,942665,60784,881881,942665,60702
2020/04/12,Pontevedra,Coruña,2389,1119596,68688,1050908,942665,60702
2020/04/12,Rioja,Navarra,624,654183,34838,619345,316798,15047
2020/04/12,Rioja,Rioja,11145,316798,15007,301791,316798,15047
2020/04/12,Rioja,Araba,175,331549,21231,310318,316798,15047
2020/04/12,Salamanca,Cáceres,17,394151,17420,376731,330119,20679
2020/04/12,Salamanca,Ávila,100,157640,7431,150209,330119,20679
2020/04/12,Salamanca,Salamanca,16525,330119,20893,309226,330119,20679
2020/04/12,Santa Cruz de Tenerife,Santa Cruz de Tenerife,45652,1032983,53965,979018,1032983,53742
2020/04/12,Segovia,Segovia,5263,153129,7592,145537,153129,7672
2020/04/12,Segovia,Valladolid,62,519546,31124,488422,153129,7672
2020/04/12,Segovia,Ávila,63,157640,7431,150209,153129,7672
2020/04/12,Sevilla,Cádiz,504,1240155,76347,1163808,1942389,117809
2020/04/12,Sevilla,Sevilla,88202,1942389,118726,1823663,1942389,117809
2020/04/12,Sevilla,Málaga,52,1661785,81340,1580445,1942389,117809
2020/04/12,Sevilla,Córdoba,1107,782979,53050,729929,1942389,117809
2020/04/12,Sevilla,Huelva,191,521870,33654,488216,1942389,117809
2020/04/12,Soria,Valladolid,32,519546,31124,488422,88636,2678
2020/04/12,Soria,Soria,1967,88636,2683,85953,88636,2678
2020/04/12,Tarragona,Alicante,26,1858683,106716,1751967,804664,40937
2020/04/12,Tarragona,Castellón,357,579962,29390,550572,804664,40937
2020/04/12,Tarragona,Barcelona,395,5664579,374724,5289855,804664,40937
2020/04/12,Tarragona,Tarragona,28786,804664,41367,763297,804664,40937
2020/04/12,Teruel,Teruel,1630,134137,2989,131148,134137,3127
2020/04/12,Teruel,Tarragona,140,804664,41367,763297,134137,3127
2020/04/12,Teruel,Castellón,25,579962,29390,550572,134137,3127
2020/04/12,Toledo,Toledo,16088,694844,28814,666030,694844,28552
2020/04/12,Toledo,Madrid,1241,6663394,403272,6260122,694844,28552
2020/04/12,Toledo,Cáceres,161,394151,17420,376731,694844,28552
2020/04/12,Toledo,Ávila,132,157640,7431,150209,694844,28552
2020/04/12,Valencia,Albacete,178,388167,19507,368660,2565124,161006
2020/04/12,Valencia,Cuenca,48,196329,6167,190162,2565124,161006
2020/04/12,Valencia,Castellón,284,579962,29390,550572,2565124,161006
2020/04/12,Valencia,Sevilla,22,1942389,118726,1823663,2565124,161006
2020/04/12,Valencia,Valencia,119067,2565124,162843,2402281,2565124,161006
2020/04/12,Valencia,Alicante,313,1858683,106716,1751967,2565124,161006
2020/04/12,Valladolid,Burgos,76,357072,14868,342204,519546,31004
2020/04/12,Valladolid,Zamora,34,172539,8330,164209,519546,31004
2020/04/12,Valladolid,Huelva,18,521870,33654,488216,519546,31004
2020/04/12,Valladolid,Segovia,42,153129,7592,145537,519546,31004
2020/04/12,Valladolid,Soria,25,88636,2683,85953,519546,31004
2020/04/12,Valladolid,Valladolid,22992,519546,31124,488422,519546,31004
2020/04/12,Valladolid,Ávila,16,157640,7431,150209,519546,31004
2020/04/12,Zamora,Ourense,16,307651,20745,286906,172539,8492
2020/04/12,Zamora,Zamora,6173,172539,8330,164209,172539,8492
2020/04/12,Zamora,Salamanca,26,330119,20893,309226,172539,8492
2020/04/12,Zaragoza,Navarra,184,654183,34838,619345,964724,55774
2020/04/12,Zaragoza,Zaragoza,42315,964724,56267,908457,964724,55774
2020/04/12,Zaragoza,Huesca,63,220461,9597,210864,964724,55774
2020/04/12,Zaragoza,Tarragona,17,804664,41367,763297,964724,55774
2020/04/12,Zaragoza,Lleida,74,434930,23784,411146,964724,55774
2020/04/13,Albacete,Albacete,16320,388167,23440,364727,388167,22947
2020/04/13,Albacete,Jaén,18,633564,48887,584677,388167,22947
2020/04/13,Albacete,Alicante,74,1858683,125185,1733498,388167,22947
2020/04/13,Albacete,Cuenca,332,196329,8930,187399,388167,22947
2020/04/13,Albacete,Valencia,218,2565124,183312,2381812,388167,22947
2020/04/13,Albacete,Almería,16,716820,63678,653142,388167,22947
2020/04/13,Albacete,Ciudad Real,319,495761,22475,473286,388167,22947
2020/04/13,Albacete,Murcia,243,1493898,163048,1330850,388167,22947
2020/04/13,Alicante,Valencia,470,2565124,183312,2381812,1858683,125039
2020/04/13,Alicante,Albacete,204,388167,23440,364727,1858683,125039
2020/04/13,Alicante,Alicante,96661,1858683,125185,1733498,1858683,125039
2020/04/13,Alicante,Murcia,2564,1493898,163048,1330850,1858683,125039
2020/04/13,Almería,Jaén,18,633564,48887,584677,716820,65688
2020/04/13,Almería,Murcia,1821,1493898,163048,1330850,716820,65688
2020/04/13,Almería,Alicante,16,1858683,125185,1733498,716820,65688
2020/04/13,Almería,Almería,51593,716820,63678,653142,716820,65688
2020/04/13,Almería,Granada,316,914678,90174,824504,716820,65688
2020/04/13,Araba,Huelva,18,521870,55683,466187,331549,24792
2020/04/13,Araba,Araba,19241,331549,23395,308154,331549,24792
2020/04/13,Araba,Rioja,437,316798,19628,297170,331549,24792
2020/04/13,Araba,Burgos,769,357072,29916,327156,331549,24792
2020/04/13,Araba,Bizkaia,248,1152934,97143,1055791,331549,24792
2020/04/13,Asturias,León,55,460001,50150,409851,1022800,97624
2020/04/13,Asturias,Lugo,784,329587,32595,296992,1022800,97624
2020/04/13,Asturias,Cantabria,122,580795,39730,541065,1022800,97624
2020/04/13,Asturias,Asturias,74386,1022800,98056,924744,1022800,97624
2020/04/13,Ávila,Cáceres,90,394151,29793,364358,157640,12963
2020/04/13,Ávila,Toledo,106,694844,45636,649208,157640,12963
2020/04/13,Ávila,Ávila,8078,157640,12183,145457,157640,12963
2020/04/13,Ávila,Segovia,87,153129,14175,138954,157640,12963
2020/04/13,Ávila,Madrid,68,6663394,671687,5991707,157640,12963
2020/04/13,Ávila,Salamanca,225,330119,36586,293533,157640,12963
2020/04/13,Badajoz,Badajoz,44872,673559,62271,611288,673559,61367
2020/04/13,Badajoz,Sevilla,36,1942389,206174,1736215,673559,61367
2020/04/13,Badajoz,Cáceres,663,394151,29793,364358,673559,61367
2020/04/13,Badajoz,Ciudad Real,35,495761,22475,473286,673559,61367
2020/04/13,Badajoz,Huelva,244,521870,55683,466187,673559,61367
2020/04/13,Badajoz,Córdoba,39,782979,83012,699967,673559,61367
2020/04/13,Balears,Alicante,16,1858683,125185,1733498,1149460,53688
2020/04/13,Balears,Balears,43382,1149460,53504,1095956,1149460,53688
2020/04/13,Barcelona,Lleida,35,434930,24497,410433,5664579,386005
2020/04/13,Barcelona,Girona,1085,771044,33689,737355,5664579,386005
2020/04/13,Barcelona,Barcelona,275704,5664579,385824,5278755,5664579,386005
2020/04/13,Barcelona,Tarragona,311,804664,40968,763696,5664579,386005
2020/04/13,Barcelona,Alicante,16,1858683,125185,1733498,5664579,386005
2020/04/13,Bizkaia,Gipuzkoa,358,723576,39687,683889,1152934,96555
2020/04/13,Bizkaia,Cantabria,426,580795,39730,541065,1152934,96555
2020/04/13,Bizkaia,Araba,231,331549,23395,308154,1152934,96555
2020/04/13,Bizkaia,Alicante,21,1858683,125185,1733498,1152934,96555
2020/04/13,Bizkaia,Bizkaia,76278,1152934,97143,1055791,1152934,96555
2020/04/13,Burgos,Bizkaia,31,1152934,97143,1055791,357072,31404
2020/04/13,Burgos,Burgos,22607,357072,29916,327156,357072,31404
2020/04/13,Burgos,Palencia,544,160866,15787,145079,357072,31404
2020/04/13,Burgos,Araba,514,331549,23395,308154,357072,31404
2020/04/13,Burgos,Soria,32,88636,5796,82840,357072,31404
2020/04/13,Burgos,Valladolid,125,519546,56299,463247,357072,31404
2020/04/13,Cáceres,Cádiz,22,1240155,123198,1116957,394151,29787
2020/04/13,Cáceres,Cáceres,19659,394151,29793,364358,394151,29787
2020/04/13,Cáceres,Ávila,83,157640,12183,145457,394151,29787
2020/04/13,Cáceres,Toledo,73,694844,45636,649208,394151,29787
2020/04/13,Cáceres,Badajoz,694,673559,62271,611288,394151,29787
2020/04/13,Cádiz,Málaga,943,1661785,152111,1509674,1240155,123473
2020/04/13,Cádiz,Cádiz,99015,1240155,123198,1116957,1240155,123473
2020/04/13,Cádiz,Huelva,854,521870,55683,466187,1240155,123473
2020/04/13,Cádiz,Sevilla,821,1942389,206174,1736215,1240155,123473
2020/04/13,Cantabria,Cantabria,28460,580795,39730,541065,580795,38312
2020/04/13,Cantabria,Bizkaia,287,1152934,97143,1055791,580795,38312
2020/04/13,Cantabria,Asturias,115,1022800,98056,924744,580795,38312
2020/04/13,Cantabria,Palencia,28,160866,15787,145079,580795,38312
2020/04/13,Castellón,Tarragona,525,804664,40968,763696,579962,33128
2020/04/13,Castellón,Teruel,34,134137,6798,127339,579962,33128
2020/04/13,Castellón,Castellón,23774,579962,33104,546858,579962,33128
2020/04/13,Castellón,Valencia,500,2565124,183312,2381812,579962,33128
2020/04/13,Ceuta,Cádiz,22,1240155,123198,1116957,84777,7399
2020/04/13,Ceuta,Ceuta,6982,84777,7308,77469,84777,7399
2020/04/13,Ciudad Real,Badajoz,45,673559,62271,611288,495761,20746
2020/04/13,Ciudad Real,Ciudad Real,13255,495761,22475,473286,495761,20746
2020/04/13,Ciudad Real,Córdoba,501,782979,83012,699967,495761,20746
2020/04/13,Ciudad Real,Albacete,403,388167,23440,364727,495761,20746
2020/04/13,Córdoba,Jaén,550,633564,48887,584677,782979,80030
2020/04/13,Córdoba,Sevilla,1323,1942389,206174,1736215,782979,80030
2020/04/13,Córdoba,Ciudad Real,259,495761,22475,473286,782979,80030
2020/04/13,Córdoba,Córdoba,57066,782979,83012,699967,782979,80030
2020/04/13,Córdoba,Málaga,175,1661785,152111,1509674,782979,80030
2020/04/13,Córdoba,Granada,143,914678,90174,824504,782979,80030
2020/04/13,Coruña,Lugo,460,329587,32595,296992,1119596,125041
2020/04/13,Coruña,Pontevedra,4054,942665,111737,830928,1119596,125041
2020/04/13,Coruña,Coruña,94278,1119596,124470,995126,1119596,125041
2020/04/13,Cuenca,Valencia,57,2565124,183312,2381812,196329,9138
2020/04/13,Cuenca,Guadalajara,19,257762,19517,238245,196329,9138
2020/04/13,Cuenca,Ciudad Real,55,495761,22475,473286,196329,9138
2020/04/13,Cuenca,Albacete,504,388167,23440,364727,196329,9138
2020/04/13,Cuenca,Toledo,97,694844,45636,649208,196329,9138
2020/04/13,Cuenca,Madrid,33,6663394,671687,5991707,196329,9138
2020/04/13,Cuenca,Cuenca,4155,196329,8930,187399,196329,9138
2020/04/13,Gipuzkoa,Bizkaia,324,1152934,97143,1055791,723576,40816
2020/04/13,Gipuzkoa,Navarra,67,654183,42247,611936,723576,40816
2020/04/13,Gipuzkoa,Gipuzkoa,29542,723576,39687,683889,723576,40816
2020/04/13,Girona,Lleida,59,434930,24497,410433,771044,34471
2020/04/13,Girona,Girona,22744,771044,33689,737355,771044,34471
2020/04/13,Girona,Barcelona,1008,5664579,385824,5278755,771044,34471
2020/04/13,Granada,Málaga,89,1661785,152111,1509674,914678,88027
2020/04/13,Granada,Jaén,287,633564,48887,584677,914678,88027
2020/04/13,Granada,Alicante,18,1858683,125185,1733498,914678,88027
2020/04/13,Granada,Almería,182,716820,63678,653142,914678,88027
2020/04/13,Granada,Granada,62096,914678,90174,824504,914678,88027
2020/04/13,Granada,Córdoba,215,782979,83012,699967,914678,88027
2020/04/13,Guadalajara,Guadalajara,10136,257762,19517,238245,257762,19181
2020/04/13,Guadalajara,Madrid,929,6663394,671687,5991707,257762,19181
2020/04/13,Guadalajara,Cuenca,27,196329,8930,187399,257762,19181
2020/04/13,Huelva,Sevilla,1052,1942389,206174,1736215,521870,58065
2020/04/13,Huelva,Badajoz,320,673559,62271,611288,521870,58065
2020/04/13,Huelva,Huelva,41810,521870,55683,466187,521870,58065
2020/04/13,Huelva,Cádiz,656,1240155,123198,1116957,521870,58065
2020/04/13,Huelva,Almería,16,716820,63678,653142,521870,58065
2020/04/13,Huesca,Lleida,465,434930,24497,410433,220461,19417
2020/04/13,Huesca,Huesca,11913,220461,17282,203179,220461,19417
2020/04/13,Huesca,Zaragoza,276,964724,113178,851546,220461,19417
2020/04/13,Jaén,Jaén,32290,633564,48887,584677,633564,47154
2020/04/13,Jaén,Córdoba,628,782979,83012,699967,633564,47154
2020/04/13,Jaén,Granada,133,914678,90174,824504,633564,47154
2020/04/13,Las Palmas de Gran Canaria,Santa Cruz de Tenerife,32,1032983,114501,918482,1120406,116804
2020/04/13,Las Palmas de Gran Canaria,Las Palmas de Gran Canaria,106756,1120406,116985,1003421,1120406,116804
2020/04/13,León,Ourense,75,307651,36357,271294,460001,50202
2020/04/13,León,Palencia,28,160866,15787,145079,460001,50202
2020/04/13,León,Asturias,40,1022800,98056,924744,460001,50202
2020/04/13,León,Zamora,70,172539,15933,156606,460001,50202
2020/04/13,León,León,36813,460001,50150,409851,460001,50202
2020/04/13,Lleida,Zaragoza,28,964724,113178,851546,434930,23861
2020/04/13,Lleida,Girona,53,771044,33689,737355,434930,23861
2020/04/13,Lleida,Huesca,314,220461,17282,203179,434930,23861
2020/04/13,Lleida,Lleida,15738,434930,24497,410433,434930,23861
2020/04/13,Lugo,Ourense,105,307651,36357,271294,329587,33156
2020/04/13,Lugo,Lugo,22894,329587,32595,296992,329587,33156
2020/04/13,Lugo,Asturias,651,1022800,98056,924744,329587,33156
2020/04/13,Lugo,Coruña,466,1119596,124470,995126,329587,33156
2020/04/13,Madrid,Guadalajara,1450,257762,19517,238245,6663394,680308
2020/04/13,Madrid,Toledo,2637,694844,45636,649208,6663394,680308
2020/04/13,Madrid,Segovia,20,153129,14175,138954,6663394,680308
2020/04/13,Madrid,Zaragoza,16,964724,113178,851546,6663394,680308
2020/04/13,Madrid,Cuenca,78,196329,8930,187399,6663394,680308
2020/04/13,Madrid,Madrid,380963,6663394,671687,5991707,6663394,680308
2020/04/13,Madrid,Jaén,16,633564,48887,584677,6663394,680308
2020/04/13,Madrid,Murcia,16,1493898,163048,1330850,6663394,680308
2020/04/13,Madrid,Ávila,105,157640,12183,145457,6663394,680308
2020/04/13,Málaga,Jaén,33,633564,48887,584677,1661785,156932
2020/04/13,Málaga,Málaga,118445,1661785,152111,1509674,1661785,156932
2020/04/13,Málaga,Granada,150,914678,90174,824504,1661785,156932
2020/04/13,Málaga,Cádiz,643,1240155,123198,1116957,1661785,156932
2020/04/13,Málaga,Sevilla,205,1942389,206174,1736215,1661785,156932
2020/04/13,Málaga,Córdoba,136,782979,83012,699967,1661785,156932
2020/04/13,Melilla,Melilla,9156,86487,9206,77281,86487,9236
2020/04/13,Murcia,Almería,1380,716820,63678,653142,1493898,161936
2020/04/13,Murcia,Albacete,308,388167,23440,364727,1493898,161936
2020/04/13,Murcia,Granada,32,914678,90174,824504,1493898,161936
2020/04/13,Murcia,Murcia,127984,1493898,163048,1330850,1493898,161936
2020/04/13,Murcia,Alicante,2509,1858683,125185,1733498,1493898,161936
2020/04/13,Navarra,Navarra,28632,654183,42247,611936,654183,42184
2020/04/13,Navarra,Zaragoza,301,964724,113178,851546,654183,42184
2020/04/13,Navarra,Gipuzkoa,97,723576,39687,683889,654183,42184
2020/04/13,Navarra,Rioja,794,316798,19628,297170,654183,42184
2020/04/13,Ourense,Ourense,27486,307651,36357,271294,307651,36332
2020/04/13,Ourense,Lugo,96,329587,32595,296992,307651,36332
2020/04/13,Ourense,León,60,460001,50150,409851,307651,36332
2020/04/13,Ourense,Pontevedra,153,942665,111737,830928,307651,36332
2020/04/13,Ourense,Zamora,25,172539,15933,156606,307651,36332
2020/04/13,Palencia,Valladolid,65,519546,56299,463247,160866,16646
2020/04/13,Palencia,Palencia,10809,160866,15787,145079,160866,16646
2020/04/13,Palencia,Burgos,169,357072,29916,327156,160866,16646
2020/04/13,Palencia,Cantabria,59,580795,39730,541065,160866,16646
2020/04/13,Pontevedra,Ourense,172,307651,36357,271294,942665,110132
2020/04/13,Pontevedra,Lugo,34,329587,32595,296992,942665,110132
2020/04/13,Pontevedra,Pontevedra,84264,942665,111737,830928,942665,110132
2020/04/13,Pontevedra,Coruña,3351,1119596,124470,995126,942665,110132
2020/04/13,Rioja,Rioja,13433,316798,19628,297170,316798,18857
2020/04/13,Rioja,Araba,219,331549,23395,308154,316798,18857
2020/04/13,Rioja,Navarra,969,654183,42247,611936,316798,18857
2020/04/13,Salamanca,Cáceres,34,394151,29793,364358,330119,35860
2020/04/13,Salamanca,Salamanca,28043,330119,36586,293533,330119,35860
2020/04/13,Salamanca,Ávila,202,157640,12183,145457,330119,35860
2020/04/13,Santa Cruz de Tenerife,Santa Cruz de Tenerife,102852,1032983,114501,918482,1032983,114297
2020/04/13,Segovia,Ávila,122,157640,12183,145457,153129,15588
2020/04/13,Segovia,Valladolid,226,519546,56299,463247,153129,15588
2020/04/13,Segovia,Burgos,79,357072,29916,327156,153129,15588
2020/04/13,Segovia,Segovia,9168,153129,14175,138954,153129,15588
2020/04/13,Sevilla,Córdoba,1518,782979,83012,699967,1942389,202341
2020/04/13,Sevilla,Málaga,91,1661785,152111,1509674,1942389,202341
2020/04/13,Sevilla,Alicante,18,1858683,125185,1733498,1942389,202341
2020/04/13,Sevilla,Sevilla,135798,1942389,206174,1736215,1942389,202341
2020/04/13,Sevilla,Huelva,416,521870,55683,466187,1942389,202341
2020/04/13,Sevilla,Cádiz,819,1240155,123198,1116957,1942389,202341
2020/04/13,Soria,Soria,4449,88636,5796,82840,88636,6534
2020/04/13,Soria,Valladolid,45,519546,56299,463247,88636,6534
2020/04/13,Soria,Burgos,32,357072,29916,327156,88636,6534
2020/04/13,Soria,Zaragoza,61,964724,113178,851546,88636,6534
2020/04/13,Tarragona,Barcelona,429,5664579,385824,5278755,804664,40492
2020/04/13,Tarragona,Castellón,317,579962,33104,546858,804664,40492
2020/04/13,Tarragona,Tarragona,27986,804664,40968,763696,804664,40492
2020/04/13,Teruel,Zaragoza,174,964724,113178,851546,134137,7897
2020/04/13,Teruel,Teruel,4150,134137,6798,127339,134137,7897
2020/04/13,Teruel,Tarragona,19,804664,40968,763696,134137,7897
2020/04/13,Toledo,Cáceres,106,394151,29793,364358,694844,42269
2020/04/13,Toledo,Toledo,19958,694844,45636,649208,694844,42269
2020/04/13,Toledo,Ciudad Real,143,495761,22475,473286,694844,42269
2020/04/13,Toledo,Madrid,2153,6663394,671687,5991707,694844,42269
2020/04/13,Toledo,Ávila,101,157640,12183,145457,694844,42269
2020/04/13,Toledo,Alicante,16,1858683,125185,1733498,694844,42269
2020/04/13,Valencia,Murcia,16,1493898,163048,1330850,2565124,181047
2020/04/13,Valencia,Albacete,223,388167,23440,364727,2565124,181047
2020/04/13,Valencia,Cuenca,72,196329,8930,187399,2565124,181047
2020/04/13,Valencia,Valencia,126403,2565124,183312,2381812,2565124,181047
2020/04/13,Valencia,Castellón,305,579962,33104,546858,2565124,181047
2020/04/13,Valencia,Alicante,443,1858683,125185,1733498,2565124,181047
2020/04/13,Valladolid,León,48,460001,50150,409851,519546,54086
2020/04/13,Valladolid,Valladolid,37961,519546,56299,463247,519546,54086
2020/04/13,Valladolid,Segovia,204,153129,14175,138954,519546,54086
2020/04/13,Valladolid,Zamora,65,172539,15933,156606,519546,54086
2020/04/13,Valladolid,Burgos,50,357072,29916,327156,519546,54086
2020/04/13,Valladolid,Soria,52,88636,5796,82840,519546,54086
2020/04/13,Valladolid,Ávila,26,157640,12183,145457,519546,54086
2020/04/13,Zamora,Salamanca,16,330119,36586,293533,172539,16391
2020/04/13,Zamora,Zamora,10993,172539,15933,156606,172539,16391
2020/04/13,Zamora,Valladolid,48,519546,56299,463247,172539,16391
2020/04/13,Zamora,Ourense,45,307651,36357,271294,172539,16391
2020/04/13,Zaragoza,Teruel,45,134137,6798,127339,964724,111303
2020/04/13,Zaragoza,Barcelona,19,5664579,385824,5278755,964724,111303
2020/04/13,Zaragoza,Lleida,61,434930,24497,410433,964724,111303
2020/04/13,Zaragoza,Navarra,329,654183,42247,611936,964724,111303
2020/04/13,Zaragoza,Tarragona,19,804664,40968,763696,964724,111303
2020/04/13,Zaragoza,Soria,43,88636,5796,82840,964724,111303
2020/04/13,Zaragoza,Zaragoza,83534,964724,113178,851546,964724,111303
2020/04/13,Zaragoza,Huesca,123,220461,17282,203179,964724,111303
2020/04/14,Albacete,Albacete,15579,388167,26846,361321,388167,26602
2020/04/14,Albacete,Alicante,153,1858683,206791,1651892,388167,26602
2020/04/14,Albacete,Valencia,317,2565124,323420,2241704,388167,26602
2020/04/14,Albacete,Murcia,141,1493898,159053,1334845,388167,26602
2020/04/14,Albacete,Jaén,42,633564,53890,579674,388167,26602
2020/04/14,Albacete,Cuenca,536,196329,15479,180850,388167,26602
2020/04/14,Albacete,Ciudad Real,542,495761,34764,460997,388167,26602
2020/04/14,Alicante,Valencia,722,2565124,323420,2241704,1858683,210294
2020/04/14,Alicante,Murcia,2233,1493898,159053,1334845,1858683,210294
2020/04/14,Alicante,Albacete,223,388167,26846,361321,1858683,210294
2020/04/14,Alicante,Alicante,151226,1858683,206791,1651892,1858683,210294
2020/04/14,Almería,Murcia,1783,1493898,159053,1334845,716820,77774
2020/04/14,Almería,Almería,59472,716820,76034,640786,716820,77774
2020/04/14,Almería,Granada,318,914678,95735,818943,716820,77774
2020/04/14,Almería,Melilla,17,86487,10238,76249,716820,77774
2020/04/14,Araba,Navarra,79,654183,74904,579279,331549,48045
2020/04/14,Araba,Araba,34042,331549,42174,289375,331549,48045
2020/04/14,Araba,Gipuzkoa,88,723576,77886,645690,331549,48045
2020/04/14,Araba,Bizkaia,770,1152934,161558,991376,331549,48045
2020/04/14,Araba,Burgos,1297,357072,33489,323583,331549,48045
2020/04/14,Araba,Rioja,1565,316798,36275,280523,331549,48045
2020/04/14,Asturias,Lugo,721,329587,35016,294571,1022800,110820
2020/04/14,Asturias,León,37,460001,49787,410214,1022800,110820
2020/04/14,Asturias,Asturias,84365,1022800,111481,911319,1022800,110820
2020/04/14,Asturias,Cantabria,148,580795,67774,513021,1022800,110820
2020/04/14,Ávila,Segovia,107,153129,15205,137924,157640,13080
2020/04/14,Ávila,Salamanca,213,330119,34682,295437,157640,13080
2020/04/14,Ávila,Toledo,207,694844,69526,625318,157640,13080
2020/04/14,Ávila,Madrid,77,6663394,753434,5909960,157640,13080
2020/04/14,Ávila,Cáceres,79,394151,29789,364362,157640,13080
2020/04/14,Ávila,Ávila,8183,157640,12896,144744,157640,13080
2020/04/14,Badajoz,Córdoba,63,782979,77615,705364,673559,61495
2020/04/14,Badajoz,Badajoz,43673,673559,62537,611022,673559,61495
2020/04/14,Badajoz,Cáceres,800,394151,29789,364362,673559,61495
2020/04/14,Badajoz,Ciudad Real,33,495761,34764,460997,673559,61495
2020/04/14,Badajoz,Huelva,203,521870,50249,471621,673559,61495
2020/04/14,Balears,Valencia,32,2565124,323420,2241704,1149460,103092
2020/04/14,Balears,Balears,83670,1149460,101852,1047608,1149460,103092
2020/04/14,Barcelona,Tarragona,925,804664,73922,730742,5664579,640643
2020/04/14,Barcelona,Barcelona,385999,5664579,636229,5028350,5664579,640643
2020/04/14,Barcelona,Lleida,124,434930,45511,389419,5664579,640643
2020/04/14,Barcelona,Girona,1645,771044,66694,704350,5664579,640643
2020/04/14,Bizkaia,Gipuzkoa,725,723576,77886,645690,1152934,158884
2020/04/14,Bizkaia,Cantabria,1515,580795,67774,513021,1152934,158884
2020/04/14,Bizkaia,Araba,495,331549,42174,289375,1152934,158884
2020/04/14,Bizkaia,Bizkaia,117450,1152934,161558,991376,1152934,158884
2020/04/14,Bizkaia,Burgos,23,357072,33489,323583,1152934,158884
2020/04/14,Burgos,Valladolid,32,519546,57649,461897,357072,34013
2020/04/14,Burgos,Bizkaia,50,1152934,161558,991376,357072,34013
2020/04/14,Burgos,Araba,621,331549,42174,289375,357072,34013
2020/04/14,Burgos,Rioja,51,316798,36275,280523,357072,34013
2020/04/14,Burgos,Palencia,200,160866,16715,144151,357072,34013
2020/04/14,Burgos,Burgos,23798,357072,33489,323583,357072,34013
2020/04/14,Cáceres,Cáceres,18646,394151,29789,364362,394151,29609
2020/04/14,Cáceres,Badajoz,874,673559,62537,611022,394151,29609
2020/04/14,Cáceres,Ávila,106,157640,12896,144744,394151,29609
2020/04/14,Cáceres,Valencia,20,2565124,323420,2241704,394151,29609
2020/04/14,Cáceres,Toledo,119,694844,69526,625318,394151,29609
2020/04/14,Cádiz,Cádiz,92017,1240155,116660,1123495,1240155,117623
2020/04/14,Cádiz,Huelva,634,521870,50249,471621,1240155,117623
2020/04/14,Cádiz,Sevilla,588,1942389,193812,1748577,1240155,117623
2020/04/14,Cádiz,Málaga,833,1661785,149296,1512489,1240155,117623
2020/04/14,Cantabria,Cantabria,47180,580795,67774,513021,580795,64767
2020/04/14,Cantabria,Asturias,167,1022800,111481,911319,580795,64767
2020/04/14,Cantabria,Bizkaia,395,1152934,161558,991376,580795,64767
2020/04/14,Cantabria,Palencia,55,160866,16715,144151,580795,64767
2020/04/14,Castellón,Valencia,585,2565124,323420,2241704,579962,64097
2020/04/14,Castellón,Teruel,32,134137,7285,126852,579962,64097
2020/04/14,Castellón,Castellón,44277,579962,61269,518693,579962,64097
2020/04/14,Castellón,Tarragona,636,804664,73922,730742,579962,64097
2020/04/14,Ceuta,Cádiz,16,1240155,116660,1123495,84777,8050
2020/04/14,Ceuta,Ceuta,7626,84777,8109,76668,84777,8050
2020/04/14,Ciudad Real,Toledo,155,694844,69526,625318,495761,32425
2020/04/14,Ciudad Real,Albacete,443,388167,26846,361321,495761,32425
2020/04/14,Ciudad Real,Córdoba,289,782979,77615,705364,495761,32425
2020/04/14,Ciudad Real,Badajoz,63,673559,62537,611022,495761,32425
2020/04/14,Ciudad Real,Ciudad Real,19156,495761,34764,460997,495761,32425
2020/04/14,Córdoba,Jaén,647,633564,53890,579674,782979,75698
2020/04/14,Córdoba,Ciudad Real,258,495761,34764,460997,782979,75698
2020/04/14,Córdoba,Córdoba,52210,782979,77615,705364,782979,75698
2020/04/14,Córdoba,Sevilla,1305,1942389,193812,1748577,782979,75698
2020/04/14,Córdoba,Granada,110,914678,95735,818943,782979,75698
2020/04/14,Córdoba,Málaga,105,1661785,149296,1512489,782979,75698
2020/04/14,Córdoba,Badajoz,33,673559,62537,611022,782979,75698
2020/04/14,Coruña,Pontevedra,4177,942665,124243,818422,1119596,141714
2020/04/14,Coruña,Coruña,104775,1119596,141119,978477,1119596,141714
2020/04/14,Coruña,Lugo,443,329587,35016,294571,1119596,141714
2020/04/14,Cuenca,Madrid,65,6663394,753434,5909960,196329,16584
2020/04/14,Cuenca,Cuenca,7461,196329,15479,180850,196329,16584
2020/04/14,Cuenca,Ciudad Real,45,495761,34764,460997,196329,16584
2020/04/14,Cuenca,Valencia,46,2565124,323420,2241704,196329,16584
2020/04/14,Cuenca,Toledo,184,694844,69526,625318,196329,16584
2020/04/14,Cuenca,Guadalajara,22,257762,27722,230040,196329,16584
2020/04/14,Cuenca,Albacete,421,388167,26846,361321,196329,16584
2020/04/14,Gipuzkoa,Gipuzkoa,57049,723576,77886,645690,723576,82436
2020/04/14,Gipuzkoa,Bizkaia,870,1152934,161558,991376,723576,82436
2020/04/14,Gipuzkoa,Araba,98,331549,42174,289375,723576,82436
2020/04/14,Gipuzkoa,Navarra,208,654183,74904,579279,723576,82436
2020/04/14,Girona,Lleida,129,434930,45511,389419,771044,70972
2020/04/14,Girona,Girona,42514,771044,66694,704350,771044,70972
2020/04/14,Girona,Barcelona,1481,5664579,636229,5028350,771044,70972
2020/04/14,Granada,Córdoba,236,782979,77615,705364,914678,93412
2020/04/14,Granada,Málaga,131,1661785,149296,1512489,914678,93412
2020/04/14,Granada,Granada,64729,914678,95735,818943,914678,93412
2020/04/14,Granada,Jaén,273,633564,53890,579674,914678,93412
2020/04/14,Granada,Almería,248,716820,76034,640786,914678,93412
2020/04/14,Guadalajara,Guadalajara,16003,257762,27722,230040,257762,28912
2020/04/14,Guadalajara,Cuenca,37,196329,15479,180850,257762,28912
2020/04/14,Guadalajara,Madrid,1601,6663394,753434,5909960,257762,28912
2020/04/14,Huelva,Sevilla,868,1942389,193812,1748577,521870,51788
2020/04/14,Huelva,Huelva,36067,521870,50249,471621,521870,51788
2020/04/14,Huelva,Badajoz,292,673559,62537,611022,521870,51788
2020/04/14,Huelva,Cádiz,368,1240155,116660,1123495,521870,51788
2020/04/14,Huesca,Lleida,657,434930,45511,389419,220461,24198
2020/04/14,Huesca,Zaragoza,267,964724,120970,843754,220461,24198
2020/04/14,Huesca,Huesca,14256,220461,21284,199177,220461,24198
2020/04/14,Jaén,Jaén,34356,633564,53890,579674,633564,52185
2020/04/14,Jaén,Córdoba,616,782979,77615,705364,633564,52185
2020/04/14,Jaén,Granada,302,914678,95735,818943,633564,52185
2020/04/14,Las Palmas de Gran Canaria,Santa Cruz de Tenerife,26,1032983,110190,922793,1120406,116019
2020/04/14,Las Palmas de Gran Canaria,Las Palmas de Gran Canaria,102917,1120406,116974,1003432,1120406,116019
2020/04/14,León,Asturias,40,1022800,111481,911319,460001,48945
2020/04/14,León,Zamora,124,172539,17050,155489,460001,48945
2020/04/14,León,Ourense,87,307651,39239,268412,460001,48945
2020/04/14,León,Palencia,34,160866,16715,144151,460001,48945
2020/04/14,León,León,35421,460001,49787,410214,460001,48945
2020/04/14,Lleida,Lleida,27326,434930,45511,389419,434930,43543
2020/04/14,Lleida,Barcelona,132,5664579,636229,5028350,434930,43543
2020/04/14,Lleida,Tarragona,32,804664,73922,730742,434930,43543
2020/04/14,Lleida,Huesca,460,220461,21284,199177,434930,43543
2020/04/14,Lleida,Zaragoza,72,964724,120970,843754,434930,43543
2020/04/14,Lleida,Girona,69,771044,66694,704350,434930,43543
2020/04/14,Lugo,Lugo,23976,329587,35016,294571,329587,35750
2020/04/14,Lugo,Asturias,593,1022800,111481,911319,329587,35750
2020/04/14,Lugo,Ourense,64,307651,39239,268412,329587,35750
2020/04/14,Lugo,Coruña,506,1119596,141119,978477,329587,35750
2020/04/14,Madrid,Guadalajara,1893,257762,27722,230040,6663394,754470
2020/04/14,Madrid,Segovia,17,153129,15205,137924,6663394,754470
2020/04/14,Madrid,Toledo,3275,694844,69526,625318,6663394,754470
2020/04/14,Madrid,Cuenca,87,196329,15479,180850,6663394,754470
2020/04/14,Madrid,Madrid,427391,6663394,753434,5909960,6663394,754470
2020/04/14,Madrid,Melilla,18,86487,10238,76249,6663394,754470
2020/04/14,Madrid,Ávila,127,157640,12896,144744,6663394,754470
2020/04/14,Málaga,Málaga,113906,1661785,149296,1512489,1661785,152288
2020/04/14,Málaga,Granada,184,914678,95735,818943,1661785,152288
2020/04/14,Málaga,Cádiz,612,1240155,116660,1123495,1661785,152288
2020/04/14,Málaga,Sevilla,185,1942389,193812,1748577,1661785,152288
2020/04/14,Málaga,Córdoba,248,782979,77615,705364,1661785,152288
2020/04/14,Melilla,Melilla,9889,86487,10238,76249,86487,10258
2020/04/14,Murcia,Albacete,126,388167,26846,361321,1493898,153948
2020/04/14,Murcia,Murcia,114888,1493898,159053,1334845,1493898,153948
2020/04/14,Murcia,Almería,1050,716820,76034,640786,1493898,153948
2020/04/14,Murcia,Alicante,2011,1858683,206791,1651892,1493898,153948
2020/04/14,Navarra,Navarra,51169,654183,74904,579279,654183,77821
2020/04/14,Navarra,Gipuzkoa,258,723576,77886,645690,654183,77821
2020/04/14,Navarra,Zaragoza,752,964724,120970,843754,654183,77821
2020/04/14,Navarra,Rioja,1910,316798,36275,280523,654183,77821
2020/04/14,Ourense,Pontevedra,155,942665,124243,818422,307651,39540
2020/04/14,Ourense,Zamora,24,172539,17050,155489,307651,39540
2020/04/14,Ourense,Lugo,175,329587,35016,294571,307651,39540
2020/04/14,Ourense,Ourense,29592,307651,39239,268412,307651,39540
2020/04/14,Ourense,León,111,460001,49787,410214,307651,39540
2020/04/14,Palencia,Cantabria,153,580795,67774,513021,160866,17521
2020/04/14,Palencia,Burgos,178,357072,33489,323583,160866,17521
2020/04/14,Palencia,Palencia,11365,160866,16715,144151,160866,17521
2020/04/14,Pontevedra,Ourense,196,307651,39239,268412,942665,123307
2020/04/14,Pontevedra,Pontevedra,93646,942665,124243,818422,942665,123307
2020/04/14,Pontevedra,Coruña,3572,1119596,141119,978477,942665,123307
2020/04/14,Rioja,Burgos,44,357072,33489,323583,316798,34276
2020/04/14,Rioja,Navarra,1431,654183,74904,579279,316798,34276
2020/04/14,Rioja,Araba,439,331549,42174,289375,316798,34276
2020/04/14,Rioja,Rioja,25190,316798,36275,280523,316798,34276
2020/04/14,Salamanca,Ávila,178,157640,12896,144744,330119,34244
2020/04/14,Salamanca,Salamanca,26021,330119,34682,295437,330119,34244
2020/04/14,Santa Cruz de Tenerife,Las Palmas de Gran Canaria,17,1120406,116974,1003432,1032983,109299
2020/04/14,Santa Cruz de Tenerife,Santa Cruz de Tenerife,94426,1032983,110190,922793,1032983,109299
2020/04/14,Segovia,Ávila,113,157640,12896,144744,153129,16142
2020/04/14,Segovia,Segovia,9574,153129,15205,137924,153129,16142
2020/04/14,Segovia,Valladolid,205,519546,57649,461897,153129,16142
2020/04/14,Segovia,Burgos,63,357072,33489,323583,153129,16142
2020/04/14,Sevilla,Huelva,348,521870,50249,471621,1942389,190376
2020/04/14,Sevilla,Cádiz,655,1240155,116660,1123495,1942389,190376
2020/04/14,Sevilla,Sevilla,123908,1942389,193812,1748577,1942389,190376
2020/04/14,Sevilla,Badajoz,21,673559,62537,611022,1942389,190376
2020/04/14,Sevilla,Málaga,116,1661785,149296,1512489,1942389,190376
2020/04/14,Sevilla,Córdoba,1369,782979,77615,705364,1942389,190376
2020/04/14,Soria,Soria,4467,88636,6083,82553,88636,6855
2020/04/14,Soria,Burgos,30,357072,33489,323583,88636,6855
2020/04/14,Soria,Zaragoza,75,964724,120970,843754,88636,6855
2020/04/14,Soria,Segovia,20,153129,15205,137924,88636,6855
2020/04/14,Soria,Valladolid,27,519546,57649,461897,88636,6855
2020/04/14,Tarragona,Teruel,43,134137,7285,126852,804664,73525
2020/04/14,Tarragona,Tarragona,45537,804664,73922,730742,804664,73525
2020/04/14,Tarragona,Barcelona,573,5664579,636229,5028350,804664,73525
2020/04/14,Tarragona,Castellón,564,579962,61269,518693,804664,73525
2020/04/14,Teruel,Castellón,42,579962,61269,518693,134137,8791
2020/04/14,Teruel,Teruel,3919,134137,7285,126852,134137,8791
2020/04/14,Teruel,Zaragoza,32,964724,120970,843754,134137,8791
2020/04/14,Teruel,Guadalajara,44,257762,27722,230040,134137,8791
2020/04/14,Teruel,Tarragona,75,804664,73922,730742,134137,8791
2020/04/14,Toledo,Cuenca,49,196329,15479,180850,694844,66831
2020/04/14,Toledo,Cáceres,146,394151,29789,364362,694844,66831
2020/04/14,Toledo,Toledo,32687,694844,69526,625318,694844,66831
2020/04/14,Toledo,Madrid,2855,6663394,753434,5909960,694844,66831
2020/04/14,Toledo,Ávila,107,157640,12896,144744,694844,66831
2020/04/14,Toledo,Ciudad Real,189,495761,34764,460997,694844,66831
2020/04/14,Valencia,Murcia,17,1493898,159053,1334845,2565124,316496
2020/04/14,Valencia,Cuenca,114,196329,15479,180850,2565124,316496
2020/04/14,Valencia,Albacete,270,388167,26846,361321,2565124,316496
2020/04/14,Valencia,Alicante,653,1858683,206791,1651892,2565124,316496
2020/04/14,Valencia,Valencia,210069,2565124,323420,2241704,2565124,316496
2020/04/14,Valencia,Castellón,513,579962,61269,518693,2565124,316496
2020/04/14,Valladolid,Soria,26,88636,6083,82553,519546,55619
2020/04/14,Valladolid,Valladolid,38983,519546,57649,461897,519546,55619
2020/04/14,Valladolid,Zamora,223,172539,17050,155489,519546,55619
2020/04/14,Valladolid,Segovia,196,153129,15205,137924,519546,55619
2020/04/14,Valladolid,Burgos,96,357072,33489,323583,519546,55619
2020/04/14,Zamora,Ourense,40,307651,39239,268412,172539,16799
2020/04/14,Zamora,Zamora,11136,172539,17050,155489,172539,16799
2020/04/14,Zamora,Valladolid,24,519546,57649,461897,172539,16799
2020/04/14,Zamora,León,27,460001,49787,410214,172539,16799
2020/04/14,Zamora,Salamanca,16,330119,34682,295437,172539,16799
2020/04/14,Zaragoza,Zaragoza,88384,964724,120970,843754,964724,116521
2020/04/14,Zaragoza,Soria,78,88636,6083,82553,964724,116521
2020/04/14,Zaragoza,Huesca,147,220461,21284,199177,964724,116521
2020/04/14,Zaragoza,Lleida,65,434930,45511,389419,964724,116521
2020/04/14,Zaragoza,Teruel,166,134137,7285,126852,964724,116521
2020/04/14,Zaragoza,Navarra,443,654183,74904,579279,964724,116521
2020/04/15,Albacete,Albacete,15760,388167,26573,361594,388167,26117
2020/04/15,Albacete,Cuenca,426,196329,14769,181560,388167,26117
2020/04/15,Albacete,Valencia,321,2565124,314912,2250212,388167,26117
2020/04/15,Albacete,Alicante,167,1858683,201132,1657551,388167,26117
2020/04/15,Albacete,Ciudad Real,479,495761,32972,462789,388167,26117
2020/04/15,Albacete,Jaén,33,633564,47711,585853,388167,26117
2020/04/15,Albacete,Murcia,134,1493898,156133,1337765,388167,26117
2020/04/15,Alicante,Murcia,2145,1493898,156133,1337765,1858683,203555
2020/04/15,Alicante,Valencia,769,2565124,314912,2250212,1858683,203555
2020/04/15,Alicante,Alicante,154492,1858683,201132,1657551,1858683,203555
2020/04/15,Alicante,Albacete,219,388167,26573,361594,1858683,203555
2020/04/15,Alicante,Barcelona,16,5664579,689885,4974694,1858683,203555
2020/04/15,Almería,Almería,58289,716820,72031,644789,716820,73117
2020/04/15,Almería,Murcia,1271,1493898,156133,1337765,716820,73117
2020/04/15,Almería,Granada,347,914678,90967,823711,716820,73117
2020/04/15,Araba,Navarra,81,654183,77106,577077,331549,49049
2020/04/15,Araba,Araba,34684,331549,43014,288535,331549,49049
2020/04/15,Araba,Gipuzkoa,136,723576,80581,642995,331549,49049
2020/04/15,Araba,Burgos,1475,357072,34354,322718,331549,49049
2020/04/15,Araba,Bizkaia,942,1152934,164357,988577,331549,49049
2020/04/15,Araba,Rioja,1587,316798,36543,280255,331549,49049
2020/04/15,Asturias,Asturias,87682,1022800,113252,909548,1022800,113132
2020/04/15,Asturias,Lugo,763,329587,35467,294120,1022800,113132
2020/04/15,Asturias,Cantabria,160,580795,67424,513371,1022800,113132
2020/04/15,Ávila,Cáceres,119,394151,29621,364530,157640,13297
2020/04/15,Ávila,Segovia,71,153129,15235,137894,157640,13297
2020/04/15,Ávila,Toledo,426,694844,71770,623074,157640,13297
2020/04/15,Ávila,Ávila,8048,157640,12708,144932,157640,13297
2020/04/15,Ávila,Madrid,85,6663394,742142,5921252,157640,13297
2020/04/15,Ávila,Salamanca,263,330119,34694,295425,157640,13297
2020/04/15,Badajoz,Ciudad Real,37,495761,32972,462789,673559,59170
2020/04/15,Badajoz,Badajoz,42145,673559,59572,613987,673559,59170
2020/04/15,Badajoz,Córdoba,88,782979,75024,707955,673559,59170
2020/04/15,Badajoz,Cáceres,786,394151,29621,364530,673559,59170
2020/04/15,Badajoz,Huelva,146,521870,51296,470574,673559,59170
2020/04/15,Balears,Barcelona,20,5664579,689885,4974694,1149460,108073
2020/04/15,Balears,Balears,89324,1149460,107145,1042315,1149460,108073
2020/04/15,Balears,Valencia,47,2565124,314912,2250212,1149460,108073
2020/04/15,Barcelona,Tarragona,872,804664,79036,725628,5664579,691557
2020/04/15,Barcelona,Barcelona,427556,5664579,689885,4974694,5664579,691557
2020/04/15,Barcelona,Girona,1925,771044,71112,699932,5664579,691557
2020/04/15,Barcelona,Lleida,68,434930,49295,385635,5664579,691557
2020/04/15,Bizkaia,Barcelona,16,5664579,689885,4974694,1152934,161378
2020/04/15,Bizkaia,Bizkaia,120356,1152934,164357,988577,1152934,161378
2020/04/15,Bizkaia,Cantabria,1565,580795,67424,513371,1152934,161378
2020/04/15,Bizkaia,Burgos,38,357072,34354,322718,1152934,161378
2020/04/15,Bizkaia,Gipuzkoa,784,723576,80581,642995,1152934,161378
2020/04/15,Bizkaia,Araba,633,331549,43014,288535,1152934,161378
2020/04/15,Burgos,Segovia,22,153129,15235,137894,357072,34757
2020/04/15,Burgos,Valladolid,87,519546,58158,461388,357072,34757
2020/04/15,Burgos,Burgos,24547,357072,34354,322718,357072,34757
2020/04/15,Burgos,Palencia,188,160866,16948,143918,357072,34757
2020/04/15,Burgos,Araba,576,331549,43014,288535,357072,34757
2020/04/15,Burgos,Rioja,26,316798,36543,280255,357072,34757
2020/04/15,Burgos,Bizkaia,48,1152934,164357,988577,357072,34757
2020/04/15,Cáceres,Badajoz,746,673559,59572,613987,394151,29382
2020/04/15,Cáceres,Cáceres,19110,394151,29621,364530,394151,29382
2020/04/15,Cáceres,Ávila,86,157640,12708,144932,394151,29382
2020/04/15,Cáceres,Toledo,157,694844,71770,623074,394151,29382
2020/04/15,Cádiz,Málaga,774,1661785,148143,1513642,1240155,116791
2020/04/15,Cádiz,Sevilla,520,1942389,194465,1747924,1240155,116791
2020/04/15,Cádiz,Ceuta,40,84777,8168,76609,1240155,116791
2020/04/15,Cádiz,Cádiz,92681,1240155,115308,1124847,1240155,116791
2020/04/15,Cádiz,Huelva,575,521870,51296,470574,1240155,116791
2020/04/15,Cantabria,Cantabria,47174,580795,67424,513371,580795,64561
2020/04/15,Cantabria,Palencia,30,160866,16948,143918,580795,64561
2020/04/15,Cantabria,Asturias,126,1022800,113252,909548,580795,64561
2020/04/15,Cantabria,Bizkaia,415,1152934,164357,988577,580795,64561
2020/04/15,Castellón,Castellón,45250,579962,61839,518123,579962,64303
2020/04/15,Castellón,Tarragona,683,804664,79036,725628,579962,64303
2020/04/15,Castellón,Valencia,509,2565124,314912,2250212,579962,64303
2020/04/15,Castellón,Teruel,30,134137,7981,126156,579962,64303
2020/04/15,Ceuta,Ceuta,7683,84777,8168,76609,84777,8101
2020/04/15,Ceuta,Cádiz,16,1240155,115308,1124847,84777,8101
2020/04/15,Ciudad Real,Ciudad Real,18169,495761,32972,462789,495761,30866
2020/04/15,Ciudad Real,Albacete,432,388167,26573,361594,495761,30866
2020/04/15,Ciudad Real,Córdoba,313,782979,75024,707955,495761,30866
2020/04/15,Ciudad Real,Toledo,184,694844,71770,623074,495761,30866
2020/04/15,Ciudad Real,Badajoz,51,673559,59572,613987,495761,30866
2020/04/15,Córdoba,Granada,119,914678,90967,823711,782979,73515
2020/04/15,Córdoba,Ciudad Real,223,495761,32972,462789,782979,73515
2020/04/15,Córdoba,Jaén,478,633564,47711,585853,782979,73515
2020/04/15,Córdoba,Sevilla,1065,1942389,194465,1747924,782979,73515
2020/04/15,Córdoba,Málaga,70,1661785,148143,1513642,782979,73515
2020/04/15,Córdoba,Córdoba,51030,782979,75024,707955,782979,73515
2020/04/15,Córdoba,Badajoz,34,673559,59572,613987,782979,73515
2020/04/15,Coruña,Coruña,103342,1119596,138933,980663,1119596,140190
2020/04/15,Coruña,Pontevedra,4243,942665,124010,818655,1119596,140190
2020/04/15,Coruña,Lugo,531,329587,35467,294120,1119596,140190
2020/04/15,Cuenca,Guadalajara,25,257762,27707,230055,196329,15328
2020/04/15,Cuenca,Ciudad Real,29,495761,32972,462789,196329,15328
2020/04/15,Cuenca,Cuenca,7004,196329,14769,181560,196329,15328
2020/04/15,Cuenca,Valencia,40,2565124,314912,2250212,196329,15328
2020/04/15,Cuenca,Albacete,473,388167,26573,361594,196329,15328
2020/04/15,Cuenca,Toledo,100,694844,71770,623074,196329,15328
2020/04/15,Cuenca,Madrid,56,6663394,742142,5921252,196329,15328
2020/04/15,Gipuzkoa,Bizkaia,915,1152934,164357,988577,723576,84340
2020/04/15,Gipuzkoa,Gipuzkoa,59484,723576,80581,642995,723576,84340
2020/04/15,Gipuzkoa,Araba,80,331549,43014,288535,723576,84340
2020/04/15,Gipuzkoa,Navarra,303,654183,77106,577077,723576,84340
2020/04/15,Girona,Girona,46225,771044,71112,699932,771044,76025
2020/04/15,Girona,Lleida,133,434930,49295,385635,771044,76025
2020/04/15,Girona,Barcelona,1815,5664579,689885,4974694,771044,76025
2020/04/15,Granada,Málaga,103,1661785,148143,1513642,914678,88813
2020/04/15,Granada,Granada,64179,914678,90967,823711,914678,88813
2020/04/15,Granada,Almería,330,716820,72031,644789,914678,88813
2020/04/15,Granada,Jaén,138,633564,47711,585853,914678,88813
2020/04/15,Granada,Córdoba,136,782979,75024,707955,914678,88813
2020/04/15,Guadalajara,Guadalajara,16067,257762,27707,230055,257762,28664
2020/04/15,Guadalajara,Madrid,1404,6663394,742142,5921252,257762,28664
2020/04/15,Guadalajara,Cuenca,23,196329,14769,181560,257762,28664
2020/04/15,Huelva,Huelva,37919,521870,51296,470574,521870,53327
2020/04/15,Huelva,Cádiz,482,1240155,115308,1124847,521870,53327
2020/04/15,Huelva,Sevilla,691,1942389,194465,1747924,521870,53327
2020/04/15,Huelva,Badajoz,293,673559,59572,613987,521870,53327
2020/04/15,Huesca,Zaragoza,217,964724,122411,842313,220461,24997
2020/04/15,Huesca,Huesca,14794,220461,22277,198184,220461,24997
2020/04/15,Huesca,Lleida,765,434930,49295,385635,220461,24997
2020/04/15,Jaén,Albacete,17,388167,26573,361594,633564,46704
2020/04/15,Jaén,Granada,127,914678,90967,823711,633564,46704
2020/04/15,Jaén,Córdoba,536,782979,75024,707955,633564,46704
2020/04/15,Jaén,Jaén,31709,633564,47711,585853,633564,46704
2020/04/15,Las Palmas de Gran Canaria,Las Palmas de Gran Canaria,106944,1120406,119511,1000895,1120406,118531
2020/04/15,Las Palmas de Gran Canaria,Santa Cruz de Tenerife,20,1032983,111843,921140,1120406,118531
2020/04/15,León,Zamora,98,172539,16951,155588,460001,48959
2020/04/15,León,Palencia,32,160866,16948,143918,460001,48959
2020/04/15,León,León,35744,460001,49860,410141,460001,48959
2020/04/15,León,Asturias,41,1022800,113252,909548,460001,48959
2020/04/15,León,Ourense,102,307651,39031,268620,460001,48959
2020/04/15,Lleida,Barcelona,178,5664579,689885,4974694,434930,46840
2020/04/15,Lleida,Tarragona,24,804664,79036,725628,434930,46840
2020/04/15,Lleida,Girona,108,771044,71112,699932,434930,46840
2020/04/15,Lleida,Lleida,30350,434930,49295,385635,434930,46840
2020/04/15,Lleida,Huesca,456,220461,22277,198184,434930,46840
2020/04/15,Lleida,Zaragoza,102,964724,122411,842313,434930,46840
2020/04/15,Lugo,Coruña,463,1119596,138933,980663,329587,36323
2020/04/15,Lugo,Asturias,557,1022800,113252,909548,329587,36323
2020/04/15,Lugo,Lugo,24558,329587,35467,294120,329587,36323
2020/04/15,Lugo,Ourense,107,307651,39031,268620,329587,36323
2020/04/15,Madrid,Segovia,20,153129,15235,137894,6663394,745679
2020/04/15,Madrid,Madrid,422829,6663394,742142,5921252,6663394,745679
2020/04/15,Madrid,Guadalajara,1771,257762,27707,230055,6663394,745679
2020/04/15,Madrid,Cuenca,67,196329,14769,181560,6663394,745679
2020/04/15,Madrid,Toledo,2910,694844,71770,623074,6663394,745679
2020/04/15,Madrid,Ávila,132,157640,12708,144932,6663394,745679
2020/04/15,Madrid,Melilla,16,86487,10349,76138,6663394,745679
2020/04/15,Málaga,Cádiz,601,1240155,115308,1124847,1661785,150572
2020/04/15,Málaga,Granada,135,914678,90967,823711,1661785,150572
2020/04/15,Málaga,Sevilla,79,1942389,194465,1747924,1661785,150572
2020/04/15,Málaga,Málaga,115175,1661785,148143,1513642,1661785,150572
2020/04/15,Málaga,Córdoba,186,782979,75024,707955,1661785,150572
2020/04/15,Melilla,Melilla,10105,86487,10349,76138,86487,10310
2020/04/15,Murcia,Almería,860,716820,72031,644789,1493898,154126
2020/04/15,Murcia,Murcia,115663,1493898,156133,1337765,1493898,154126
2020/04/15,Murcia,Albacete,166,388167,26573,361594,1493898,154126
2020/04/15,Murcia,Barcelona,16,5664579,689885,4974694,1493898,154126
2020/04/15,Murcia,Granada,37,914678,90967,823711,1493898,154126
2020/04/15,Murcia,Alicante,1955,1858683,201132,1657551,1493898,154126
2020/04/15,Navarra,Navarra,53027,654183,77106,577077,654183,78449
2020/04/15,Navarra,Araba,54,331549,43014,288535,654183,78449
2020/04/15,Navarra,Gipuzkoa,243,723576,80581,642995,654183,78449
2020/04/15,Navarra,Zaragoza,446,964724,122411,842313,654183,78449
2020/04/15,Navarra,Rioja,2041,316798,36543,280255,654183,78449
2020/04/15,Ourense,León,83,460001,49860,410141,307651,39044
2020/04/15,Ourense,Pontevedra,152,942665,124010,818655,307651,39044
2020/04/15,Ourense,Zamora,23,172539,16951,155588,307651,39044
2020/04/15,Ourense,Ourense,29357,307651,39031,268620,307651,39044
2020/04/15,Ourense,Lugo,160,329587,35467,294120,307651,39044
2020/04/15,Palencia,Palencia,11581,160866,16948,143918,160866,17811
2020/04/15,Palencia,Burgos,127,357072,34354,322718,160866,17811
2020/04/15,Palencia,Valladolid,44,519546,58158,461388,160866,17811
2020/04/15,Palencia,Cantabria,150,580795,67424,513371,160866,17811
2020/04/15,Pontevedra,Pontevedra,93300,942665,124010,818655,942665,122382
2020/04/15,Pontevedra,Coruña,3489,1119596,138933,980663,942665,122382
2020/04/15,Pontevedra,Ourense,221,307651,39031,268620,942665,122382
2020/04/15,Rioja,Navarra,1664,654183,77106,577077,316798,34211
2020/04/15,Rioja,Burgos,18,357072,34354,322718,316798,34211
2020/04/15,Rioja,Rioja,25212,316798,36543,280255,316798,34211
2020/04/15,Rioja,Araba,502,331549,43014,288535,316798,34211
2020/04/15,Salamanca,Ávila,173,157640,12708,144932,330119,34443
2020/04/15,Salamanca,Zamora,62,172539,16951,155588,330119,34443
2020/04/15,Salamanca,Salamanca,26450,330119,34694,295425,330119,34443
2020/04/15,Santa Cruz de Tenerife,Las Palmas de Gran Canaria,16,1120406,119511,1000895,1032983,111583
2020/04/15,Santa Cruz de Tenerife,Santa Cruz de Tenerife,96613,1032983,111843,921140,1032983,111583
2020/04/15,Segovia,Valladolid,231,519546,58158,461388,153129,16292
2020/04/15,Segovia,Ávila,114,157640,12708,144932,153129,16292
2020/04/15,Segovia,Burgos,46,357072,34354,322718,153129,16292
2020/04/15,Segovia,Segovia,9704,153129,15235,137894,153129,16292
2020/04/15,Sevilla,Córdoba,1113,782979,75024,707955,1942389,191805
2020/04/15,Sevilla,Cádiz,533,1240155,115308,1124847,1942389,191805
2020/04/15,Sevilla,Sevilla,128031,1942389,194465,1747924,1942389,191805
2020/04/15,Sevilla,Badajoz,16,673559,59572,613987,1942389,191805
2020/04/15,Sevilla,Málaga,148,1661785,148143,1513642,1942389,191805
2020/04/15,Sevilla,Huelva,324,521870,51296,470574,1942389,191805
2020/04/15,Soria,Segovia,16,153129,15235,137894,88636,6759
2020/04/15,Soria,Valladolid,32,519546,58158,461388,88636,6759
2020/04/15,Soria,Burgos,32,357072,34354,322718,88636,6759
2020/04/15,Soria,Zaragoza,74,964724,122411,842313,88636,6759
2020/04/15,Soria,Soria,4446,88636,6221,82415,88636,6759
2020/04/15,Tarragona,Castellón,660,579962,61839,518123,804664,78412
2020/04/15,Tarragona,Tarragona,50555,804664,79036,725628,804664,78412
2020/04/15,Tarragona,Teruel,37,134137,7981,126156,804664,78412
2020/04/15,Tarragona,Barcelona,750,5664579,689885,4974694,804664,78412
2020/04/15,Teruel,Tarragona,65,804664,79036,725628,134137,9314
2020/04/15,Teruel,Castellón,58,579962,61839,518123,134137,9314
2020/04/15,Teruel,Teruel,4406,134137,7981,126156,134137,9314
2020/04/15,Teruel,Zaragoza,43,964724,122411,842313,134137,9314
2020/04/15,Toledo,Ciudad Real,223,495761,32972,462789,694844,68762
2020/04/15,Toledo,Ávila,206,157640,12708,144932,694844,68762
2020/04/15,Toledo,Cáceres,156,394151,29621,364530,694844,68762
2020/04/15,Toledo,Toledo,35594,694844,71770,623074,694844,68762
2020/04/15,Toledo,Madrid,2918,6663394,742142,5921252,694844,68762
2020/04/15,Toledo,Cuenca,51,196329,14769,181560,694844,68762
2020/04/15,Valencia,Cuenca,57,196329,14769,181560,2565124,307447
2020/04/15,Valencia,Castellón,458,579962,61839,518123,2565124,307447
2020/04/15,Valencia,Albacete,280,388167,26573,361594,2565124,307447
2020/04/15,Valencia,Valencia,209323,2565124,314912,2250212,2565124,307447
2020/04/15,Valencia,Alicante,705,1858683,201132,1657551,2565124,307447
2020/04/15,Valladolid,Ávila,23,157640,12708,144932,519546,56266
2020/04/15,Valladolid,Segovia,208,153129,15235,137894,519546,56266
2020/04/15,Valladolid,Burgos,44,357072,34354,322718,519546,56266
2020/04/15,Valladolid,Soria,28,88636,6221,82415,519546,56266
2020/04/15,Valladolid,Zamora,52,172539,16951,155588,519546,56266
2020/04/15,Valladolid,León,31,460001,49860,410141,519546,56266
2020/04/15,Valladolid,Valladolid,39727,519546,58158,461388,519546,56266
2020/04/15,Zamora,Valladolid,88,519546,58158,461388,172539,17082
2020/04/15,Zamora,Zamora,11461,172539,16951,155588,172539,17082
2020/04/15,Zamora,Ourense,53,307651,39031,268620,172539,17082
2020/04/15,Zaragoza,Navarra,474,654183,77106,577077,964724,117435
2020/04/15,Zaragoza,Huesca,209,220461,22277,198184,964724,117435
2020/04/15,Zaragoza,Zaragoza,89581,964724,122411,842313,964724,117435
2020/04/15,Zaragoza,Soria,76,88636,6221,82415,964724,117435
2020/04/15,Zaragoza,Lleida,108,434930,49295,385635,964724,117435
2020/04/15,Zaragoza,Barcelona,16,5664579,689885,4974694,964724,117435
2020/04/15,Zaragoza,Teruel,188,134137,7981,126156,964724,117435
2020/04/16,Albacete,Ciudad Real,392,495761,35552,460209,388167,28772
2020/04/16,Albacete,Albacete,17843,388167,28554,359613,388167,28772
2020/04/16,Albacete,Murcia,241,1493898,178868,1315030,388167,28772
2020/04/16,Albacete,Jaén,37,633564,55731,577833,388167,28772
2020/04/16,Albacete,Alicante,214,1858683,225296,1633387,388167,28772
2020/04/16,Albacete,Cuenca,347,196329,15324,181005,388167,28772
2020/04/16,Albacete,Valencia,288,2565124,351254,2213870,388167,28772
2020/04/16,Alicante,Albacete,240,388167,28554,359613,1858683,229543
2020/04/16,Alicante,Murcia,2659,1493898,178868,1315030,1858683,229543
2020/04/16,Alicante,Valencia,659,2565124,351254,2213870,1858683,229543
2020/04/16,Alicante,Alicante,175735,1858683,225296,1633387,1858683,229543
2020/04/16,Almería,Murcia,1960,1493898,178868,1315030,716820,78952
2020/04/16,Almería,Melilla,18,86487,10872,75615,716820,78952
2020/04/16,Almería,Granada,377,914678,98517,816161,716820,78952
2020/04/16,Almería,Almería,62383,716820,76447,640373,716820,78952
2020/04/16,Araba,Araba,36630,331549,45491,286058,331549,50717
2020/04/16,Araba,Navarra,163,654183,82690,571493,331549,50717
2020/04/16,Araba,Bizkaia,964,1152934,173064,979870,331549,50717
2020/04/16,Araba,Rioja,1396,316798,38225,278573,331549,50717
2020/04/16,Araba,Gipuzkoa,173,723576,86390,637186,331549,50717
2020/04/16,Araba,Burgos,1302,357072,35651,321421,331549,50717
2020/04/16,Asturias,Cantabria,132,580795,74955,505840,1022800,120616
2020/04/16,Asturias,León,33,460001,52966,407035,1022800,120616
2020/04/16,Asturias,Lugo,984,329587,36221,293366,1022800,120616
2020/04/16,Asturias,Asturias,94252,1022800,121018,901782,1022800,120616
2020/04/16,Ávila,Toledo,119,694844,76577,618267,157640,14005
2020/04/16,Ávila,Ávila,8717,157640,13493,144147,157640,14005
2020/04/16,Ávila,Salamanca,283,330119,37343,292776,157640,14005
2020/04/16,Ávila,Cáceres,134,394151,31853,362298,157640,14005
2020/04/16,Ávila,Madrid,111,6663394,806557,5856837,157640,14005
2020/04/16,Ávila,Segovia,118,153129,15960,137169,157640,14005
2020/04/16,Badajoz,Córdoba,93,782979,83325,699654,673559,63264
2020/04/16,Badajoz,Badajoz,46076,673559,64094,609465,673559,63264
2020/04/16,Badajoz,Sevilla,22,1942389,214293,1728096,673559,63264
2020/04/16,Badajoz,Huelva,215,521870,54921,466949,673559,63264
2020/04/16,Badajoz,Ciudad Real,36,495761,35552,460209,673559,63264
2020/04/16,Badajoz,Cáceres,701,394151,31853,362298,673559,63264
2020/04/16,Balears,Balears,94025,1149460,111989,1037471,1149460,112733
2020/04/16,Balears,Barcelona,18,5664579,728999,4935580,1149460,112733
2020/04/16,Balears,Valencia,76,2565124,351254,2213870,1149460,112733
2020/04/16,Barcelona,Tarragona,1000,804664,84482,720182,5664579,730121
2020/04/16,Barcelona,Girona,2166,771044,75767,695277,5664579,730121
2020/04/16,Barcelona,Lleida,184,434930,51022,383908,5664579,730121
2020/04/16,Barcelona,Barcelona,463391,5664579,728999,4935580,5664579,730121
2020/04/16,Bizkaia,Bizkaia,127820,1152934,173064,979870,1152934,169012
2020/04/16,Bizkaia,Cantabria,1579,580795,74955,505840,1152934,169012
2020/04/16,Bizkaia,Burgos,49,357072,35651,321421,1152934,169012
2020/04/16,Bizkaia,Araba,631,331549,45491,286058,1152934,169012
2020/04/16,Bizkaia,Gipuzkoa,730,723576,86390,637186,1152934,169012
2020/04/16,Burgos,Valladolid,77,519546,61812,457734,357072,36190
2020/04/16,Burgos,Araba,762,331549,45491,286058,357072,36190
2020/04/16,Burgos,Burgos,25713,357072,35651,321421,357072,36190
2020/04/16,Burgos,Palencia,186,160866,17379,143487,357072,36190
2020/04/16,Burgos,Segovia,46,153129,15960,137169,357072,36190
2020/04/16,Burgos,Soria,29,88636,6456,82180,357072,36190
2020/04/16,Burgos,Bizkaia,90,1152934,173064,979870,357072,36190
2020/04/16,Burgos,Rioja,44,316798,38225,278573,357072,36190
2020/04/16,Cáceres,Cáceres,21116,394151,31853,362298,394151,32102
2020/04/16,Cáceres,Toledo,128,694844,76577,618267,394151,32102
2020/04/16,Cáceres,Ávila,95,157640,13493,144147,394151,32102
2020/04/16,Cáceres,Badajoz,905,673559,64094,609465,394151,32102
2020/04/16,Cádiz,Málaga,947,1661785,158597,1503188,1240155,132718
2020/04/16,Cádiz,Sevilla,958,1942389,214293,1728096,1240155,132718
2020/04/16,Cádiz,Cádiz,106355,1240155,130217,1109938,1240155,132718
2020/04/16,Cádiz,Huelva,642,521870,54921,466949,1240155,132718
2020/04/16,Cantabria,Cantabria,53988,580795,74955,505840,580795,71452
2020/04/16,Cantabria,Palencia,69,160866,17379,143487,580795,71452
2020/04/16,Cantabria,Asturias,166,1022800,121018,901782,580795,71452
2020/04/16,Cantabria,Burgos,36,357072,35651,321421,580795,71452
2020/04/16,Cantabria,Bizkaia,446,1152934,173064,979870,580795,71452
2020/04/16,Castellón,Tarragona,719,804664,84482,720182,579962,70084
2020/04/16,Castellón,Valencia,577,2565124,351254,2213870,579962,70084
2020/04/16,Castellón,Castellón,49838,579962,67748,512214,579962,70084
2020/04/16,Castellón,Teruel,58,134137,8653,125484,579962,70084
2020/04/16,Ceuta,Ceuta,8239,84777,8611,76166,84777,8651
2020/04/16,Ciudad Real,Badajoz,47,673559,64094,609465,495761,33782
2020/04/16,Ciudad Real,Albacete,398,388167,28554,359613,495761,33782
2020/04/16,Ciudad Real,Ciudad Real,20455,495761,35552,460209,495761,33782
2020/04/16,Ciudad Real,Córdoba,383,782979,83325,699654,495761,33782
2020/04/16,Ciudad Real,Toledo,150,694844,76577,618267,495761,33782
2020/04/16,Córdoba,Granada,143,914678,98517,816161,782979,81742
2020/04/16,Córdoba,Jaén,653,633564,55731,577833,782979,81742
2020/04/16,Córdoba,Málaga,112,1661785,158597,1503188,782979,81742
2020/04/16,Córdoba,Córdoba,57872,782979,83325,699654,782979,81742
2020/04/16,Córdoba,Badajoz,73,673559,64094,609465,782979,81742
2020/04/16,Córdoba,Sevilla,1391,1942389,214293,1728096,782979,81742
2020/04/16,Córdoba,Ciudad Real,237,495761,35552,460209,782979,81742
2020/04/16,Coruña,Pontevedra,4359,942665,126532,816133,1119596,144743
2020/04/16,Coruña,Coruña,107780,1119596,143475,976121,1119596,144743
2020/04/16,Coruña,Lugo,534,329587,36221,293366,1119596,144743
2020/04/16,Cuenca,Toledo,109,694844,76577,618267,196329,15923
2020/04/16,Cuenca,Valencia,39,2565124,351254,2213870,196329,15923
2020/04/16,Cuenca,Cuenca,7518,196329,15324,181005,196329,15923
2020/04/16,Cuenca,Albacete,549,388167,28554,359613,196329,15923
2020/04/16,Cuenca,Ciudad Real,36,495761,35552,460209,196329,15923
2020/04/16,Cuenca,Madrid,63,6663394,806557,5856837,196329,15923
2020/04/16,Gipuzkoa,Navarra,215,654183,82690,571493,723576,89504
2020/04/16,Gipuzkoa,Bizkaia,1098,1152934,173064,979870,723576,89504
2020/04/16,Gipuzkoa,Araba,96,331549,45491,286058,723576,89504
2020/04/16,Gipuzkoa,Gipuzkoa,64631,723576,86390,637186,723576,89504
2020/04/16,Girona,Barcelona,2214,5664579,728999,4935580,771044,79981
2020/04/16,Girona,Lleida,141,434930,51022,383908,771044,79981
2020/04/16,Girona,Girona,50137,771044,75767,695277,771044,79981
2020/04/16,Granada,Málaga,94,1661785,158597,1503188,914678,96528
2020/04/16,Granada,Córdoba,246,782979,83325,699654,914678,96528
2020/04/16,Granada,Granada,70660,914678,98517,816161,914678,96528
2020/04/16,Granada,Almería,394,716820,76447,640373,914678,96528
2020/04/16,Granada,Jaén,346,633564,55731,577833,914678,96528
2020/04/16,Guadalajara,Cuenca,35,196329,15324,181005,257762,29922
2020/04/16,Guadalajara,Madrid,1621,6663394,806557,5856837,257762,29922
2020/04/16,Guadalajara,Guadalajara,16905,257762,29101,228661,257762,29922
2020/04/16,Huelva,Zaragoza,21,964724,129809,834915,521870,57076
2020/04/16,Huelva,Sevilla,1019,1942389,214293,1728096,521870,57076
2020/04/16,Huelva,Cádiz,442,1240155,130217,1109938,521870,57076
2020/04/16,Huelva,Badajoz,253,673559,64094,609465,521870,57076
2020/04/16,Huelva,Huelva,41289,521870,54921,466949,521870,57076
2020/04/16,Huesca,Lleida,692,434930,51022,383908,220461,25069
2020/04/16,Huesca,Zaragoza,241,964724,129809,834915,220461,25069
2020/04/16,Huesca,Huesca,15105,220461,22690,197771,220461,25069
2020/04/16,Jaén,Albacete,17,388167,28554,359613,633564,54202
2020/04/16,Jaén,Jaén,38308,633564,55731,577833,633564,54202
2020/04/16,Jaén,Córdoba,659,782979,83325,699654,633564,54202
2020/04/16,Jaén,Granada,301,914678,98517,816161,633564,54202
2020/04/16,Las Palmas de Gran Canaria,Las Palmas de Gran Canaria,114917,1120406,127603,992803,1120406,126911
2020/04/16,León,Ourense,131,307651,41479,266172,460001,52502
2020/04/16,León,León,38955,460001,52966,407035,460001,52502
2020/04/16,León,Zamora,76,172539,17699,154840,460001,52502
2020/04/16,León,Valladolid,56,519546,61812,457734,460001,52502
2020/04/16,León,Palencia,80,160866,17379,143487,460001,52502
2020/04/16,León,Asturias,42,1022800,121018,901782,460001,52502
2020/04/16,Lleida,Huesca,510,220461,22690,197771,434930,48883
2020/04/16,Lleida,Barcelona,255,5664579,728999,4935580,434930,48883
2020/04/16,Lleida,Girona,106,771044,75767,695277,434930,48883
2020/04/16,Lleida,Lleida,31928,434930,51022,383908,434930,48883
2020/04/16,Lleida,Tarragona,34,804664,84482,720182,434930,48883
2020/04/16,Lleida,Zaragoza,65,964724,129809,834915,434930,48883
2020/04/16,Lugo,Ourense,122,307651,41479,266172,329587,37370
2020/04/16,Lugo,Coruña,522,1119596,143475,976121,329587,37370
2020/04/16,Lugo,Asturias,636,1022800,121018,901782,329587,37370
2020/04/16,Lugo,Lugo,25267,329587,36221,293366,329587,37370
2020/04/16,Lugo,Pontevedra,27,942665,126532,816133,329587,37370
2020/04/16,Madrid,Cuenca,62,196329,15324,181005,6663394,811214
2020/04/16,Madrid,Ávila,100,157640,13493,144147,6663394,811214
2020/04/16,Madrid,Guadalajara,2039,257762,29101,228661,6663394,811214
2020/04/16,Madrid,Toledo,3155,694844,76577,618267,6663394,811214
2020/04/16,Madrid,Madrid,480999,6663394,806557,5856837,6663394,811214
2020/04/16,Málaga,Córdoba,299,782979,83325,699654,1661785,161620
2020/04/16,Málaga,Granada,174,914678,98517,816161,1661785,161620
2020/04/16,Málaga,Cádiz,719,1240155,130217,1109938,1661785,161620
2020/04/16,Málaga,Málaga,124119,1661785,158597,1503188,1661785,161620
2020/04/16,Málaga,Sevilla,216,1942389,214293,1728096,1661785,161620
2020/04/16,Melilla,Melilla,10545,86487,10872,75615,86487,10710
2020/04/16,Murcia,Albacete,275,388167,28554,359613,1493898,175900
2020/04/16,Murcia,Granada,27,914678,98517,816161,1493898,175900
2020/04/16,Murcia,Alicante,2053,1858683,225296,1633387,1493898,175900
2020/04/16,Murcia,Murcia,133763,1493898,178868,1315030,1493898,175900
2020/04/16,Murcia,Almería,1144,716820,76447,640373,1493898,175900
2020/04/16,Navarra,Rioja,1944,316798,38225,278573,654183,82803
2020/04/16,Navarra,Zaragoza,541,964724,129809,834915,654183,82803
2020/04/16,Navarra,Navarra,57293,654183,82690,571493,654183,82803
2020/04/16,Navarra,Gipuzkoa,245,723576,86390,637186,654183,82803
2020/04/16,Navarra,Araba,17,331549,45491,286058,654183,82803
2020/04/16,Ourense,Lugo,110,329587,36221,293366,307651,41335
2020/04/16,Ourense,Zamora,24,172539,17699,154840,307651,41335
2020/04/16,Ourense,Ourense,31606,307651,41479,266172,307651,41335
2020/04/16,Ourense,Pontevedra,145,942665,126532,816133,307651,41335
2020/04/16,Ourense,León,91,460001,52966,407035,307651,41335
2020/04/16,Palencia,Palencia,12222,160866,17379,143487,160866,18350
2020/04/16,Palencia,León,22,460001,52966,407035,160866,18350
2020/04/16,Palencia,Burgos,168,357072,35651,321421,160866,18350
2020/04/16,Palencia,Valladolid,24,519546,61812,457734,160866,18350
2020/04/16,Palencia,Cantabria,149,580795,74955,505840,160866,18350
2020/04/16,Pontevedra,Ourense,211,307651,41479,266172,942665,125830
2020/04/16,Pontevedra,Coruña,3616,1119596,143475,976121,942665,125830
2020/04/16,Pontevedra,Pontevedra,96028,942665,126532,816133,942665,125830
2020/04/16,Pontevedra,Lugo,24,329587,36221,293366,942665,125830
2020/04/16,Rioja,Rioja,26761,316798,38225,278573,316798,36645
2020/04/16,Rioja,Navarra,2058,654183,82690,571493,316798,36645
2020/04/16,Rioja,Araba,477,331549,45491,286058,316798,36645
2020/04/16,Salamanca,Ávila,141,157640,13493,144147,330119,36909
2020/04/16,Salamanca,Salamanca,29054,330119,37343,292776,330119,36909
2020/04/16,Santa Cruz de Tenerife,Santa Cruz de Tenerife,107648,1032983,122142,910841,1032983,121858
2020/04/16,Santa Cruz de Tenerife,Las Palmas de Gran Canaria,106,1120406,127603,992803,1032983,121858
2020/04/16,Segovia,Segovia,10349,153129,15960,137169,153129,16897
2020/04/16,Segovia,Burgos,27,357072,35651,321421,153129,16897
2020/04/16,Segovia,Valladolid,190,519546,61812,457734,153129,16897
2020/04/16,Segovia,Ávila,135,157640,13493,144147,153129,16897
2020/04/16,Sevilla,Málaga,114,1661785,158597,1503188,1942389,210953
2020/04/16,Sevilla,Córdoba,1630,782979,83325,699654,1942389,210953
2020/04/16,Sevilla,Badajoz,59,673559,64094,609465,1942389,210953
2020/04/16,Sevilla,Sevilla,144184,1942389,214293,1728096,1942389,210953
2020/04/16,Sevilla,Cádiz,754,1240155,130217,1109938,1942389,210953
2020/04/16,Sevilla,Huelva,298,521870,54921,466949,1942389,210953
2020/04/16,Soria,Valladolid,34,519546,61812,457734,88636,7166
2020/04/16,Soria,Burgos,57,357072,35651,321421,88636,7166
2020/04/16,Soria,Zaragoza,90,964724,129809,834915,88636,7166
2020/04/16,Soria,Soria,4552,88636,6456,82180,88636,7166
2020/04/16,Tarragona,Teruel,60,134137,8653,125484,804664,83657
2020/04/16,Tarragona,Lleida,31,434930,51022,383908,804664,83657
2020/04/16,Tarragona,Barcelona,739,5664579,728999,4935580,804664,83657
2020/04/16,Tarragona,Zaragoza,36,964724,129809,834915,804664,83657
2020/04/16,Tarragona,Tarragona,54961,804664,84482,720182,804664,83657
2020/04/16,Tarragona,Castellón,697,579962,67748,512214,804664,83657
2020/04/16,Teruel,Zaragoza,41,964724,129809,834915,134137,9917
2020/04/16,Teruel,Castellón,39,579962,67748,512214,134137,9917
2020/04/16,Teruel,Tarragona,87,804664,84482,720182,134137,9917
2020/04/16,Teruel,Teruel,4591,134137,8653,125484,134137,9917
2020/04/16,Toledo,Ávila,321,157640,13493,144147,694844,74474
2020/04/16,Toledo,Madrid,2981,6663394,806557,5856837,694844,74474
2020/04/16,Toledo,Toledo,40178,694844,76577,618267,694844,74474
2020/04/16,Toledo,Cuenca,28,196329,15324,181005,694844,74474
2020/04/16,Toledo,Ciudad Real,250,495761,35552,460209,694844,74474
2020/04/16,Toledo,Cáceres,152,394151,31853,362298,694844,74474
2020/04/16,Valencia,Valencia,240458,2565124,351254,2213870,2565124,343084
2020/04/16,Valencia,Castellón,582,579962,67748,512214,2565124,343084
2020/04/16,Valencia,Albacete,318,388167,28554,359613,2565124,343084
2020/04/16,Valencia,Alicante,989,1858683,225296,1633387,2565124,343084
2020/04/16,Valencia,Cuenca,86,196329,15324,181005,2565124,343084
2020/04/16,Valladolid,Zamora,42,172539,17699,154840,519546,59401
2020/04/16,Valladolid,León,43,460001,52966,407035,519546,59401
2020/04/16,Valladolid,Soria,28,88636,6456,82180,519546,59401
2020/04/16,Valladolid,Burgos,81,357072,35651,321421,519546,59401
2020/04/16,Valladolid,Segovia,192,153129,15960,137169,519546,59401
2020/04/16,Valladolid,Valladolid,42989,519546,61812,457734,519546,59401
2020/04/16,Valladolid,Palencia,31,160866,17379,143487,519546,59401
2020/04/16,Zamora,Ourense,60,307651,41479,266172,172539,17705
2020/04/16,Zamora,Valladolid,19,519546,61812,457734,172539,17705
2020/04/16,Zamora,Zamora,12037,172539,17699,154840,172539,17705
2020/04/16,Zamora,León,80,460001,52966,407035,172539,17705
2020/04/16,Zaragoza,Huesca,214,220461,22690,197771,964724,124257
2020/04/16,Zaragoza,Zaragoza,96382,964724,129809,834915,964724,124257
2020/04/16,Zaragoza,Soria,72,88636,6456,82180,964724,124257
2020/04/16,Zaragoza,Teruel,136,134137,8653,125484,964724,124257
2020/04/16,Zaragoza,Navarra,409,654183,82690,571493,964724,124257
2020/04/16,Zaragoza,Huelva,20,521870,54921,466949,964724,124257
2020/04/16,Zaragoza,Lleida,86,434930,51022,383908,964724,124257
2020/04/17,Albacete,Murcia,205,1493898,170548,1323350,388167,28104
2020/04/17,Albacete,Ciudad Real,412,495761,35507,460254,388167,28104
2020/04/17,Albacete,Jaén,22,633564,51351,582213,388167,28104
2020/04/17,Albacete,Cuenca,434,196329,15352,180977,388167,28104
2020/04/17,Albacete,Alicante,164,1858683,221237,1637446,388167,28104
2020/04/17,Albacete,Albacete,17186,388167,27758,360409,388167,28104
2020/04/17,Albacete,Valencia,336,2565124,338553,2226571,388167,28104
2020/04/17,Alicante,Murcia,2662,1493898,170548,1323350,1858683,224704
2020/04/17,Alicante,Alicante,172096,1858683,221237,1637446,1858683,224704
2020/04/17,Alicante,Valencia,848,2565124,338553,2226571,1858683,224704
2020/04/17,Alicante,Albacete,283,388167,27758,360409,1858683,224704
2020/04/17,Almería,Granada,448,914678,93921,820757,716820,76646
2020/04/17,Almería,Murcia,1840,1493898,170548,1323350,716820,76646
2020/04/17,Almería,Almería,61138,716820,74604,642216,716820,76646
2020/04/17,Araba,Burgos,1187,357072,34301,322771,331549,48568
2020/04/17,Araba,Navarra,117,654183,78859,575324,331549,48568
2020/04/17,Araba,Rioja,1470,316798,37258,279540,331549,48568
2020/04/17,Araba,Araba,34486,331549,43064,288485,331549,48568
2020/04/17,Araba,Gipuzkoa,132,723576,79845,643731,331549,48568
2020/04/17,Araba,Bizkaia,963,1152934,164237,988697,331549,48568
2020/04/17,Asturias,Asturias,87666,1022800,114297,908503,1022800,114426
2020/04/17,Asturias,Lugo,770,329587,34952,294635,1022800,114426
2020/04/17,Asturias,Cantabria,144,580795,69145,511650,1022800,114426
2020/04/17,Asturias,León,32,460001,49526,410475,1022800,114426
2020/04/17,Ávila,Madrid,81,6663394,762905,5900489,157640,13245
2020/04/17,Ávila,Ávila,8090,157640,12702,144938,157640,13245
2020/04/17,Ávila,Segovia,75,153129,15036,138093,157640,13245
2020/04/17,Ávila,Toledo,340,694844,70339,624505,157640,13245
2020/04/17,Ávila,Salamanca,239,330119,35250,294869,157640,13245
2020/04/17,Ávila,Cáceres,106,394151,30815,363336,157640,13245
2020/04/17,Badajoz,Sevilla,30,1942389,198267,1744122,673559,61494
2020/04/17,Badajoz,Córdoba,52,782979,79353,703626,673559,61494
2020/04/17,Badajoz,Ciudad Real,33,495761,35507,460254,673559,61494
2020/04/17,Badajoz,Badajoz,44511,673559,62411,611148,673559,61494
2020/04/17,Badajoz,Cáceres,746,394151,30815,363336,673559,61494
2020/04/17,Badajoz,Huelva,145,521870,52680,469190,673559,61494
2020/04/17,Balears,Valencia,54,2565124,338553,2226571,1149460,108756
2020/04/17,Balears,Balears,90473,1149460,108014,1041446,1149460,108756
2020/04/17,Barcelona,Lleida,90,434930,49587,385343,5664579,685960
2020/04/17,Barcelona,Barcelona,424777,5664579,683828,4980751,5664579,685960
2020/04/17,Barcelona,Tarragona,995,804664,82280,722384,5664579,685960
2020/04/17,Barcelona,Girona,2040,771044,72053,698991,5664579,685960
2020/04/17,Bizkaia,Burgos,40,357072,34301,322771,1152934,161065
2020/04/17,Bizkaia,Bizkaia,119325,1152934,164237,988697,1152934,161065
2020/04/17,Bizkaia,Araba,536,331549,43064,288485,1152934,161065
2020/04/17,Bizkaia,Gipuzkoa,707,723576,79845,643731,1152934,161065
2020/04/17,Bizkaia,Cantabria,1500,580795,69145,511650,1152934,161065
2020/04/17,Burgos,Soria,31,88636,6397,82239,357072,34349
2020/04/17,Burgos,Bizkaia,44,1152934,164237,988697,357072,34349
2020/04/17,Burgos,Burgos,24718,357072,34301,322771,357072,34349
2020/04/17,Burgos,Valladolid,120,519546,59018,460528,357072,34349
2020/04/17,Burgos,Rioja,46,316798,37258,279540,357072,34349
2020/04/17,Burgos,Araba,637,331549,43064,288485,357072,34349
2020/04/17,Burgos,Palencia,205,160866,16172,144694,357072,34349
2020/04/17,Cáceres,Badajoz,938,673559,62411,611148,394151,30857
2020/04/17,Cáceres,Toledo,141,694844,70339,624505,394151,30857
2020/04/17,Cáceres,Ávila,102,157640,12702,144938,394151,30857
2020/04/17,Cáceres,Cáceres,19919,394151,30815,363336,394151,30857
2020/04/17,Cádiz,Huelva,630,521870,52680,469190,1240155,118982
2020/04/17,Cádiz,Málaga,873,1661785,150227,1511558,1240155,118982
2020/04/17,Cádiz,Cádiz,93845,1240155,117052,1123103,1240155,118982
2020/04/17,Cádiz,Sevilla,730,1942389,198267,1744122,1240155,118982
2020/04/17,Cantabria,Cantabria,48361,580795,69145,511650,580795,66216
2020/04/17,Cantabria,Palencia,61,160866,16172,144694,580795,66216
2020/04/17,Cantabria,Asturias,120,1022800,114297,908503,580795,66216
2020/04/17,Cantabria,Bizkaia,353,1152934,164237,988697,580795,66216
2020/04/17,Castellón,Tarragona,777,804664,82280,722384,579962,68918
2020/04/17,Castellón,Teruel,64,134137,8630,125507,579962,68918
2020/04/17,Castellón,Castellón,48302,579962,66632,513330,579962,68918
2020/04/17,Castellón,Valencia,619,2565124,338553,2226571,579962,68918
2020/04/17,Ceuta,Ceuta,7381,84777,7828,76949,84777,7800
2020/04/17,Ciudad Real,Albacete,303,388167,27758,360409,495761,33489
2020/04/17,Ciudad Real,Ciudad Real,20670,495761,35507,460254,495761,33489
2020/04/17,Ciudad Real,Melilla,20,86487,9836,76651,495761,33489
2020/04/17,Ciudad Real,Córdoba,386,782979,79353,703626,495761,33489
2020/04/17,Ciudad Real,Toledo,184,694844,70339,624505,495761,33489
2020/04/17,Ciudad Real,Badajoz,55,673559,62411,611148,495761,33489
2020/04/17,Ciudad Real,Cuenca,22,196329,15352,180977,495761,33489
2020/04/17,Córdoba,Badajoz,95,673559,62411,611148,782979,77835
2020/04/17,Córdoba,Ciudad Real,214,495761,35507,460254,782979,77835
2020/04/17,Córdoba,Melilla,20,86487,9836,76651,782979,77835
2020/04/17,Córdoba,Jaén,603,633564,51351,582213,782979,77835
2020/04/17,Córdoba,Córdoba,54660,782979,79353,703626,782979,77835
2020/04/17,Córdoba,Sevilla,1480,1942389,198267,1744122,782979,77835
2020/04/17,Córdoba,Granada,135,914678,93921,820757,782979,77835
2020/04/17,Córdoba,Málaga,142,1661785,150227,1511558,782979,77835
2020/04/17,Coruña,Lugo,500,329587,34952,294635,1119596,141257
2020/04/17,Coruña,Coruña,104688,1119596,139701,979895,1119596,141257
2020/04/17,Coruña,Pontevedra,4208,942665,124016,818649,1119596,141257
2020/04/17,Cuenca,Valencia,27,2565124,338553,2226571,196329,15871
2020/04/17,Cuenca,Cuenca,7578,196329,15352,180977,196329,15871
2020/04/17,Cuenca,Ciudad Real,105,495761,35507,460254,196329,15871
2020/04/17,Cuenca,Toledo,112,694844,70339,624505,196329,15871
2020/04/17,Cuenca,Madrid,66,6663394,762905,5900489,196329,15871
2020/04/17,Cuenca,Albacete,492,388167,27758,360409,196329,15871
2020/04/17,Cuenca,Guadalajara,16,257762,27901,229861,196329,15871
2020/04/17,Gipuzkoa,Araba,64,331549,43064,288485,723576,82956
2020/04/17,Gipuzkoa,Navarra,151,654183,78859,575324,723576,82956
2020/04/17,Gipuzkoa,Bizkaia,985,1152934,164237,988697,723576,82956
2020/04/17,Gipuzkoa,Gipuzkoa,58922,723576,79845,643731,723576,82956
2020/04/17,Gipuzkoa,Alicante,32,1858683,221237,1637446,723576,82956
2020/04/17,Girona,Lleida,106,434930,49587,385343,771044,75891
2020/04/17,Girona,Girona,47721,771044,72053,698991,771044,75891
2020/04/17,Girona,Barcelona,1959,5664579,683828,4980751,771044,75891
2020/04/17,Granada,Granada,67141,914678,93921,820757,914678,92230
2020/04/17,Granada,Córdoba,250,782979,79353,703626,914678,92230
2020/04/17,Granada,Jaén,320,633564,51351,582213,914678,92230
2020/04/17,Granada,Almería,254,716820,74604,642216,914678,92230
2020/04/17,Granada,Málaga,97,1661785,150227,1511558,914678,92230
2020/04/17,Guadalajara,Madrid,1715,6663394,762905,5900489,257762,28764
2020/04/17,Guadalajara,Cuenca,40,196329,15352,180977,257762,28764
2020/04/17,Guadalajara,Guadalajara,16117,257762,27901,229861,257762,28764
2020/04/17,Huelva,Sevilla,1105,1942389,198267,1744122,521870,54768
2020/04/17,Huelva,Badajoz,293,673559,62411,611148,521870,54768
2020/04/17,Huelva,Huelva,39403,521870,52680,469190,521870,54768
2020/04/17,Huelva,Cádiz,503,1240155,117052,1123103,521870,54768
2020/04/17,Huesca,Huesca,14338,220461,21733,198728,220461,24084
2020/04/17,Huesca,Lleida,779,434930,49587,385343,220461,24084
2020/04/17,Huesca,Zaragoza,200,964724,123507,841217,220461,24084
2020/04/17,Jaén,Córdoba,751,782979,79353,703626,633564,50355
2020/04/17,Jaén,Granada,268,914678,93921,820757,633564,50355
2020/04/17,Jaén,Jaén,34362,633564,51351,582213,633564,50355
2020/04/17,Las Palmas de Gran Canaria,Las Palmas de Gran Canaria,105489,1120406,118660,1001746,1120406,117596
2020/04/17,León,Palencia,36,160866,16172,144694,460001,48874
2020/04/17,León,Asturias,24,1022800,114297,908503,460001,48874
2020/04/17,León,Zamora,74,172539,16643,155896,460001,48874
2020/04/17,León,Ourense,125,307651,39150,268501,460001,48874
2020/04/17,León,León,35996,460001,49526,410475,460001,48874
2020/04/17,Lleida,Huesca,585,220461,21733,198728,434930,47170
2020/04/17,Lleida,Lleida,30546,434930,49587,385343,434930,47170
2020/04/17,Lleida,Zaragoza,123,964724,123507,841217,434930,47170
2020/04/17,Lleida,Barcelona,214,5664579,683828,4980751,434930,47170
2020/04/17,Lleida,Girona,85,771044,72053,698991,434930,47170
2020/04/17,Lleida,Tarragona,28,804664,82280,722384,434930,47170
2020/04/17,Lugo,Asturias,610,1022800,114297,908503,329587,35856
2020/04/17,Lugo,Lugo,24215,329587,34952,294635,329587,35856
2020/04/17,Lugo,Ourense,55,307651,39150,268501,329587,35856
2020/04/17,Lugo,Coruña,473,1119596,139701,979895,329587,35856
2020/04/17,Lugo,León,17,460001,49526,410475,329587,35856
2020/04/17,Madrid,Cuenca,66,196329,15352,180977,6663394,766303
2020/04/17,Madrid,Ávila,135,157640,12702,144938,6663394,766303
2020/04/17,Madrid,Segovia,35,153129,15036,138093,6663394,766303
2020/04/17,Madrid,Toledo,2954,694844,70339,624505,6663394,766303
2020/04/17,Madrid,Guadalajara,1820,257762,27901,229861,6663394,766303
2020/04/17,Madrid,Madrid,439049,6663394,762905,5900489,6663394,766303
2020/04/17,Málaga,Cádiz,690,1240155,117052,1123103,1661785,152703
2020/04/17,Málaga,Sevilla,246,1942389,198267,1744122,1661785,152703
2020/04/17,Málaga,Córdoba,168,782979,79353,703626,1661785,152703
2020/04/17,Málaga,Málaga,116252,1661785,150227,1511558,1661785,152703
2020/04/17,Málaga,Granada,150,914678,93921,820757,1661785,152703
2020/04/17,Melilla,Melilla,9576,86487,9836,76651,86487,9776
2020/04/17,Murcia,Albacete,232,388167,27758,360409,1493898,167754
2020/04/17,Murcia,Almería,1174,716820,74604,642216,1493898,167754
2020/04/17,Murcia,Alicante,2283,1858683,221237,1637446,1493898,167754
2020/04/17,Murcia,Granada,21,914678,93921,820757,1493898,167754
2020/04/17,Murcia,Murcia,126759,1493898,170548,1323350,1493898,167754
2020/04/17,Navarra,Zaragoza,577,964724,123507,841217,654183,79774
2020/04/17,Navarra,Gipuzkoa,253,723576,79845,643731,654183,79774
2020/04/17,Navarra,Navarra,53633,654183,78859,575324,654183,79774
2020/04/17,Navarra,Rioja,2106,316798,37258,279540,654183,79774
2020/04/17,Navarra,Alicante,32,1858683,221237,1637446,654183,79774
2020/04/17,Ourense,Ourense,29866,307651,39150,268501,307651,39221
2020/04/17,Ourense,Zamora,34,172539,16643,155896,307651,39221
2020/04/17,Ourense,Pontevedra,119,942665,124016,818649,307651,39221
2020/04/17,Ourense,Lugo,72,329587,34952,294635,307651,39221
2020/04/17,Ourense,León,130,460001,49526,410475,307651,39221
2020/04/17,Palencia,Burgos,146,357072,34301,322771,160866,17009
2020/04/17,Palencia,Cantabria,78,580795,69145,511650,160866,17009
2020/04/17,Palencia,Palencia,11131,160866,16172,144694,160866,17009
2020/04/17,Palencia,Valladolid,56,519546,59018,460528,160866,17009
2020/04/17,Pontevedra,Ourense,140,307651,39150,268501,942665,123434
2020/04/17,Pontevedra,Lugo,29,329587,34952,294635,942665,123434
2020/04/17,Pontevedra,Pontevedra,94311,942665,124016,818649,942665,123434
2020/04/17,Pontevedra,Coruña,3576,1119596,139701,979895,942665,123434
2020/04/17,Rioja,Araba,420,331549,43064,288485,316798,35126
2020/04/17,Rioja,Rioja,25659,316798,37258,279540,316798,35126
2020/04/17,Rioja,Navarra,1775,654183,78859,575324,316798,35126
2020/04/17,Rioja,Burgos,24,357072,34301,322771,316798,35126
2020/04/17,Salamanca,Ávila,174,157640,12702,144938,330119,34630
2020/04/17,Salamanca,Salamanca,27091,330119,35250,294869,330119,34630
2020/04/17,Santa Cruz de Tenerife,Santa Cruz de Tenerife,97998,1032983,112259,920724,1032983,111959
2020/04/17,Santa Cruz de Tenerife,Las Palmas de Gran Canaria,137,1120406,118660,1001746,1032983,111959
2020/04/17,Segovia,Soria,24,88636,6397,82239,153129,16329
2020/04/17,Segovia,Burgos,80,357072,34301,322771,153129,16329
2020/04/17,Segovia,Ávila,127,157640,12702,144938,153129,16329
2020/04/17,Segovia,Valladolid,228,519546,59018,460528,153129,16329
2020/04/17,Segovia,Segovia,9766,153129,15036,138093,153129,16329
2020/04/17,Sevilla,Córdoba,1552,782979,79353,703626,1942389,195324
2020/04/17,Sevilla,Huelva,295,521870,52680,469190,1942389,195324
2020/04/17,Sevilla,Badajoz,23,673559,62411,611148,1942389,195324
2020/04/17,Sevilla,Sevilla,129700,1942389,198267,1744122,1942389,195324
2020/04/17,Sevilla,Cádiz,487,1240155,117052,1123103,1942389,195324
2020/04/17,Sevilla,Málaga,97,1661785,150227,1511558,1942389,195324
2020/04/17,Soria,Segovia,19,153129,15036,138093,88636,6930
2020/04/17,Soria,Valladolid,62,519546,59018,460528,88636,6930
2020/04/17,Soria,Burgos,26,357072,34301,322771,88636,6930
2020/04/17,Soria,Zaragoza,127,964724,123507,841217,88636,6930
2020/04/17,Soria,Soria,4516,88636,6397,82239,88636,6930
2020/04/17,Tarragona,Tarragona,53027,804664,82280,722384,804664,81316
2020/04/17,Tarragona,Teruel,46,134137,8630,125507,804664,81316
2020/04/17,Tarragona,Barcelona,629,5664579,683828,4980751,804664,81316
2020/04/17,Tarragona,Zaragoza,34,964724,123507,841217,804664,81316
2020/04/17,Tarragona,Castellón,678,579962,66632,513330,804664,81316
2020/04/17,Teruel,Teruel,4729,134137,8630,125507,134137,9843
2020/04/17,Teruel,Tarragona,79,804664,82280,722384,134137,9843
2020/04/17,Teruel,Zaragoza,67,964724,123507,841217,134137,9843
2020/04/17,Teruel,Castellón,60,579962,66632,513330,134137,9843
2020/04/17,Toledo,Ávila,180,157640,12702,144938,694844,67348
2020/04/17,Toledo,Toledo,34558,694844,70339,624505,694844,67348
2020/04/17,Toledo,Ciudad Real,212,495761,35507,460254,694844,67348
2020/04/17,Toledo,Madrid,2607,6663394,762905,5900489,694844,67348
2020/04/17,Toledo,Cuenca,71,196329,15352,180977,694844,67348
2020/04/17,Toledo,Cáceres,97,394151,30815,363336,694844,67348
2020/04/17,Valencia,Cuenca,114,196329,15352,180977,2565124,330966
2020/04/17,Valencia,Alicante,987,1858683,221237,1637446,2565124,330966
2020/04/17,Valencia,Albacete,313,388167,27758,360409,2565124,330966
2020/04/17,Valencia,Castellón,465,579962,66632,513330,2565124,330966
2020/04/17,Valencia,Valencia,228847,2565124,338553,2226571,2565124,330966
2020/04/17,Valladolid,Burgos,90,357072,34301,322771,519546,57050
2020/04/17,Valladolid,Soria,38,88636,6397,82239,519546,57050
2020/04/17,Valladolid,Segovia,177,153129,15036,138093,519546,57050
2020/04/17,Valladolid,Zamora,66,172539,16643,155896,519546,57050
2020/04/17,Valladolid,Valladolid,40936,519546,59018,460528,519546,57050
2020/04/17,Zamora,Zamora,11129,172539,16643,155896,172539,16519
2020/04/17,Zamora,León,24,460001,49526,410475,172539,16519
2020/04/17,Zaragoza,Zaragoza,89390,964724,123507,841217,964724,118768
2020/04/17,Zaragoza,Soria,56,88636,6397,82239,964724,118768
2020/04/17,Zaragoza,Teruel,155,134137,8630,125507,964724,118768
2020/04/17,Zaragoza,Huesca,226,220461,21733,198728,964724,118768
2020/04/17,Zaragoza,Lleida,76,434930,49587,385343,964724,118768
2020/04/17,Zaragoza,Tarragona,33,804664,82280,722384,964724,118768
2020/04/17,Zaragoza,Navarra,325,654183,78859,575324,964724,118768
2020/04/17,Zaragoza,Huelva,18,521870,52680,469190,964724,118768
2020/04/18,Albacete,Albacete,12189,388167,19145,369022,388167,19154
2020/04/18,Albacete,Ciudad Real,321,495761,24106,471655,388167,19154
2020/04/18,Albacete,Murcia,200,1493898,119438,1374460,388167,19154
2020/04/18,Albacete,Cuenca,233,196329,9971,186358,388167,19154
2020/04/18,Albacete,Valencia,272,2565124,218121,2347003,388167,19154
2020/04/18,Albacete,Jaén,45,633564,38666,594898,388167,19154
2020/04/18,Albacete,Alicante,100,1858683,143553,1715130,388167,19154
2020/04/18,Alicante,Alicante,114347,1858683,143553,1715130,1858683,144268
2020/04/18,Alicante,Valencia,498,2565124,218121,2347003,1858683,144268
2020/04/18,Alicante,Albacete,154,388167,19145,369022,1858683,144268
2020/04/18,Alicante,Murcia,1850,1493898,119438,1374460,1858683,144268
2020/04/18,Almería,Almería,41169,716820,51896,664924,716820,52931
2020/04/18,Almería,Murcia,1169,1493898,119438,1374460,716820,52931
2020/04/18,Almería,Granada,234,914678,71126,843552,716820,52931
2020/04/18,Almería,Alicante,17,1858683,143553,1715130,716820,52931
2020/04/18,Araba,Gipuzkoa,51,723576,49225,674351,331549,28969
2020/04/18,Araba,Araba,22779,331549,28009,303540,331549,28969
2020/04/18,Araba,Bizkaia,372,1152934,111211,1041723,331549,28969
2020/04/18,Araba,Rioja,444,316798,22979,293819,331549,28969
2020/04/18,Araba,Burgos,548,357072,20821,336251,331549,28969
2020/04/18,Asturias,Cantabria,144,580795,47412,533383,1022800,77874
2020/04/18,Asturias,Lugo,565,329587,23563,306024,1022800,77874
2020/04/18,Asturias,Asturias,60530,1022800,77701,945099,1022800,77874
2020/04/18,Asturias,León,40,460001,35860,424141,1022800,77874
2020/04/18,Ávila,Toledo,264,694844,43615,651229,157640,9744
2020/04/18,Ávila,Ávila,6503,157640,9508,148132,157640,9744
2020/04/18,Ávila,Salamanca,155,330119,25905,304214,157640,9744
2020/04/18,Ávila,Segovia,49,153129,10391,142738,157640,9744
2020/04/18,Ávila,Cáceres,90,394151,22763,371388,157640,9744
2020/04/18,Ávila,Madrid,74,6663394,527239,6136155,157640,9744
2020/04/18,Badajoz,Córdoba,84,782979,61680,721299,673559,46640
2020/04/18,Badajoz,Cáceres,582,394151,22763,371388,673559,46640
2020/04/18,Badajoz,Badajoz,35090,673559,47009,626550,673559,46640
2020/04/18,Badajoz,Sevilla,46,1942389,144754,1797635,673559,46640
2020/04/18,Badajoz,Huelva,150,521870,40542,481328,673559,46640
2020/04/18,Badajoz,Ciudad Real,45,495761,24106,471655,673559,46640
2020/04/18,Balears,Balears,53918,1149460,66584,1082876,1149460,67053
2020/04/18,Balears,Valencia,17,2565124,218121,2347003,1149460,67053
2020/04/18,Barcelona,Barcelona,340800,5664579,483936,5180643,5664579,485822
2020/04/18,Barcelona,Girona,1591,771044,47743,723301,5664579,485822
2020/04/18,Barcelona,Tarragona,516,804664,57944,746720,5664579,485822
2020/04/18,Barcelona,Lleida,67,434930,34812,400118,5664579,485822
2020/04/18,Bizkaia,Cantabria,437,580795,47412,533383,1152934,110482
2020/04/18,Bizkaia,Gipuzkoa,350,723576,49225,674351,1152934,110482
2020/04/18,Bizkaia,Araba,367,331549,28009,303540,1152934,110482
2020/04/18,Bizkaia,Bizkaia,85339,1152934,111211,1041723,1152934,110482
2020/04/18,Burgos,Valladolid,61,519546,39251,480295,357072,20960
2020/04/18,Burgos,Araba,516,331549,28009,303540,357072,20960
2020/04/18,Burgos,Palencia,97,160866,11096,149770,357072,20960
2020/04/18,Burgos,Burgos,15302,357072,20821,336251,357072,20960
2020/04/18,Cáceres,Ávila,106,157640,9508,148132,394151,22715
2020/04/18,Cáceres,Cáceres,14731,394151,22763,371388,394151,22715
2020/04/18,Cáceres,Badajoz,702,673559,47009,626550,394151,22715
2020/04/18,Cáceres,Toledo,100,694844,43615,651229,394151,22715
2020/04/18,Cádiz,Cádiz,75824,1240155,90773,1149382,1240155,92170
2020/04/18,Cádiz,Huelva,541,521870,40542,481328,1240155,92170
2020/04/18,Cádiz,Málaga,549,1661785,103415,1558370,1240155,92170
2020/04/18,Cádiz,Sevilla,683,1942389,144754,1797635,1240155,92170
2020/04/18,Cantabria,Cantabria,35344,580795,47412,533383,580795,47690
2020/04/18,Cantabria,Palencia,30,160866,11096,149770,580795,47690
2020/04/18,Cantabria,Asturias,125,1022800,77701,945099,580795,47690
2020/04/18,Cantabria,Bizkaia,295,1152934,111211,1041723,580795,47690
2020/04/18,Castellón,Teruel,35,134137,4674,129463,579962,41195
2020/04/18,Castellón,Castellón,28842,579962,40985,538977,579962,41195
2020/04/18,Castellón,Valencia,427,2565124,218121,2347003,579962,41195
2020/04/18,Castellón,Tarragona,845,804664,57944,746720,579962,41195
2020/04/18,Ceuta,Ceuta,5575,84777,5917,78860,84777,5872
2020/04/18,Ciudad Real,Ciudad Real,14852,495761,24106,471655,495761,23738
2020/04/18,Ciudad Real,Córdoba,351,782979,61680,721299,495761,23738
2020/04/18,Ciudad Real,Jaén,38,633564,38666,594898,495761,23738
2020/04/18,Ciudad Real,Toledo,49,694844,43615,651229,495761,23738
2020/04/18,Ciudad Real,Badajoz,61,673559,47009,626550,495761,23738
2020/04/18,Ciudad Real,Albacete,325,388167,19145,369022,495761,23738
2020/04/18,Córdoba,Jaén,654,633564,38666,594898,782979,61054
2020/04/18,Córdoba,Ciudad Real,210,495761,24106,471655,782979,61054
2020/04/18,Córdoba,Málaga,210,1661785,103415,1558370,782979,61054
2020/04/18,Córdoba,Sevilla,1301,1942389,144754,1797635,782979,61054
2020/04/18,Córdoba,Badajoz,73,673559,47009,626550,782979,61054
2020/04/18,Córdoba,Granada,119,914678,71126,843552,782979,61054
2020/04/18,Córdoba,Córdoba,44303,782979,61680,721299,782979,61054
2020/04/18,Coruña,Coruña,71287,1119596,93838,1025758,1119596,94772
2020/04/18,Coruña,Lugo,284,329587,23563,306024,1119596,94772
2020/04/18,Coruña,Pontevedra,3196,942665,82074,860591,1119596,94772
2020/04/18,Cuenca,Toledo,76,694844,43615,651229,196329,9957
2020/04/18,Cuenca,Ciudad Real,54,495761,24106,471655,196329,9957
2020/04/18,Cuenca,Albacete,391,388167,19145,369022,196329,9957
2020/04/18,Cuenca,Cuenca,4955,196329,9971,186358,196329,9957
2020/04/18,Cuenca,Madrid,24,6663394,527239,6136155,196329,9957
2020/04/18,Cuenca,Guadalajara,33,257762,17403,240359,196329,9957
2020/04/18,Cuenca,Valencia,31,2565124,218121,2347003,196329,9957
2020/04/18,Gipuzkoa,Gipuzkoa,36957,723576,49225,674351,723576,49886
2020/04/18,Gipuzkoa,Bizkaia,507,1152934,111211,1041723,723576,49886
2020/04/18,Gipuzkoa,Navarra,73,654183,49165,605018,723576,49886
2020/04/18,Girona,Lleida,58,434930,34812,400118,771044,49401
2020/04/18,Girona,Barcelona,1207,5664579,483936,5180643,771044,49401
2020/04/18,Girona,Girona,32092,771044,47743,723301,771044,49401
2020/04/18,Granada,Jaén,364,633564,38666,594898,914678,71239
2020/04/18,Granada,Córdoba,291,782979,61680,721299,914678,71239
2020/04/18,Granada,Almería,280,716820,51896,664924,914678,71239
2020/04/18,Granada,Málaga,93,1661785,103415,1558370,914678,71239
2020/04/18,Granada,Granada,52807,914678,71126,843552,914678,71239
2020/04/18,Guadalajara,Madrid,940,6663394,527239,6136155,257762,17067
2020/04/18,Guadalajara,Cuenca,21,196329,9971,186358,257762,17067
2020/04/18,Guadalajara,Teruel,21,134137,4674,129463,257762,17067
2020/04/18,Guadalajara,Guadalajara,10700,257762,17403,240359,257762,17067
2020/04/18,Huelva,Sevilla,937,1942389,144754,1797635,521870,41197
2020/04/18,Huelva,Huelva,30106,521870,40542,481328,521870,41197
2020/04/18,Huelva,Badajoz,266,673559,47009,626550,521870,41197
2020/04/18,Huelva,Cádiz,446,1240155,90773,1149382,521870,41197
2020/04/18,Huesca,Lleida,488,434930,34812,400118,220461,14557
2020/04/18,Huesca,Zaragoza,154,964724,79615,885109,220461,14557
2020/04/18,Huesca,Huesca,9510,220461,14077,206384,220461,14557
2020/04/18,Jaén,Jaén,27514,633564,38666,594898,633564,38092
2020/04/18,Jaén,Córdoba,696,782979,61680,721299,633564,38092
2020/04/18,Jaén,Granada,347,914678,71126,843552,633564,38092
2020/04/18,Jaén,Albacete,18,388167,19145,369022,633564,38092
2020/04/18,Las Palmas de Gran Canaria,Las Palmas de Gran Canaria,67259,1120406,80902,1039504,1120406,80233
2020/04/18,León,León,26388,460001,35860,424141,460001,35424
2020/04/18,León,Zamora,26,172539,11743,160796,460001,35424
2020/04/18,León,Asturias,35,1022800,77701,945099,460001,35424
2020/04/18,León,Ourense,47,307651,28708,278943,460001,35424
2020/04/18,León,Palencia,23,160866,11096,149770,460001,35424
2020/04/18,Lleida,Girona,52,771044,47743,723301,434930,33678
2020/04/18,Lleida,Lleida,22831,434930,34812,400118,434930,33678
2020/04/18,Lleida,Huesca,348,220461,14077,206384,434930,33678
2020/04/18,Lleida,Barcelona,102,5664579,483936,5180643,434930,33678
2020/04/18,Lleida,Zaragoza,42,964724,79615,885109,434930,33678
2020/04/18,Lugo,Ourense,36,307651,28708,278943,329587,24017
2020/04/18,Lugo,Coruña,400,1119596,93838,1025758,329587,24017
2020/04/18,Lugo,Lugo,16747,329587,23563,306024,329587,24017
2020/04/18,Lugo,Asturias,512,1022800,77701,945099,329587,24017
2020/04/18,Madrid,Melilla,20,86487,8031,78456,6663394,528122
2020/04/18,Madrid,Ávila,71,157640,9508,148132,6663394,528122
2020/04/18,Madrid,Cuenca,37,196329,9971,186358,6663394,528122
2020/04/18,Madrid,Guadalajara,990,257762,17403,240359,6663394,528122
2020/04/18,Madrid,Madrid,356970,6663394,527239,6136155,6663394,528122
2020/04/18,Madrid,Toledo,1780,694844,43615,651229,6663394,528122
2020/04/18,Málaga,Granada,68,914678,71126,843552,1661785,103620
2020/04/18,Málaga,Sevilla,236,1942389,144754,1797635,1661785,103620
2020/04/18,Málaga,Cádiz,479,1240155,90773,1149382,1661785,103620
2020/04/18,Málaga,Córdoba,257,782979,61680,721299,1661785,103620
2020/04/18,Málaga,Málaga,80748,1661785,103415,1558370,1661785,103620
2020/04/18,Melilla,Melilla,7744,86487,8031,78456,86487,7969
2020/04/18,Murcia,Murcia,89325,1493898,119438,1374460,1493898,118357
2020/04/18,Murcia,Alicante,1661,1858683,143553,1715130,1493898,118357
2020/04/18,Murcia,Albacete,191,388167,19145,369022,1493898,118357
2020/04/18,Murcia,Almería,769,716820,51896,664924,1493898,118357
2020/04/18,Navarra,Rioja,916,316798,22979,293819,654183,49200
2020/04/18,Navarra,Navarra,33847,654183,49165,605018,654183,49200
2020/04/18,Navarra,Zaragoza,296,964724,79615,885109,654183,49200
2020/04/18,Navarra,Araba,26,331549,28009,303540,654183,49200
2020/04/18,Navarra,Gipuzkoa,85,723576,49225,674351,654183,49200
2020/04/18,Ourense,Lugo,76,329587,23563,306024,307651,28803
2020/04/18,Ourense,Pontevedra,126,942665,82074,860591,307651,28803
2020/04/18,Ourense,León,68,460001,35860,424141,307651,28803
2020/04/18,Ourense,Ourense,22713,307651,28708,278943,307651,28803
2020/04/18,Palencia,Burgos,141,357072,20821,336251,160866,11158
2020/04/18,Palencia,Cantabria,44,580795,47412,533383,160866,11158
2020/04/18,Palencia,Palencia,7788,160866,11096,149770,160866,11158
2020/04/18,Pontevedra,Ourense,121,307651,28708,278943,942665,82249
2020/04/18,Pontevedra,Pontevedra,63088,942665,82074,860591,942665,82249
2020/04/18,Pontevedra,Coruña,2881,1119596,93838,1025758,942665,82249
2020/04/18,Rioja,Araba,403,331549,28009,303540,316798,22891
2020/04/18,Rioja,Rioja,16456,316798,22979,293819,316798,22891
2020/04/18,Rioja,Navarra,1189,654183,49165,605018,316798,22891
2020/04/18,Salamanca,Ávila,141,157640,9508,148132,330119,25613
2020/04/18,Salamanca,Salamanca,20060,330119,25905,304214,330119,25613
2020/04/18,Santa Cruz de Tenerife,Santa Cruz de Tenerife,63151,1032983,75386,957597,1032983,74909
2020/04/18,Santa Cruz de Tenerife,Melilla,26,86487,8031,78456,1032983,74909
2020/04/18,Segovia,Valladolid,127,519546,39251,480295,153129,10686
2020/04/18,Segovia,Segovia,7125,153129,10391,142738,153129,10686
2020/04/18,Segovia,Ávila,85,157640,9508,148132,153129,10686
2020/04/18,Segovia,Burgos,45,357072,20821,336251,153129,10686
2020/04/18,Sevilla,Huelva,314,521870,40542,481328,1942389,143481
2020/04/18,Sevilla,Málaga,75,1661785,103415,1558370,1942389,143481
2020/04/18,Sevilla,Córdoba,1515,782979,61680,721299,1942389,143481
2020/04/18,Sevilla,Sevilla,101207,1942389,144754,1797635,1942389,143481
2020/04/18,Sevilla,Badajoz,38,673559,47009,626550,1942389,143481
2020/04/18,Sevilla,Cádiz,477,1240155,90773,1149382,1942389,143481
2020/04/18,Soria,Soria,2700,88636,4097,84539,88636,3924
2020/04/18,Soria,Valladolid,32,519546,39251,480295,88636,3924
2020/04/18,Tarragona,Tarragona,39271,804664,57944,746720,804664,57077
2020/04/18,Tarragona,Castellón,402,579962,40985,538977,804664,57077
2020/04/18,Tarragona,Barcelona,497,5664579,483936,5180643,804664,57077
2020/04/18,Tarragona,Zaragoza,62,964724,79615,885109,804664,57077
2020/04/18,Teruel,Tarragona,46,804664,57944,746720,134137,4748
2020/04/18,Teruel,Zaragoza,16,964724,79615,885109,134137,4748
2020/04/18,Teruel,Teruel,2174,134137,4674,129463,134137,4748
2020/04/18,Toledo,Ávila,114,157640,9508,148132,694844,42781
2020/04/18,Toledo,Cáceres,100,394151,22763,371388,694844,42781
2020/04/18,Toledo,Ciudad Real,101,495761,24106,471655,694844,42781
2020/04/18,Toledo,Toledo,24066,694844,43615,651229,694844,42781
2020/04/18,Toledo,Madrid,1646,6663394,527239,6136155,694844,42781
2020/04/18,Valencia,Alicante,434,1858683,143553,1715130,2565124,217118
2020/04/18,Valencia,Castellón,411,579962,40985,538977,2565124,217118
2020/04/18,Valencia,Cuenca,84,196329,9971,186358,2565124,217118
2020/04/18,Valencia,Valencia,155318,2565124,218121,2347003,2565124,217118
2020/04/18,Valencia,Albacete,223,388167,19145,369022,2565124,217118
2020/04/18,Valladolid,Valladolid,27419,519546,39251,480295,519546,38746
2020/04/18,Valladolid,Soria,26,88636,4097,84539,519546,38746
2020/04/18,Valladolid,Segovia,90,153129,10391,142738,519546,38746
2020/04/18,Valladolid,Burgos,52,357072,20821,336251,519546,38746
2020/04/18,Valladolid,Ávila,22,157640,9508,148132,519546,38746
2020/04/18,Zamora,Zamora,8137,172539,11743,160796,172539,11564
2020/04/18,Zamora,Salamanca,18,330119,25905,304214,172539,11564
2020/04/18,Zamora,Valladolid,27,519546,39251,480295,172539,11564
2020/04/18,Zaragoza,Navarra,229,654183,49165,605018,964724,77486
2020/04/18,Zaragoza,Huesca,124,220461,14077,206384,964724,77486
2020/04/18,Zaragoza,Zaragoza,57517,964724,79615,885109,964724,77486
2020/04/18,Zaragoza,Lleida,77,434930,34812,400118,964724,77486
2020/04/18,Zaragoza,Teruel,26,134137,4674,129463,964724,77486
2020/04/19,Albacete,Ciudad Real,254,495761,17008,478753,388167,13228
2020/04/19,Albacete,Alicante,79,1858683,106406,1752277,388167,13228
2020/04/19,Albacete,Albacete,8598,388167,13306,374861,388167,13228
2020/04/19,Albacete,Cuenca,100,196329,6456,189873,388167,13228
2020/04/19,Albacete,Valencia,230,2565124,161324,2403800,388167,13228
2020/04/19,Albacete,Murcia,52,1493898,78697,1415201,388167,13228
2020/04/19,Albacete,Jaén,42,633564,28905,604659,388167,13228
2020/04/19,Alicante,Valencia,374,2565124,161324,2403800,1858683,106143
2020/04/19,Alicante,Alicante,87794,1858683,106406,1752277,1858683,106143
2020/04/19,Alicante,Albacete,90,388167,13306,374861,1858683,106143
2020/04/19,Alicante,Murcia,1278,1493898,78697,1415201,1858683,106143
2020/04/19,Almería,Almería,23580,716820,31056,685764,716820,30120
2020/04/19,Almería,Granada,116,914678,54061,860617,716820,30120
2020/04/19,Almería,Murcia,293,1493898,78697,1415201,716820,30120
2020/04/19,Araba,Rioja,253,316798,15387,301411,331549,21653
2020/04/19,Araba,Araba,17253,331549,20894,310655,331549,21653
2020/04/19,Araba,Bizkaia,282,1152934,86754,1066180,331549,21653
2020/04/19,Araba,Burgos,385,357072,14432,342640,331549,21653
2020/04/19,Asturias,Asturias,43149,1022800,56317,966483,1022800,56152
2020/04/19,Asturias,Lugo,462,329587,18501,311086,1022800,56152
2020/04/19,Asturias,Cantabria,79,580795,34523,546272,1022800,56152
2020/04/19,Asturias,León,21,460001,26221,433780,1022800,56152
2020/04/19,Ávila,Cáceres,81,394151,18006,376145,157640,7375
2020/04/19,Ávila,Salamanca,136,330119,20287,309832,157640,7375
2020/04/19,Ávila,Madrid,51,6663394,425636,6237758,157640,7375
2020/04/19,Ávila,Toledo,99,694844,31713,663131,157640,7375
2020/04/19,Ávila,Ávila,4975,157640,7212,150428,157640,7375
2020/04/19,Ávila,Segovia,44,153129,7594,145535,157640,7375
2020/04/19,Badajoz,Badajoz,25969,673559,35152,638407,673559,34528
2020/04/19,Badajoz,Ciudad Real,36,495761,17008,478753,673559,34528
2020/04/19,Badajoz,Cáceres,485,394151,18006,376145,673559,34528
2020/04/19,Badajoz,Córdoba,32,782979,47163,735816,673559,34528
2020/04/19,Badajoz,Huelva,117,521870,30879,490991,673559,34528
2020/04/19,Balears,Balears,34950,1149460,45061,1104399,1149460,44982
2020/04/19,Barcelona,Girona,997,771044,33672,737372,5664579,365510
2020/04/19,Barcelona,Lleida,30,434930,23746,411184,5664579,365510
2020/04/19,Barcelona,Tarragona,435,804664,40969,763695,5664579,365510
2020/04/19,Barcelona,Barcelona,268145,5664579,363722,5300857,5664579,365510
2020/04/19,Bizkaia,Gipuzkoa,245,723576,34705,688871,1152934,86436
2020/04/19,Bizkaia,Alicante,33,1858683,106406,1752277,1152934,86436
2020/04/19,Bizkaia,Bizkaia,68980,1152934,86754,1066180,1152934,86436
2020/04/19,Bizkaia,Araba,272,331549,20894,310655,1152934,86436
2020/04/19,Bizkaia,Cantabria,275,580795,34523,546272,1152934,86436
2020/04/19,Burgos,Burgos,10488,357072,14432,342640,357072,14672
2020/04/19,Burgos,Palencia,123,160866,7972,152894,357072,14672
2020/04/19,Burgos,Valladolid,69,519546,28810,490736,357072,14672
2020/04/19,Burgos,Araba,393,331549,20894,310655,357072,14672
2020/04/19,Cáceres,Cáceres,11711,394151,18006,376145,394151,17667
2020/04/19,Cáceres,Badajoz,452,673559,35152,638407,394151,17667
2020/04/19,Cáceres,Ávila,59,157640,7212,150428,394151,17667
2020/04/19,Cáceres,Toledo,73,694844,31713,663131,394151,17667
2020/04/19,Cádiz,Málaga,403,1661785,75747,1586038,1240155,70341
2020/04/19,Cádiz,Sevilla,534,1942389,108038,1834351,1240155,70341
2020/04/19,Cádiz,Cádiz,57589,1240155,69511,1170644,1240155,70341
2020/04/19,Cádiz,Huelva,446,521870,30879,490991,1240155,70341
2020/04/19,Cantabria,Cantabria,25970,580795,34523,546272,580795,34586
2020/04/19,Cantabria,Asturias,87,1022800,56317,966483,580795,34586
2020/04/19,Cantabria,Bizkaia,274,1152934,86754,1066180,580795,34586
2020/04/19,Castellón,Valencia,397,2565124,161324,2403800,579962,29328
2020/04/19,Castellón,Tarragona,408,804664,40969,763695,579962,29328
2020/04/19,Castellón,Castellón,20134,579962,28730,551232,579962,29328
2020/04/19,Ceuta,Ceuta,4335,84777,4675,80102,84777,4631
2020/04/19,Ciudad Real,Albacete,246,388167,13306,374861,495761,16804
2020/04/19,Ciudad Real,Badajoz,45,673559,35152,638407,495761,16804
2020/04/19,Ciudad Real,Córdoba,343,782979,47163,735816,495761,16804
2020/04/19,Ciudad Real,Melilla,18,86487,6409,80078,495761,16804
2020/04/19,Ciudad Real,Ciudad Real,10462,495761,17008,478753,495761,16804
2020/04/19,Córdoba,Córdoba,34538,782979,47163,735816,782979,46690
2020/04/19,Córdoba,Jaén,493,633564,28905,604659,782979,46690
2020/04/19,Córdoba,Granada,92,914678,54061,860617,782979,46690
2020/04/19,Córdoba,Sevilla,788,1942389,108038,1834351,782979,46690
2020/04/19,Córdoba,Málaga,61,1661785,75747,1586038,782979,46690
2020/04/19,Córdoba,Ciudad Real,172,495761,17008,478753,782979,46690
2020/04/19,Coruña,Pontevedra,2846,942665,63701,878964,1119596,71841
2020/04/19,Coruña,Lugo,239,329587,18501,311086,1119596,71841
2020/04/19,Coruña,Coruña,54292,1119596,71193,1048403,1119596,71841
2020/04/19,Cuenca,Toledo,76,694844,31713,663131,196329,6717
2020/04/19,Cuenca,Albacete,190,388167,13306,374861,196329,6717
2020/04/19,Cuenca,Cuenca,3349,196329,6456,189873,196329,6717
2020/04/19,Cuenca,Ciudad Real,41,495761,17008,478753,196329,6717
2020/04/19,Cuenca,Valencia,36,2565124,161324,2403800,196329,6717
2020/04/19,Cuenca,Madrid,27,6663394,425636,6237758,196329,6717
2020/04/19,Gipuzkoa,Navarra,114,654183,36883,617300,723576,35513
2020/04/19,Gipuzkoa,Gipuzkoa,26744,723576,34705,688871,723576,35513
2020/04/19,Gipuzkoa,Bizkaia,273,1152934,86754,1066180,723576,35513
2020/04/19,Girona,Barcelona,987,5664579,363722,5300857,771044,34584
2020/04/19,Girona,Lleida,74,434930,23746,411184,771044,34584
2020/04/19,Girona,Girona,22699,771044,33672,737372,771044,34584
2020/04/19,Girona,Tarragona,35,804664,40969,763695,771044,34584
2020/04/19,Granada,Jaén,259,633564,28905,604659,914678,53740
2020/04/19,Granada,Granada,40146,914678,54061,860617,914678,53740
2020/04/19,Granada,Córdoba,176,782979,47163,735816,914678,53740
2020/04/19,Granada,Málaga,85,1661785,75747,1586038,914678,53740
2020/04/19,Granada,Almería,155,716820,31056,685764,914678,53740
2020/04/19,Guadalajara,Madrid,635,6663394,425636,6237758,257762,13002
2020/04/19,Guadalajara,Guadalajara,8542,257762,13285,244477,257762,13002
2020/04/19,Huelva,Badajoz,198,673559,35152,638407,521870,30373
2020/04/19,Huelva,Cádiz,443,1240155,69511,1170644,521870,30373
2020/04/19,Huelva,Huelva,22112,521870,30879,490991,521870,30373
2020/04/19,Huelva,Sevilla,306,1942389,108038,1834351,521870,30373
2020/04/19,Huesca,Zaragoza,65,964724,57188,907536,220461,9821
2020/04/19,Huesca,Lleida,243,434930,23746,411184,220461,9821
2020/04/19,Huesca,Huesca,6371,220461,9596,210865,220461,9821
2020/04/19,Jaén,Córdoba,436,782979,47163,735816,633564,28382
2020/04/19,Jaén,Granada,245,914678,54061,860617,633564,28382
2020/04/19,Jaén,Jaén,20076,633564,28905,604659,633564,28382
2020/04/19,Las Palmas de Gran Canaria,Las Palmas de Gran Canaria,49011,1120406,60513,1059893,1120406,60203
2020/04/19,León,Asturias,31,1022800,56317,966483,460001,26221
2020/04/19,León,León,19360,460001,26221,433780,460001,26221
2020/04/19,León,Ourense,60,307651,22084,285567,460001,26221
2020/04/19,Lleida,Girona,48,771044,33672,737372,434930,23166
2020/04/19,Lleida,Barcelona,31,5664579,363722,5300857,434930,23166
2020/04/19,Lleida,Huesca,220,220461,9596,210865,434930,23166
2020/04/19,Lleida,Lleida,15357,434930,23746,411184,434930,23166
2020/04/19,Lleida,Zaragoza,42,964724,57188,907536,434930,23166
2020/04/19,Lugo,Lugo,12915,329587,18501,311086,329587,18443
2020/04/19,Lugo,Ourense,24,307651,22084,285567,329587,18443
2020/04/19,Lugo,Coruña,228,1119596,71193,1048403,329587,18443
2020/04/19,Lugo,Asturias,344,1022800,56317,966483,329587,18443
2020/04/19,Madrid,Toledo,1446,694844,31713,663131,6663394,428017
2020/04/19,Madrid,Madrid,305200,6663394,425636,6237758,6663394,428017
2020/04/19,Madrid,Tarragona,19,804664,40969,763695,6663394,428017
2020/04/19,Madrid,Guadalajara,780,257762,13285,244477,6663394,428017
2020/04/19,Madrid,Cuenca,43,196329,6456,189873,6663394,428017
2020/04/19,Málaga,Granada,54,914678,54061,860617,1661785,75330
2020/04/19,Málaga,Cádiz,370,1240155,69511,1170644,1661785,75330
2020/04/19,Málaga,Sevilla,34,1942389,108038,1834351,1661785,75330
2020/04/19,Málaga,Málaga,58726,1661785,75747,1586038,1661785,75330
2020/04/19,Málaga,Córdoba,94,782979,47163,735816,1661785,75330
2020/04/19,Melilla,Melilla,6154,86487,6409,80078,86487,6401
2020/04/19,Murcia,Murcia,60415,1493898,78697,1415201,1493898,78044
2020/04/19,Murcia,Alicante,1039,1858683,106406,1752277,1493898,78044
2020/04/19,Murcia,Albacete,91,388167,13306,374861,1493898,78044
2020/04/19,Murcia,Almería,376,716820,31056,685764,1493898,78044
2020/04/19,Navarra,Rioja,559,316798,15387,301411,654183,37264
2020/04/19,Navarra,Navarra,26221,654183,36883,617300,654183,37264
2020/04/19,Navarra,Gipuzkoa,79,723576,34705,688871,654183,37264
2020/04/19,Navarra,Zaragoza,193,964724,57188,907536,654183,37264
2020/04/19,Ourense,Ourense,17296,307651,22084,285567,307651,21978
2020/04/19,Ourense,Lugo,33,329587,18501,311086,307651,21978
2020/04/19,Ourense,León,94,460001,26221,433780,307651,21978
2020/04/19,Ourense,Pontevedra,96,942665,63701,878964,307651,21978
2020/04/19,Palencia,Palencia,5638,160866,7972,152894,160866,7996
2020/04/19,Palencia,Burgos,104,357072,14432,342640,160866,7996
2020/04/19,Pontevedra,Ourense,127,307651,22084,285567,942665,63378
2020/04/19,Pontevedra,Coruña,2416,1119596,71193,1048403,942665,63378
2020/04/19,Pontevedra,Pontevedra,49430,942665,63701,878964,942665,63378
2020/04/19,Rioja,Rioja,11080,316798,15387,301411,316798,15334
2020/04/19,Rioja,Araba,237,331549,20894,310655,316798,15334
2020/04/19,Rioja,Navarra,638,654183,36883,617300,316798,15334
2020/04/19,Salamanca,Salamanca,15601,330119,20287,309832,330119,20154
2020/04/19,Salamanca,Ávila,109,157640,7212,150428,330119,20154
2020/04/19,Santa Cruz de Tenerife,Santa Cruz de Tenerife,46675,1032983,56416,976567,1032983,56337
2020/04/19,Segovia,Valladolid,75,519546,28810,490736,153129,7649
2020/04/19,Segovia,Ávila,46,157640,7212,150428,153129,7649
2020/04/19,Segovia,Segovia,4949,153129,7594,145535,153129,7649
2020/04/19,Sevilla,Cádiz,451,1240155,69511,1170644,1942389,107766
2020/04/19,Sevilla,Málaga,52,1661785,75747,1586038,1942389,107766
2020/04/19,Sevilla,Córdoba,981,782979,47163,735816,1942389,107766
2020/04/19,Sevilla,Badajoz,29,673559,35152,638407,1942389,107766
2020/04/19,Sevilla,Huelva,180,521870,30879,490991,1942389,107766
2020/04/19,Sevilla,Sevilla,79094,1942389,108038,1834351,1942389,107766
2020/04/19,Soria,Valladolid,81,519546,28810,490736,88636,3010
2020/04/19,Soria,Soria,2031,88636,2830,85806,88636,3010
2020/04/19,Tarragona,Castellón,274,579962,28730,551232,804664,40436
2020/04/19,Tarragona,Barcelona,469,5664579,363722,5300857,804664,40436
2020/04/19,Tarragona,Tarragona,27561,804664,40969,763695,804664,40436
2020/04/19,Teruel,Castellón,28,579962,28730,551232,134137,3186
2020/04/19,Teruel,Tarragona,47,804664,40969,763695,134137,3186
2020/04/19,Teruel,Teruel,1363,134137,3076,131061,134137,3186
2020/04/19,Toledo,Madrid,1289,6663394,425636,6237758,694844,31092
2020/04/19,Toledo,Cuenca,40,196329,6456,189873,694844,31092
2020/04/19,Toledo,Ávila,145,157640,7212,150428,694844,31092
2020/04/19,Toledo,Ciudad Real,27,495761,17008,478753,694844,31092
2020/04/19,Toledo,Toledo,18061,694844,31713,663131,694844,31092
2020/04/19,Toledo,Cáceres,112,394151,18006,376145,694844,31092
2020/04/19,Valencia,Albacete,150,388167,13306,374861,2565124,160669
2020/04/19,Valencia,Castellón,283,579962,28730,551232,2565124,160669
2020/04/19,Valencia,Cuenca,34,196329,6456,189873,2565124,160669
2020/04/19,Valencia,Alicante,354,1858683,106406,1752277,2565124,160669
2020/04/19,Valencia,Valencia,122402,2565124,161324,2403800,2565124,160669
2020/04/19,Valladolid,Segovia,116,153129,7594,145535,519546,28819
2020/04/19,Valladolid,Burgos,128,357072,14432,342640,519546,28819
2020/04/19,Valladolid,Zamora,62,172539,8310,164229,519546,28819
2020/04/19,Valladolid,Soria,42,88636,2830,85806,519546,28819
2020/04/19,Valladolid,Ávila,21,157640,7212,150428,519546,28819
2020/04/19,Valladolid,Valladolid,20622,519546,28810,490736,519546,28819
2020/04/19,Zamora,Zamora,5838,172539,8310,164229,172539,8514
2020/04/19,Zamora,Salamanca,17,330119,20287,309832,172539,8514
2020/04/19,Zaragoza,Zaragoza,42196,964724,57188,907536,964724,56506
2020/04/19,Zaragoza,Navarra,181,654183,36883,617300,964724,56506
2020/04/19,Zaragoza,Lleida,63,434930,23746,411184,964724,56506
2020/04/19,Zaragoza,Huesca,62,220461,9596,210865,964724,56506
2020/04/20,Albacete,Albacete,15737,388167,27120,361047,388167,26182
2020/04/20,Albacete,Ciudad Real,426,495761,34905,460856,388167,26182
2020/04/20,Albacete,Alicante,93,1858683,197285,1661398,388167,26182
2020/04/20,Albacete,Murcia,245,1493898,165379,1328519,388167,26182
2020/04/20,Albacete,Cuenca,402,196329,14803,181526,388167,26182
2020/04/20,Albacete,Jaén,16,633564,49856,583708,388167,26182
2020/04/20,Albacete,Valencia,280,2565124,231204,2333920,388167,26182
2020/04/20,Alicante,Murcia,2435,1493898,165379,1328519,1858683,200038
2020/04/20,Alicante,Alicante,150477,1858683,197285,1661398,1858683,200038
2020/04/20,Alicante,Albacete,157,388167,27120,361047,1858683,200038
2020/04/20,Alicante,Valencia,756,2565124,231204,2333920,1858683,200038
2020/04/20,Almería,Murcia,1662,1493898,165379,1328519,716820,73929
2020/04/20,Almería,Granada,360,914678,91976,822702,716820,73929
2020/04/20,Almería,Almería,57708,716820,71457,645363,716820,73929
2020/04/20,Araba,Araba,33523,331549,41776,289773,331549,47884
2020/04/20,Araba,Gipuzkoa,112,723576,77838,645738,331549,47884
2020/04/20,Araba,Rioja,1452,316798,36064,280734,331549,47884
2020/04/20,Araba,Bizkaia,916,1152934,160698,992236,331549,47884
2020/04/20,Araba,Navarra,127,654183,75233,578950,331549,47884
2020/04/20,Araba,Burgos,1279,357072,33396,323676,331549,47884
2020/04/20,Asturias,Asturias,84790,1022800,112151,910649,1022800,110678
2020/04/20,Asturias,León,44,460001,50113,409888,1022800,110678
2020/04/20,Asturias,Cantabria,214,580795,67576,513219,1022800,110678
2020/04/20,Asturias,Lugo,819,329587,35430,294157,1022800,110678
2020/04/20,Ávila,Cáceres,109,394151,32532,361619,157640,13242
2020/04/20,Ávila,Segovia,67,153129,15150,137979,157640,13242
2020/04/20,Ávila,Ávila,7956,157640,13179,144461,157640,13242
2020/04/20,Ávila,Salamanca,312,330119,35466,294653,157640,13242
2020/04/20,Ávila,Madrid,24,6663394,737900,5925494,157640,13242
2020/04/20,Ávila,Toledo,199,694844,68607,626237,157640,13242
2020/04/20,Badajoz,Huelva,211,521870,53433,468437,673559,63363
2020/04/20,Badajoz,Sevilla,53,1942389,200732,1741657,673559,63363
2020/04/20,Badajoz,Badajoz,45368,673559,64976,608583,673559,63363
2020/04/20,Badajoz,Ciudad Real,39,495761,34905,460856,673559,63363
2020/04/20,Badajoz,Córdoba,40,782979,80473,702506,673559,63363
2020/04/20,Badajoz,Cáceres,816,394151,32532,361619,673559,63363
2020/04/20,Balears,Balears,84399,1149460,102014,1047446,1149460,102383
2020/04/20,Barcelona,Barcelona,395715,5664579,654616,5009963,5664579,655838
2020/04/20,Barcelona,Lleida,108,434930,45221,389709,5664579,655838
2020/04/20,Barcelona,Girona,1896,771044,69337,701707,5664579,655838
2020/04/20,Barcelona,Tarragona,832,804664,75908,728756,5664579,655838
2020/04/20,Bizkaia,Cantabria,1510,580795,67576,513219,1152934,157241
2020/04/20,Bizkaia,Bizkaia,115068,1152934,160698,992236,1152934,157241
2020/04/20,Bizkaia,Gipuzkoa,668,723576,77838,645738,1152934,157241
2020/04/20,Bizkaia,Burgos,25,357072,33396,323676,1152934,157241
2020/04/20,Bizkaia,Araba,490,331549,41776,289773,1152934,157241
2020/04/20,Burgos,Valladolid,163,519546,59136,460410,357072,34498
2020/04/20,Burgos,Burgos,23856,357072,33396,323676,357072,34498
2020/04/20,Burgos,Araba,610,331549,41776,289773,357072,34498
2020/04/20,Burgos,Segovia,40,153129,15150,137979,357072,34498
2020/04/20,Burgos,Rioja,48,316798,36064,280734,357072,34498
2020/04/20,Burgos,Soria,24,88636,6041,82595,357072,34498
2020/04/20,Burgos,Bizkaia,37,1152934,160698,992236,357072,34498
2020/04/20,Burgos,Palencia,188,160866,15915,144951,357072,34498
2020/04/20,Cáceres,Ávila,132,157640,13179,144461,394151,32712
2020/04/20,Cáceres,Toledo,116,694844,68607,626237,394151,32712
2020/04/20,Cáceres,Cáceres,20592,394151,32532,361619,394151,32712
2020/04/20,Cáceres,Badajoz,885,673559,64976,608583,394151,32712
2020/04/20,Cádiz,Ceuta,16,84777,7467,77310,1240155,121184
2020/04/20,Cádiz,Málaga,863,1661785,151814,1509971,1240155,121184
2020/04/20,Cádiz,Sevilla,773,1942389,200732,1741657,1240155,121184
2020/04/20,Cádiz,Huelva,625,521870,53433,468437,1240155,121184
2020/04/20,Cádiz,Cádiz,94866,1240155,120004,1120151,1240155,121184
2020/04/20,Cantabria,Cantabria,46028,580795,67576,513219,580795,64127
2020/04/20,Cantabria,Asturias,121,1022800,112151,910649,580795,64127
2020/04/20,Cantabria,Bizkaia,419,1152934,160698,992236,580795,64127
2020/04/20,Cantabria,Palencia,36,160866,15915,144951,580795,64127
2020/04/20,Castellón,Valencia,362,2565124,231204,2333920,579962,60381
2020/04/20,Castellón,Castellón,43474,579962,59326,520636,579962,60381
2020/04/20,Castellón,Tarragona,547,804664,75908,728756,579962,60381
2020/04/20,Castellón,Teruel,35,134137,7615,126522,579962,60381
2020/04/20,Ceuta,Ceuta,7033,84777,7467,77310,84777,7443
2020/04/20,Ciudad Real,Toledo,153,694844,68607,626237,495761,31428
2020/04/20,Ciudad Real,Ciudad Real,19003,495761,34905,460856,495761,31428
2020/04/20,Ciudad Real,Albacete,305,388167,27120,361047,495761,31428
2020/04/20,Ciudad Real,Melilla,19,86487,9591,76896,495761,31428
2020/04/20,Ciudad Real,Córdoba,380,782979,80473,702506,495761,31428
2020/04/20,Ciudad Real,Badajoz,77,673559,64976,608583,495761,31428
2020/04/20,Córdoba,Granada,121,914678,91976,822702,782979,77530
2020/04/20,Córdoba,Jaén,527,633564,49856,583708,782979,77530
2020/04/20,Córdoba,Sevilla,1470,1942389,200732,1741657,782979,77530
2020/04/20,Córdoba,Málaga,148,1661785,151814,1509971,782979,77530
2020/04/20,Córdoba,Badajoz,39,673559,64976,608583,782979,77530
2020/04/20,Córdoba,Córdoba,53725,782979,80473,702506,782979,77530
2020/04/20,Córdoba,Ciudad Real,226,495761,34905,460856,782979,77530
2020/04/20,Coruña,Coruña,101597,1119596,137584,982012,1119596,139372
2020/04/20,Coruña,Pontevedra,4472,942665,121448,821217,1119596,139372
2020/04/20,Coruña,Lugo,482,329587,35430,294157,1119596,139372
2020/04/20,Cuenca,Albacete,449,388167,27120,361047,196329,15403
2020/04/20,Cuenca,Valencia,34,2565124,231204,2333920,196329,15403
2020/04/20,Cuenca,Ciudad Real,67,495761,34905,460856,196329,15403
2020/04/20,Cuenca,Madrid,56,6663394,737900,5925494,196329,15403
2020/04/20,Cuenca,Cuenca,7350,196329,14803,181526,196329,15403
2020/04/20,Cuenca,Toledo,136,694844,68607,626237,196329,15403
2020/04/20,Gipuzkoa,Araba,103,331549,41776,289773,723576,82066
2020/04/20,Gipuzkoa,Gipuzkoa,56422,723576,77838,645738,723576,82066
2020/04/20,Gipuzkoa,Navarra,195,654183,75233,578950,723576,82066
2020/04/20,Gipuzkoa,Bizkaia,1022,1152934,160698,992236,723576,82066
2020/04/20,Girona,Barcelona,1703,5664579,654616,5009963,771044,72208
2020/04/20,Girona,Lleida,66,434930,45221,389709,771044,72208
2020/04/20,Girona,Girona,44408,771044,69337,701707,771044,72208
2020/04/20,Granada,Almería,367,716820,71457,645363,914678,88740
2020/04/20,Granada,Córdoba,200,782979,80473,702506,914678,88740
2020/04/20,Granada,Málaga,135,1661785,151814,1509971,914678,88740
2020/04/20,Granada,Granada,63465,914678,91976,822702,914678,88740
2020/04/20,Granada,Jaén,236,633564,49856,583708,914678,88740
2020/04/20,Guadalajara,Guadalajara,15849,257762,27576,230186,257762,29095
2020/04/20,Guadalajara,Madrid,1655,6663394,737900,5925494,257762,29095
2020/04/20,Guadalajara,Cuenca,24,196329,14803,181526,257762,29095
2020/04/20,Huelva,Sevilla,1080,1942389,200732,1741657,521870,55778
2020/04/20,Huelva,Badajoz,234,673559,64976,608583,521870,55778
2020/04/20,Huelva,Cádiz,478,1240155,120004,1120151,521870,55778
2020/04/20,Huelva,Huelva,39281,521870,53433,468437,521870,55778
2020/04/20,Huesca,Lleida,569,434930,45221,389709,220461,24312
2020/04/20,Huesca,Huesca,13985,220461,21385,199076,220461,24312
2020/04/20,Huesca,Zaragoza,184,964724,119206,845518,220461,24312
2020/04/20,Jaén,Córdoba,629,782979,80473,702506,633564,47367
2020/04/20,Jaén,Granada,228,914678,91976,822702,633564,47367
2020/04/20,Jaén,Albacete,34,388167,27120,361047,633564,47367
2020/04/20,Jaén,Jaén,31648,633564,49856,583708,633564,47367
2020/04/20,Las Palmas de Gran Canaria,Las Palmas de Gran Canaria,102994,1120406,116956,1003450,1120406,116528
2020/04/20,León,León,35878,460001,50113,409888,460001,49345
2020/04/20,León,Ourense,143,307651,39929,267722,460001,49345
2020/04/20,León,Zamora,42,172539,15956,156583,460001,49345
2020/04/20,León,Palencia,26,160866,15915,144951,460001,49345
2020/04/20,León,Asturias,32,1022800,112151,910649,460001,49345
2020/04/20,Lleida,Lleida,26954,434930,45221,389709,434930,43031
2020/04/20,Lleida,Zaragoza,44,964724,119206,845518,434930,43031
2020/04/20,Lleida,Barcelona,135,5664579,654616,5009963,434930,43031
2020/04/20,Lleida,Girona,103,771044,69337,701707,434930,43031
2020/04/20,Lleida,Tarragona,23,804664,75908,728756,434930,43031
2020/04/20,Lleida,Huesca,426,220461,21385,199076,434930,43031
2020/04/20,Lugo,Ourense,98,307651,39929,267722,329587,36760
2020/04/20,Lugo,Lugo,24336,329587,35430,294157,329587,36760
2020/04/20,Lugo,Coruña,508,1119596,137584,982012,329587,36760
2020/04/20,Lugo,Asturias,577,1022800,112151,910649,329587,36760
2020/04/20,Madrid,Ávila,141,157640,13179,144461,6663394,745793
2020/04/20,Madrid,Madrid,412604,6663394,737900,5925494,6663394,745793
2020/04/20,Madrid,Guadalajara,1670,257762,27576,230186,6663394,745793
2020/04/20,Madrid,Cuenca,74,196329,14803,181526,6663394,745793
2020/04/20,Madrid,Toledo,2942,694844,68607,626237,6663394,745793
2020/04/20,Madrid,Valencia,35,2565124,231204,2333920,6663394,745793
2020/04/20,Málaga,Málaga,116871,1661785,151814,1509971,1661785,157900
2020/04/20,Málaga,Sevilla,199,1942389,200732,1741657,1661785,157900
2020/04/20,Málaga,Córdoba,193,782979,80473,702506,1661785,157900
2020/04/20,Málaga,Granada,182,914678,91976,822702,1661785,157900
2020/04/20,Málaga,Cádiz,736,1240155,120004,1120151,1661785,157900
2020/04/20,Melilla,Melilla,9374,86487,9591,76896,86487,9636
2020/04/20,Murcia,Albacete,268,388167,27120,361047,1493898,162435
2020/04/20,Murcia,Almería,1079,716820,71457,645363,1493898,162435
2020/04/20,Murcia,Alicante,2215,1858683,197285,1661398,1493898,162435
2020/04/20,Murcia,Murcia,122316,1493898,165379,1328519,1493898,162435
2020/04/20,Navarra,Alicante,32,1858683,197285,1661398,654183,77301
2020/04/20,Navarra,Rioja,2024,316798,36064,280734,654183,77301
2020/04/20,Navarra,Gipuzkoa,225,723576,77838,645738,654183,77301
2020/04/20,Navarra,Navarra,50683,654183,75233,578950,654183,77301
2020/04/20,Navarra,Zaragoza,557,964724,119206,845518,654183,77301
2020/04/20,Ourense,León,125,460001,50113,409888,307651,40642
2020/04/20,Ourense,Pontevedra,102,942665,121448,821217,307651,40642
2020/04/20,Ourense,Zamora,21,172539,15956,156583,307651,40642
2020/04/20,Ourense,Lugo,127,329587,35430,294157,307651,40642
2020/04/20,Ourense,Ourense,30155,307651,39929,267722,307651,40642
2020/04/20,Palencia,Burgos,118,357072,33396,323676,160866,17004
2020/04/20,Palencia,Palencia,10739,160866,15915,144951,160866,17004
2020/04/20,Palencia,Cantabria,137,580795,67576,513219,160866,17004
2020/04/20,Palencia,Valladolid,26,519546,59136,460410,160866,17004
2020/04/20,Pontevedra,Ourense,181,307651,39929,267722,942665,121794
2020/04/20,Pontevedra,Pontevedra,90822,942665,121448,821217,942665,121794
2020/04/20,Pontevedra,Lugo,57,329587,35430,294157,942665,121794
2020/04/20,Pontevedra,Coruña,3837,1119596,137584,982012,942665,121794
2020/04/20,Rioja,Araba,446,331549,41776,289773,316798,34038
2020/04/20,Rioja,Navarra,1673,654183,75233,578950,316798,34038
2020/04/20,Rioja,Burgos,43,357072,33396,323676,316798,34038
2020/04/20,Rioja,Rioja,24448,316798,36064,280734,316798,34038
2020/04/20,Salamanca,Ávila,150,157640,13179,144461,330119,34820
2020/04/20,Salamanca,Salamanca,26687,330119,35466,294653,330119,34820
2020/04/20,Santa Cruz de Tenerife,Santa Cruz de Tenerife,96588,1032983,111414,921569,1032983,110730
2020/04/20,Segovia,Valladolid,254,519546,59136,460410,153129,16250
2020/04/20,Segovia,Burgos,68,357072,33396,323676,153129,16250
2020/04/20,Segovia,Ávila,105,157640,13179,144461,153129,16250
2020/04/20,Segovia,Segovia,9459,153129,15150,137979,153129,16250
2020/04/20,Sevilla,Jaén,19,633564,49856,583708,1942389,195036
2020/04/20,Sevilla,Sevilla,128262,1942389,200732,1741657,1942389,195036
2020/04/20,Sevilla,Cádiz,630,1240155,120004,1120151,1942389,195036
2020/04/20,Sevilla,Badajoz,31,673559,64976,608583,1942389,195036
2020/04/20,Sevilla,Córdoba,1617,782979,80473,702506,1942389,195036
2020/04/20,Sevilla,Málaga,102,1661785,151814,1509971,1942389,195036
2020/04/20,Sevilla,Huelva,253,521870,53433,468437,1942389,195036
2020/04/20,Soria,Segovia,18,153129,15150,137979,88636,7097
2020/04/20,Soria,Soria,4318,88636,6041,82595,88636,7097
2020/04/20,Soria,Zaragoza,66,964724,119206,845518,88636,7097
2020/04/20,Soria,Valladolid,51,519546,59136,460410,88636,7097
2020/04/20,Tarragona,Barcelona,585,5664579,654616,5009963,804664,74716
2020/04/20,Tarragona,Tarragona,47201,804664,75908,728756,804664,74716
2020/04/20,Tarragona,Castellón,578,579962,59326,520636,804664,74716
2020/04/20,Teruel,Tarragona,54,804664,75908,728756,134137,9312
2020/04/20,Teruel,Zaragoza,31,964724,119206,845518,134137,9312
2020/04/20,Teruel,Castellón,62,579962,59326,520636,134137,9312
2020/04/20,Teruel,Guadalajara,20,257762,27576,230186,134137,9312
2020/04/20,Teruel,Teruel,4146,134137,7615,126522,134137,9312
2020/04/20,Toledo,Ciudad Real,176,495761,34905,460856,694844,64655
2020/04/20,Toledo,Ávila,136,157640,13179,144461,694844,64655
2020/04/20,Toledo,Toledo,31808,694844,68607,626237,694844,64655
2020/04/20,Toledo,Madrid,2607,6663394,737900,5925494,694844,64655
2020/04/20,Toledo,Cuenca,56,196329,14803,181526,694844,64655
2020/04/20,Toledo,Cáceres,115,394151,32532,361619,694844,64655
2020/04/20,Valencia,Valencia,153686,2565124,231204,2333920,2565124,224899
2020/04/20,Valencia,Castellón,343,579962,59326,520636,2565124,224899
2020/04/20,Valencia,Cuenca,76,196329,14803,181526,2565124,224899
2020/04/20,Valencia,Albacete,293,388167,27120,361047,2565124,224899
2020/04/20,Valencia,Alicante,681,1858683,197285,1661398,2565124,224899
2020/04/20,Valladolid,Valladolid,39540,519546,59136,460410,519546,56423
2020/04/20,Valladolid,Zamora,58,172539,15956,156583,519546,56423
2020/04/20,Valladolid,Burgos,96,357072,33396,323676,519546,56423
2020/04/20,Valladolid,Ávila,24,157640,13179,144461,519546,56423
2020/04/20,Valladolid,Segovia,211,153129,15150,137979,519546,56423
2020/04/20,Valladolid,Palencia,20,160866,15915,144951,519546,56423
2020/04/20,Valladolid,Soria,29,88636,6041,82595,519546,56423
2020/04/20,Valladolid,León,24,460001,50113,409888,519546,56423
2020/04/20,Zamora,Zamora,10547,172539,15956,156583,172539,16330
2020/04/20,Zamora,Ourense,36,307651,39929,267722,172539,16330
2020/04/20,Zamora,León,24,460001,50113,409888,172539,16330
2020/04/20,Zamora,Valladolid,54,519546,59136,460410,172539,16330
2020/04/20,Zaragoza,Lleida,81,434930,45221,389709,964724,115241
2020/04/20,Zaragoza,Teruel,107,134137,7615,126522,964724,115241
2020/04/20,Zaragoza,Navarra,237,654183,75233,578950,964724,115241
2020/04/20,Zaragoza,Huesca,189,220461,21385,199076,964724,115241
2020/04/20,Zaragoza,Zaragoza,85693,964724,119206,845518,964724,115241
2020/04/21,Albacete,Albacete,17894,388167,28820,359347,388167,28692
2020/04/21,Albacete,Ciudad Real,407,495761,35290,460471,388167,28692
2020/04/21,Albacete,Cuenca,396,196329,14296,182033,388167,28692
2020/04/21,Albacete,Alicante,131,1858683,217178,1641505,388167,28692
2020/04/21,Albacete,Murcia,290,1493898,173172,1320726,388167,28692
2020/04/21,Albacete,Valencia,304,2565124,337154,2227970,388167,28692
2020/04/21,Albacete,Jaén,40,633564,48129,585435,388167,28692
2020/04/21,Alicante,Albacete,260,388167,28820,359347,1858683,220786
2020/04/21,Alicante,Murcia,2596,1493898,173172,1320726,1858683,220786
2020/04/21,Alicante,Alicante,165380,1858683,217178,1641505,1858683,220786
2020/04/21,Alicante,Valencia,926,2565124,337154,2227970,1858683,220786
2020/04/21,Almería,Almería,61930,716820,75998,640822,716820,78175
2020/04/21,Almería,Murcia,1863,1493898,173172,1320726,716820,78175
2020/04/21,Almería,Granada,469,914678,95155,819523,716820,78175
2020/04/21,Araba,Araba,34607,331549,43362,288187,331549,49345
2020/04/21,Araba,Bizkaia,870,1152934,168671,984263,331549,49345
2020/04/21,Araba,Navarra,116,654183,76682,577501,331549,49345
2020/04/21,Araba,Rioja,1490,316798,36981,279817,331549,49345
2020/04/21,Araba,Burgos,1319,357072,35590,321482,331549,49345
2020/04/21,Araba,Gipuzkoa,125,723576,81926,641650,331549,49345
2020/04/21,Asturias,Cantabria,179,580795,69159,511636,1022800,112493
2020/04/21,Asturias,Lugo,804,329587,36288,293299,1022800,112493
2020/04/21,Asturias,León,39,460001,51748,408253,1022800,112493
2020/04/21,Asturias,Asturias,86483,1022800,112771,910029,1022800,112493
2020/04/21,Ávila,Segovia,48,153129,15611,137518,157640,13400
2020/04/21,Ávila,Ávila,8167,157640,13264,144376,157640,13400
2020/04/21,Ávila,Cáceres,144,394151,32159,361992,157640,13400
2020/04/21,Ávila,Madrid,80,6663394,743931,5919463,157640,13400
2020/04/21,Ávila,Salamanca,271,330119,36355,293764,157640,13400
2020/04/21,Ávila,Toledo,152,694844,69592,625252,157640,13400
2020/04/21,Badajoz,Córdoba,100,782979,76007,706972,673559,60644
2020/04/21,Badajoz,Huelva,214,521870,51075,470795,673559,60644
2020/04/21,Badajoz,Ciudad Real,34,495761,35290,460471,673559,60644
2020/04/21,Badajoz,Badajoz,43196,673559,61612,611947,673559,60644
2020/04/21,Badajoz,Sevilla,59,1942389,187899,1754490,673559,60644
2020/04/21,Badajoz,Cáceres,799,394151,32159,361992,673559,60644
2020/04/21,Balears,Balears,86026,1149460,103869,1045591,1149460,104565
2020/04/21,Balears,Valencia,44,2565124,337154,2227970,1149460,104565
2020/04/21,Barcelona,Lleida,120,434930,46473,388457,5664579,684963
2020/04/21,Barcelona,Barcelona,419506,5664579,682434,4982145,5664579,684963
2020/04/21,Barcelona,Tarragona,966,804664,79311,725353,5664579,684963
2020/04/21,Barcelona,Girona,1954,771044,69539,701505,5664579,684963
2020/04/21,Bizkaia,Burgos,41,357072,35590,321482,1152934,164803
2020/04/21,Bizkaia,Bizkaia,122312,1152934,168671,984263,1152934,164803
2020/04/21,Bizkaia,Araba,565,331549,43362,288187,1152934,164803
2020/04/21,Bizkaia,Cantabria,1648,580795,69159,511636,1152934,164803
2020/04/21,Bizkaia,Gipuzkoa,778,723576,81926,641650,1152934,164803
2020/04/21,Burgos,Palencia,162,160866,16296,144570,357072,36216
2020/04/21,Burgos,Rioja,45,316798,36981,279817,357072,36216
2020/04/21,Burgos,Burgos,25434,357072,35590,321482,357072,36216
2020/04/21,Burgos,Araba,677,331549,43362,288187,357072,36216
2020/04/21,Burgos,Soria,30,88636,6562,82074,357072,36216
2020/04/21,Burgos,Valladolid,179,519546,60901,458645,357072,36216
2020/04/21,Burgos,Bizkaia,55,1152934,168671,984263,357072,36216
2020/04/21,Cáceres,Badajoz,1007,673559,61612,611947,394151,32245
2020/04/21,Cáceres,Toledo,123,694844,69592,625252,394151,32245
2020/04/21,Cáceres,Cáceres,20702,394151,32159,361992,394151,32245
2020/04/21,Cáceres,Ávila,101,157640,13264,144376,394151,32245
2020/04/21,Cádiz,Málaga,869,1661785,149246,1512539,1240155,114282
2020/04/21,Cádiz,Cádiz,89007,1240155,112110,1128045,1240155,114282
2020/04/21,Cádiz,Huelva,610,521870,51075,470795,1240155,114282
2020/04/21,Cádiz,Sevilla,636,1942389,187899,1754490,1240155,114282
2020/04/21,Cantabria,Cantabria,47818,580795,69159,511636,580795,65981
2020/04/21,Cantabria,Palencia,39,160866,16296,144570,580795,65981
2020/04/21,Cantabria,Bizkaia,409,1152934,168671,984263,580795,65981
2020/04/21,Cantabria,Asturias,168,1022800,112771,910029,580795,65981
2020/04/21,Castellón,Tarragona,691,804664,79311,725353,579962,67078
2020/04/21,Castellón,Teruel,34,134137,8133,126004,579962,67078
2020/04/21,Castellón,Valencia,476,2565124,337154,2227970,579962,67078
2020/04/21,Castellón,Castellón,46570,579962,64531,515431,579962,67078
2020/04/21,Ceuta,Ceuta,7506,84777,7952,76825,84777,7878
2020/04/21,Ciudad Real,Córdoba,359,782979,76007,706972,495761,32123
2020/04/21,Ciudad Real,Albacete,331,388167,28820,359347,495761,32123
2020/04/21,Ciudad Real,Badajoz,53,673559,61612,611947,495761,32123
2020/04/21,Ciudad Real,Toledo,216,694844,69592,625252,495761,32123
2020/04/21,Ciudad Real,Ciudad Real,20231,495761,35290,460471,495761,32123
2020/04/21,Córdoba,Badajoz,51,673559,61612,611947,782979,74097
2020/04/21,Córdoba,Córdoba,51829,782979,76007,706972,782979,74097
2020/04/21,Córdoba,Granada,103,914678,95155,819523,782979,74097
2020/04/21,Córdoba,Ciudad Real,226,495761,35290,460471,782979,74097
2020/04/21,Córdoba,Málaga,45,1661785,149246,1512539,782979,74097
2020/04/21,Córdoba,Sevilla,1180,1942389,187899,1754490,782979,74097
2020/04/21,Córdoba,Jaén,466,633564,48129,585435,782979,74097
2020/04/21,Coruña,Pontevedra,4402,942665,126906,815759,1119596,141906
2020/04/21,Coruña,Coruña,106125,1119596,141686,977910,1119596,141906
2020/04/21,Coruña,Lugo,520,329587,36288,293299,1119596,141906
2020/04/21,Cuenca,Valencia,26,2565124,337154,2227970,196329,14596
2020/04/21,Cuenca,Cuenca,6865,196329,14296,182033,196329,14596
2020/04/21,Cuenca,Albacete,478,388167,28820,359347,196329,14596
2020/04/21,Cuenca,Guadalajara,24,257762,28065,229697,196329,14596
2020/04/21,Cuenca,Madrid,56,6663394,743931,5919463,196329,14596
2020/04/21,Cuenca,Ciudad Real,35,495761,35290,460471,196329,14596
2020/04/21,Cuenca,Toledo,80,694844,69592,625252,196329,14596
2020/04/21,Gipuzkoa,Bizkaia,1276,1152934,168671,984263,723576,86317
2020/04/21,Gipuzkoa,Gipuzkoa,60283,723576,81926,641650,723576,86317
2020/04/21,Gipuzkoa,Araba,123,331549,43362,288187,723576,86317
2020/04/21,Gipuzkoa,Navarra,172,654183,76682,577501,723576,86317
2020/04/21,Girona,Girona,44716,771044,69539,701505,771044,74469
2020/04/21,Girona,Lleida,97,434930,46473,388457,771044,74469
2020/04/21,Girona,Barcelona,1861,5664579,682434,4982145,771044,74469
2020/04/21,Granada,Almería,467,716820,75998,640822,914678,92654
2020/04/21,Granada,Jaén,75,633564,48129,585435,914678,92654
2020/04/21,Granada,Granada,67921,914678,95155,819523,914678,92654
2020/04/21,Granada,Córdoba,123,782979,76007,706972,914678,92654
2020/04/21,Granada,Málaga,113,1661785,149246,1512539,914678,92654
2020/04/21,Guadalajara,Cuenca,29,196329,14296,182033,257762,29269
2020/04/21,Guadalajara,Madrid,1777,6663394,743931,5919463,257762,29269
2020/04/21,Guadalajara,Guadalajara,16268,257762,28065,229697,257762,29269
2020/04/21,Huelva,Cádiz,475,1240155,112110,1128045,521870,53245
2020/04/21,Huelva,Badajoz,319,673559,61612,611947,521870,53245
2020/04/21,Huelva,Huelva,37321,521870,51075,470795,521870,53245
2020/04/21,Huelva,Sevilla,1012,1942389,187899,1754490,521870,53245
2020/04/21,Huesca,Zaragoza,184,964724,126629,838095,220461,23665
2020/04/21,Huesca,Lleida,490,434930,46473,388457,220461,23665
2020/04/21,Huesca,Huesca,14086,220461,21502,198959,220461,23665
2020/04/21,Jaén,Jaén,31322,633564,48129,585435,633564,46805
2020/04/21,Jaén,Córdoba,609,782979,76007,706972,633564,46805
2020/04/21,Jaén,Granada,138,914678,95155,819523,633564,46805
2020/04/21,Las Palmas de Gran Canaria,Las Palmas de Gran Canaria,107499,1120406,121443,998963,1120406,120439
2020/04/21,León,Zamora,132,172539,17137,155402,460001,51082
2020/04/21,León,Asturias,69,1022800,112771,910029,460001,51082
2020/04/21,León,Lugo,29,329587,36288,293299,460001,51082
2020/04/21,León,Ourense,154,307651,40896,266755,460001,51082
2020/04/21,León,Palencia,78,160866,16296,144570,460001,51082
2020/04/21,León,León,37405,460001,51748,408253,460001,51082
2020/04/21,Lleida,Barcelona,144,5664579,682434,4982145,434930,44423
2020/04/21,Lleida,Zaragoza,105,964724,126629,838095,434930,44423
2020/04/21,Lleida,Tarragona,31,804664,79311,725353,434930,44423
2020/04/21,Lleida,Huesca,448,220461,21502,198959,434930,44423
2020/04/21,Lleida,Lleida,28120,434930,46473,388457,434930,44423
2020/04/21,Lleida,Girona,88,771044,69539,701505,434930,44423
2020/04/21,Lugo,Lugo,25609,329587,36288,293299,329587,37082
2020/04/21,Lugo,Ourense,58,307651,40896,266755,329587,37082
2020/04/21,Lugo,Coruña,518,1119596,141686,977910,329587,37082
2020/04/21,Lugo,Asturias,605,1022800,112771,910029,329587,37082
2020/04/21,Madrid,Segovia,17,153129,15611,137518,6663394,748287
2020/04/21,Madrid,Guadalajara,1812,257762,28065,229697,6663394,748287
2020/04/21,Madrid,Ávila,214,157640,13264,144376,6663394,748287
2020/04/21,Madrid,Melilla,18,86487,9830,76657,6663394,748287
2020/04/21,Madrid,Toledo,2829,694844,69592,625252,6663394,748287
2020/04/21,Madrid,Madrid,416897,6663394,743931,5919463,6663394,748287
2020/04/21,Madrid,Cuenca,74,196329,14296,182033,6663394,748287
2020/04/21,Madrid,Valencia,27,2565124,337154,2227970,6663394,748287
2020/04/21,Málaga,Córdoba,253,782979,76007,706972,1661785,151898
2020/04/21,Málaga,Málaga,114929,1661785,149246,1512539,1661785,151898
2020/04/21,Málaga,Granada,125,914678,95155,819523,1661785,151898
2020/04/21,Málaga,Sevilla,135,1942389,187899,1754490,1661785,151898
2020/04/21,Málaga,Cádiz,573,1240155,112110,1128045,1661785,151898
2020/04/21,Melilla,Melilla,9561,86487,9830,76657,86487,9766
2020/04/21,Murcia,Granada,24,914678,95155,819523,1493898,169449
2020/04/21,Murcia,Almería,1181,716820,75998,640822,1493898,169449
2020/04/21,Murcia,Murcia,126793,1493898,173172,1320726,1493898,169449
2020/04/21,Murcia,Albacete,299,388167,28820,359347,1493898,169449
2020/04/21,Murcia,Alicante,2278,1858683,217178,1641505,1493898,169449
2020/04/21,Navarra,Navarra,51955,654183,76682,577501,654183,79035
2020/04/21,Navarra,Rioja,2036,316798,36981,279817,654183,79035
2020/04/21,Navarra,Gipuzkoa,246,723576,81926,641650,654183,79035
2020/04/21,Navarra,Alicante,28,1858683,217178,1641505,654183,79035
2020/04/21,Navarra,Zaragoza,469,964724,126629,838095,654183,79035
2020/04/21,Ourense,León,164,460001,51748,408253,307651,41026
2020/04/21,Ourense,Lugo,127,329587,36288,293299,307651,41026
2020/04/21,Ourense,Zamora,35,172539,17137,155402,307651,41026
2020/04/21,Ourense,Pontevedra,163,942665,126906,815759,307651,41026
2020/04/21,Ourense,Ourense,31251,307651,40896,266755,307651,41026
2020/04/21,Palencia,Palencia,11189,160866,16296,144570,160866,17401
2020/04/21,Palencia,Valladolid,24,519546,60901,458645,160866,17401
2020/04/21,Palencia,Burgos,145,357072,35590,321482,160866,17401
2020/04/21,Palencia,Cantabria,129,580795,69159,511636,160866,17401
2020/04/21,Pontevedra,Coruña,3802,1119596,141686,977910,942665,125955
2020/04/21,Pontevedra,Lugo,27,329587,36288,293299,942665,125955
2020/04/21,Pontevedra,Ourense,223,307651,40896,266755,942665,125955
2020/04/21,Pontevedra,Pontevedra,96953,942665,126906,815759,942665,125955
2020/04/21,Rioja,Burgos,18,357072,35590,321482,316798,35070
2020/04/21,Rioja,Navarra,1723,654183,76682,577501,316798,35070
2020/04/21,Rioja,Araba,502,331549,43362,288187,316798,35070
2020/04/21,Rioja,Rioja,25435,316798,36981,279817,316798,35070
2020/04/21,Salamanca,Ávila,230,157640,13264,144376,330119,35806
2020/04/21,Salamanca,Salamanca,27367,330119,36355,293764,330119,35806
2020/04/21,Salamanca,Zamora,75,172539,17137,155402,330119,35806
2020/04/21,Santa Cruz de Tenerife,Santa Cruz de Tenerife,99868,1032983,114067,918916,1032983,113589
2020/04/21,Segovia,Segovia,9989,153129,15611,137518,153129,16918
2020/04/21,Segovia,Madrid,20,6663394,743931,5919463,153129,16918
2020/04/21,Segovia,Valladolid,353,519546,60901,458645,153129,16918
2020/04/21,Segovia,Burgos,76,357072,35590,321482,153129,16918
2020/04/21,Segovia,Ávila,101,157640,13264,144376,153129,16918
2020/04/21,Sevilla,Málaga,96,1661785,149246,1512539,1942389,184014
2020/04/21,Sevilla,Córdoba,1294,782979,76007,706972,1942389,184014
2020/04/21,Sevilla,Huelva,254,521870,51075,470795,1942389,184014
2020/04/21,Sevilla,Cádiz,580,1240155,112110,1128045,1942389,184014
2020/04/21,Sevilla,Sevilla,119679,1942389,187899,1754490,1942389,184014
2020/04/21,Sevilla,Badajoz,21,673559,61612,611947,1942389,184014
2020/04/21,Soria,Segovia,17,153129,15611,137518,88636,7302
2020/04/21,Soria,Zaragoza,97,964724,126629,838095,88636,7302
2020/04/21,Soria,Valladolid,99,519546,60901,458645,88636,7302
2020/04/21,Soria,Soria,4666,88636,6562,82074,88636,7302
2020/04/21,Tarragona,Barcelona,695,5664579,682434,4982145,804664,78765
2020/04/21,Tarragona,Teruel,46,134137,8133,126004,804664,78765
2020/04/21,Tarragona,Castellón,667,579962,64531,515431,804664,78765
2020/04/21,Tarragona,Tarragona,50218,804664,79311,725353,804664,78765
2020/04/21,Teruel,Tarragona,50,804664,79311,725353,134137,9559
2020/04/21,Teruel,Teruel,4403,134137,8133,126004,134137,9559
2020/04/21,Teruel,Castellón,67,579962,64531,515431,134137,9559
2020/04/21,Teruel,Zaragoza,79,964724,126629,838095,134137,9559
2020/04/21,Toledo,Ciudad Real,204,495761,35290,460471,694844,66301
2020/04/21,Toledo,Cuenca,30,196329,14296,182033,694844,66301
2020/04/21,Toledo,Ávila,147,157640,13264,144376,694844,66301
2020/04/21,Toledo,Madrid,2735,6663394,743931,5919463,694844,66301
2020/04/21,Toledo,Toledo,33459,694844,69592,625252,694844,66301
2020/04/21,Toledo,Cáceres,104,394151,32159,361992,694844,66301
2020/04/21,Valencia,Valencia,224783,2565124,337154,2227970,2565124,330285
2020/04/21,Valencia,Castellón,497,579962,64531,515431,2565124,330285
2020/04/21,Valencia,Cuenca,65,196329,14296,182033,2565124,330285
2020/04/21,Valencia,Madrid,23,6663394,743931,5919463,2565124,330285
2020/04/21,Valencia,Alicante,915,1858683,217178,1641505,2565124,330285
2020/04/21,Valencia,Albacete,290,388167,28820,359347,2565124,330285
2020/04/21,Valladolid,Segovia,205,153129,15611,137518,519546,58417
2020/04/21,Valladolid,Palencia,35,160866,16296,144570,519546,58417
2020/04/21,Valladolid,Soria,57,88636,6562,82074,519546,58417
2020/04/21,Valladolid,Zamora,59,172539,17137,155402,519546,58417
2020/04/21,Valladolid,Ávila,23,157640,13264,144376,519546,58417
2020/04/21,Valladolid,Burgos,98,357072,35590,321482,519546,58417
2020/04/21,Valladolid,Valladolid,41612,519546,60901,458645,519546,58417
2020/04/21,Valladolid,León,24,460001,51748,408253,519546,58417
2020/04/21,Zamora,Salamanca,50,330119,36355,293764,172539,17229
2020/04/21,Zamora,Ourense,61,307651,40896,266755,172539,17229
2020/04/21,Zamora,Valladolid,31,519546,60901,458645,172539,17229
2020/04/21,Zamora,Zamora,11116,172539,17137,155402,172539,17229
2020/04/21,Zamora,León,52,460001,51748,408253,172539,17229
2020/04/21,Zaragoza,Teruel,145,134137,8133,126004,964724,121587
2020/04/21,Zaragoza,Lleida,50,434930,46473,388457,964724,121587
2020/04/21,Zaragoza,Navarra,359,654183,76682,577501,964724,121587
2020/04/21,Zaragoza,Soria,64,88636,6562,82074,964724,121587
2020/04/21,Zaragoza,Huesca,199,220461,21502,198959,964724,121587
2020/04/21,Zaragoza,Zaragoza,92843,964724,126629,838095,964724,121587
2020/04/22,Albacete,Alicante,172,1858683,226992,1631691,388167,29864
2020/04/22,Albacete,Ciudad Real,630,495761,36169,459592,388167,29864
2020/04/22,Albacete,Cuenca,521,196329,15357,180972,388167,29864
2020/04/22,Albacete,Jaén,43,633564,55198,578366,388167,29864
2020/04/22,Albacete,Valencia,364,2565124,358886,2206238,388167,29864
2020/04/22,Albacete,Murcia,401,1493898,177101,1316797,388167,29864
2020/04/22,Albacete,Albacete,18603,388167,29653,358514,388167,29864
2020/04/22,Alicante,Albacete,320,388167,29653,358514,1858683,230229
2020/04/22,Alicante,Alicante,175551,1858683,226992,1631691,1858683,230229
2020/04/22,Alicante,Valencia,1052,2565124,358886,2206238,1858683,230229
2020/04/22,Alicante,Murcia,2498,1493898,177101,1316797,1858683,230229
2020/04/22,Almería,Almería,63313,716820,77584,639236,716820,79619
2020/04/22,Almería,Granada,679,914678,99904,814774,716820,79619
2020/04/22,Almería,Murcia,1983,1493898,177101,1316797,716820,79619
2020/04/22,Araba,Araba,36167,331549,44983,286566,331549,50706
2020/04/22,Araba,Navarra,166,654183,81748,572435,331549,50706
2020/04/22,Araba,Gipuzkoa,120,723576,85201,638375,331549,50706
2020/04/22,Araba,Burgos,1360,357072,35080,321992,331549,50706
2020/04/22,Araba,Bizkaia,850,1152934,171567,981367,331549,50706
2020/04/22,Araba,Rioja,1519,316798,37283,279515,331549,50706
2020/04/22,Asturias,León,50,460001,53600,406401,1022800,115253
2020/04/22,Asturias,Asturias,88697,1022800,115517,907283,1022800,115253
2020/04/22,Asturias,Cantabria,185,580795,70938,509857,1022800,115253
2020/04/22,Asturias,Lugo,752,329587,36208,293379,1022800,115253
2020/04/22,Ávila,Segovia,66,153129,16172,136957,157640,14382
2020/04/22,Ávila,Madrid,73,6663394,771205,5892189,157640,14382
2020/04/22,Ávila,Cáceres,124,394151,31941,362210,157640,14382
2020/04/22,Ávila,Salamanca,237,330119,38007,292112,157640,14382
2020/04/22,Ávila,Toledo,231,694844,72112,622732,157640,14382
2020/04/22,Ávila,Ávila,8794,157640,13896,143744,157640,14382
2020/04/22,Badajoz,Badajoz,46572,673559,65322,608237,673559,64712
2020/04/22,Badajoz,Huelva,235,521870,54262,467608,673559,64712
2020/04/22,Badajoz,Ciudad Real,42,495761,36169,459592,673559,64712
2020/04/22,Badajoz,Sevilla,67,1942389,204600,1737789,673559,64712
2020/04/22,Badajoz,Cáceres,905,394151,31941,362210,673559,64712
2020/04/22,Badajoz,Córdoba,33,782979,80424,702555,673559,64712
2020/04/22,Balears,Valencia,53,2565124,358886,2206238,1149460,108933
2020/04/22,Balears,Balears,89810,1149460,108089,1041371,1149460,108933
2020/04/22,Balears,Barcelona,16,5664579,720678,4943901,1149460,108933
2020/04/22,Barcelona,Tarragona,958,804664,81768,722896,5664579,723570
2020/04/22,Barcelona,Girona,2503,771044,76262,694782,5664579,723570
2020/04/22,Barcelona,Barcelona,452118,5664579,720678,4943901,5664579,723570
2020/04/22,Barcelona,Lleida,113,434930,50545,384385,5664579,723570
2020/04/22,Bizkaia,Bizkaia,125484,1152934,171567,981367,1152934,168498
2020/04/22,Bizkaia,Burgos,42,357072,35080,321992,1152934,168498
2020/04/22,Bizkaia,Araba,695,331549,44983,286566,1152934,168498
2020/04/22,Bizkaia,Gipuzkoa,807,723576,85201,638375,1152934,168498
2020/04/22,Bizkaia,Cantabria,1597,580795,70938,509857,1152934,168498
2020/04/22,Burgos,Burgos,24972,357072,35080,321992,357072,35499
2020/04/22,Burgos,Palencia,174,160866,17858,143008,357072,35499
2020/04/22,Burgos,Soria,30,88636,6355,82281,357072,35499
2020/04/22,Burgos,Valladolid,87,519546,62697,456849,357072,35499
2020/04/22,Burgos,Cantabria,47,580795,70938,509857,357072,35499
2020/04/22,Burgos,Araba,704,331549,44983,286566,357072,35499
2020/04/22,Burgos,Rioja,43,316798,37283,279515,357072,35499
2020/04/22,Burgos,Bizkaia,60,1152934,171567,981367,357072,35499
2020/04/22,Cáceres,Ávila,153,157640,13896,143744,394151,31673
2020/04/22,Cáceres,Toledo,156,694844,72112,622732,394151,31673
2020/04/22,Cáceres,Badajoz,912,673559,65322,608237,394151,31673
2020/04/22,Cáceres,Cáceres,19940,394151,31941,362210,394151,31673
2020/04/22,Cádiz,Málaga,926,1661785,157549,1504236,1240155,122512
2020/04/22,Cádiz,Sevilla,675,1942389,204600,1737789,1240155,122512
2020/04/22,Cádiz,Cádiz,96249,1240155,120479,1119676,1240155,122512
2020/04/22,Cádiz,Huelva,667,521870,54262,467608,1240155,122512
2020/04/22,Cantabria,Asturias,152,1022800,115517,907283,580795,68102
2020/04/22,Cantabria,Bizkaia,443,1152934,171567,981367,580795,68102
2020/04/22,Cantabria,Cantabria,50003,580795,70938,509857,580795,68102
2020/04/22,Cantabria,Palencia,42,160866,17858,143008,580795,68102
2020/04/22,Castellón,Valencia,758,2565124,358886,2206238,579962,70744
2020/04/22,Castellón,Teruel,31,134137,8146,125991,579962,70744
2020/04/22,Castellón,Tarragona,954,804664,81768,722896,579962,70744
2020/04/22,Castellón,Castellón,49343,579962,67451,512511,579962,70744
2020/04/22,Ceuta,Ceuta,8250,84777,8711,76066,84777,8633
2020/04/22,Ciudad Real,Toledo,259,694844,72112,622732,495761,33515
2020/04/22,Ciudad Real,Córdoba,373,782979,80424,702555,495761,33515
2020/04/22,Ciudad Real,Badajoz,58,673559,65322,608237,495761,33515
2020/04/22,Ciudad Real,Albacete,364,388167,29653,358514,495761,33515
2020/04/22,Ciudad Real,Ciudad Real,21085,495761,36169,459592,495761,33515
2020/04/22,Córdoba,Jaén,682,633564,55198,578366,782979,79046
2020/04/22,Córdoba,Córdoba,55205,782979,80424,702555,782979,79046
2020/04/22,Córdoba,Málaga,164,1661785,157549,1504236,782979,79046
2020/04/22,Córdoba,Badajoz,96,673559,65322,608237,782979,79046
2020/04/22,Córdoba,Granada,113,914678,99904,814774,782979,79046
2020/04/22,Córdoba,Sevilla,1469,1942389,204600,1737789,782979,79046
2020/04/22,Córdoba,Ciudad Real,221,495761,36169,459592,782979,79046
2020/04/22,Coruña,Pontevedra,4363,942665,125731,816934,1119596,141420
2020/04/22,Coruña,Coruña,106298,1119596,140603,978993,1119596,141420
2020/04/22,Coruña,Lugo,557,329587,36208,293379,1119596,141420
2020/04/22,Cuenca,Albacete,623,388167,29653,358514,196329,15445
2020/04/22,Cuenca,Cuenca,7401,196329,15357,180972,196329,15445
2020/04/22,Cuenca,Madrid,58,6663394,771205,5892189,196329,15445
2020/04/22,Cuenca,Valencia,54,2565124,358886,2206238,196329,15445
2020/04/22,Cuenca,Toledo,85,694844,72112,622732,196329,15445
2020/04/22,Cuenca,Guadalajara,19,257762,28945,228817,196329,15445
2020/04/22,Cuenca,Ciudad Real,35,495761,36169,459592,196329,15445
2020/04/22,Gipuzkoa,Bizkaia,969,1152934,171567,981367,723576,88696
2020/04/22,Gipuzkoa,Gipuzkoa,63196,723576,85201,638375,723576,88696
2020/04/22,Gipuzkoa,Navarra,227,654183,81748,572435,723576,88696
2020/04/22,Gipuzkoa,Araba,146,331549,44983,286566,723576,88696
2020/04/22,Girona,Barcelona,1948,5664579,720678,4943901,771044,79706
2020/04/22,Girona,Girona,50480,771044,76262,694782,771044,79706
2020/04/22,Girona,Lleida,117,434930,50545,384385,771044,79706
2020/04/22,Girona,Murcia,43,1493898,177101,1316797,771044,79706
2020/04/22,Granada,Córdoba,195,782979,80424,702555,914678,97093
2020/04/22,Granada,Jaén,206,633564,55198,578366,914678,97093
2020/04/22,Granada,Granada,71202,914678,99904,814774,914678,97093
2020/04/22,Granada,Málaga,108,1661785,157549,1504236,914678,97093
2020/04/22,Granada,Murcia,49,1493898,177101,1316797,914678,97093
2020/04/22,Granada,Almería,375,716820,77584,639236,914678,97093
2020/04/22,Guadalajara,Madrid,1762,6663394,771205,5892189,257762,29945
2020/04/22,Guadalajara,Guadalajara,17066,257762,28945,228817,257762,29945
2020/04/22,Guadalajara,Cuenca,18,196329,15357,180972,257762,29945
2020/04/22,Huelva,Cádiz,486,1240155,120479,1119676,521870,56879
2020/04/22,Huelva,Sevilla,1196,1942389,204600,1737789,521870,56879
2020/04/22,Huelva,Badajoz,260,673559,65322,608237,521870,56879
2020/04/22,Huelva,Huelva,40077,521870,54262,467608,521870,56879
2020/04/22,Huesca,Lleida,736,434930,50545,384385,220461,24979
2020/04/22,Huesca,Huesca,14761,220461,22497,197964,220461,24979
2020/04/22,Huesca,Zaragoza,256,964724,128351,836373,220461,24979
2020/04/22,Jaén,Albacete,16,388167,29653,358514,633564,53662
2020/04/22,Jaén,Córdoba,701,782979,80424,702555,633564,53662
2020/04/22,Jaén,Granada,159,914678,99904,814774,633564,53662
2020/04/22,Jaén,Jaén,37475,633564,55198,578366,633564,53662
2020/04/22,Las Palmas de Gran Canaria,Las Palmas de Gran Canaria,109817,1120406,123315,997091,1120406,122571
2020/04/22,León,Asturias,40,1022800,115517,907283,460001,53183
2020/04/22,León,Valladolid,18,519546,62697,456849,460001,53183
2020/04/22,León,Zamora,90,172539,18565,153974,460001,53183
2020/04/22,León,Palencia,27,160866,17858,143008,460001,53183
2020/04/22,León,León,39224,460001,53600,406401,460001,53183
2020/04/22,León,Ourense,125,307651,40616,267035,460001,53183
2020/04/22,Lleida,Tarragona,31,804664,81768,722896,434930,48526
2020/04/22,Lleida,Zaragoza,43,964724,128351,836373,434930,48526
2020/04/22,Lleida,Barcelona,154,5664579,720678,4943901,434930,48526
2020/04/22,Lleida,Huesca,451,220461,22497,197964,434930,48526
2020/04/22,Lleida,Girona,153,771044,76262,694782,434930,48526
2020/04/22,Lleida,Lleida,32024,434930,50545,384385,434930,48526
2020/04/22,Lugo,Ourense,130,307651,40616,267035,329587,37178
2020/04/22,Lugo,Asturias,670,1022800,115517,907283,329587,37178
2020/04/22,Lugo,Coruña,548,1119596,140603,978993,329587,37178
2020/04/22,Lugo,Lugo,25462,329587,36208,293379,329587,37178
2020/04/22,Madrid,Toledo,3063,694844,72112,622732,6663394,775433
2020/04/22,Madrid,Guadalajara,1794,257762,28945,228817,6663394,775433
2020/04/22,Madrid,Cuenca,66,196329,15357,180972,6663394,775433
2020/04/22,Madrid,Valencia,28,2565124,358886,2206238,6663394,775433
2020/04/22,Madrid,Segovia,18,153129,16172,136957,6663394,775433
2020/04/22,Madrid,Ávila,234,157640,13896,143744,6663394,775433
2020/04/22,Madrid,Madrid,445874,6663394,771205,5892189,6663394,775433
2020/04/22,Málaga,Cádiz,724,1240155,120479,1119676,1661785,161283
2020/04/22,Málaga,Granada,176,914678,99904,814774,1661785,161283
2020/04/22,Málaga,Sevilla,223,1942389,204600,1737789,1661785,161283
2020/04/22,Málaga,Málaga,123019,1661785,157549,1504236,1661785,161283
2020/04/22,Málaga,Córdoba,204,782979,80424,702555,1661785,161283
2020/04/22,Melilla,Melilla,10838,86487,11127,75360,86487,11079
2020/04/22,Murcia,Granada,18,914678,99904,814774,1493898,175452
2020/04/22,Murcia,Murcia,132357,1493898,177101,1316797,1493898,175452
2020/04/22,Murcia,Albacete,480,388167,29653,358514,1493898,175452
2020/04/22,Murcia,Almería,1140,716820,77584,639236,1493898,175452
2020/04/22,Murcia,Alicante,2583,1858683,226992,1631691,1493898,175452
2020/04/22,Navarra,Gipuzkoa,357,723576,85201,638375,654183,82420
2020/04/22,Navarra,Navarra,56120,654183,81748,572435,654183,82420
2020/04/22,Navarra,Araba,59,331549,44983,286566,654183,82420
2020/04/22,Navarra,Alicante,27,1858683,226992,1631691,654183,82420
2020/04/22,Navarra,Zaragoza,487,964724,128351,836373,654183,82420
2020/04/22,Navarra,Rioja,1985,316798,37283,279515,654183,82420
2020/04/22,Ourense,León,81,460001,53600,406401,307651,40771
2020/04/22,Ourense,Pontevedra,149,942665,125731,816934,307651,40771
2020/04/22,Ourense,Lugo,214,329587,36208,293379,307651,40771
2020/04/22,Ourense,Zamora,41,172539,18565,153974,307651,40771
2020/04/22,Ourense,Ourense,30961,307651,40616,267035,307651,40771
2020/04/22,Palencia,Cantabria,161,580795,70938,509857,160866,18843
2020/04/22,Palencia,Burgos,172,357072,35080,321992,160866,18843
2020/04/22,Palencia,Valladolid,61,519546,62697,456849,160866,18843
2020/04/22,Palencia,Palencia,12393,160866,17858,143008,160866,18843
2020/04/22,Pontevedra,Ourense,171,307651,40616,267035,942665,124501
2020/04/22,Pontevedra,Pontevedra,96279,942665,125731,816934,942665,124501
2020/04/22,Pontevedra,Coruña,3424,1119596,140603,978993,942665,124501
2020/04/22,Rioja,Rioja,25921,316798,37283,279515,316798,35851
2020/04/22,Rioja,Burgos,41,357072,35080,321992,316798,35851
2020/04/22,Rioja,Araba,513,331549,44983,286566,316798,35851
2020/04/22,Rioja,Navarra,2246,654183,81748,572435,316798,35851
2020/04/22,Salamanca,Ávila,188,157640,13896,143744,330119,37342
2020/04/22,Salamanca,Salamanca,29030,330119,38007,292112,330119,37342
2020/04/22,Santa Cruz de Tenerife,Las Palmas de Gran Canaria,20,1120406,123315,997091,1032983,116260
2020/04/22,Santa Cruz de Tenerife,Santa Cruz de Tenerife,101506,1032983,116982,916001,1032983,116260
2020/04/22,Segovia,Valladolid,239,519546,62697,456849,153129,17625
2020/04/22,Segovia,Segovia,10516,153129,16172,136957,153129,17625
2020/04/22,Segovia,Ávila,110,157640,13896,143744,153129,17625
2020/04/22,Segovia,Burgos,88,357072,35080,321992,153129,17625
2020/04/22,Sevilla,Huelva,389,521870,54262,467608,1942389,200632
2020/04/22,Sevilla,Cádiz,814,1240155,120479,1119676,1942389,200632
2020/04/22,Sevilla,Córdoba,1384,782979,80424,702555,1942389,200632
2020/04/22,Sevilla,Málaga,130,1661785,157549,1504236,1942389,200632
2020/04/22,Sevilla,Sevilla,134491,1942389,204600,1737789,1942389,200632
2020/04/22,Sevilla,Badajoz,31,673559,65322,608237,1942389,200632
2020/04/22,Soria,Valladolid,44,519546,62697,456849,88636,7102
2020/04/22,Soria,Segovia,22,153129,16172,136957,88636,7102
2020/04/22,Soria,Burgos,55,357072,35080,321992,88636,7102
2020/04/22,Soria,Soria,4425,88636,6355,82281,88636,7102
2020/04/22,Soria,Zaragoza,93,964724,128351,836373,88636,7102
2020/04/22,Tarragona,Zaragoza,39,964724,128351,836373,804664,80571
2020/04/22,Tarragona,Lleida,37,434930,50545,384385,804664,80571
2020/04/22,Tarragona,Barcelona,655,5664579,720678,4943901,804664,80571
2020/04/22,Tarragona,Teruel,62,134137,8146,125991,804664,80571
2020/04/22,Tarragona,Tarragona,52687,804664,81768,722896,804664,80571
2020/04/22,Tarragona,Castellón,764,579962,67451,512511,804664,80571
2020/04/22,Teruel,Tarragona,70,804664,81768,722896,134137,9750
2020/04/22,Teruel,Castellón,61,579962,67451,512511,134137,9750
2020/04/22,Teruel,Teruel,4441,134137,8146,125991,134137,9750
2020/04/22,Teruel,Guadalajara,63,257762,28945,228817,134137,9750
2020/04/22,Teruel,Zaragoza,36,964724,128351,836373,134137,9750
2020/04/22,Toledo,Ávila,112,157640,13896,143744,694844,68738
2020/04/22,Toledo,Madrid,2941,6663394,771205,5892189,694844,68738
2020/04/22,Toledo,Toledo,35231,694844,72112,622732,694844,68738
2020/04/22,Toledo,Ciudad Real,223,495761,36169,459592,694844,68738
2020/04/22,Toledo,Cuenca,90,196329,15357,180972,694844,68738
2020/04/22,Toledo,Cáceres,147,394151,31941,362210,694844,68738
2020/04/22,Valencia,Albacete,259,388167,29653,358514,2565124,349115
2020/04/22,Valencia,Cuenca,66,196329,15357,180972,2565124,349115
2020/04/22,Valencia,Madrid,34,6663394,771205,5892189,2565124,349115
2020/04/22,Valencia,Valencia,247572,2565124,358886,2206238,2565124,349115
2020/04/22,Valencia,Castellón,567,579962,67451,512511,2565124,349115
2020/04/22,Valencia,Alicante,676,1858683,226992,1631691,2565124,349115
2020/04/22,Valladolid,Ávila,21,157640,13896,143744,519546,60567
2020/04/22,Valladolid,Segovia,217,153129,16172,136957,519546,60567
2020/04/22,Valladolid,Soria,30,88636,6355,82281,519546,60567
2020/04/22,Valladolid,Zamora,110,172539,18565,153974,519546,60567
2020/04/22,Valladolid,Burgos,87,357072,35080,321992,519546,60567
2020/04/22,Valladolid,Valladolid,43338,519546,62697,456849,519546,60567
2020/04/22,Zamora,Ourense,52,307651,40616,267035,172539,18691
2020/04/22,Zamora,Zamora,12600,172539,18565,153974,172539,18691
2020/04/22,Zamora,Salamanca,18,330119,38007,292112,172539,18691
2020/04/22,Zamora,Valladolid,47,519546,62697,456849,172539,18691
2020/04/22,Zaragoza,Teruel,161,134137,8146,125991,964724,123456
2020/04/22,Zaragoza,Zaragoza,94259,964724,128351,836373,964724,123456
2020/04/22,Zaragoza,Navarra,315,654183,81748,572435,964724,123456
2020/04/22,Zaragoza,Huesca,192,220461,22497,197964,964724,123456
2020/04/22,Zaragoza,Lleida,90,434930,50545,384385,964724,123456
2020/04/22,Zaragoza,Soria,53,88636,6355,82281,964724,123456
2020/04/23,Albacete,Cuenca,563,196329,15805,180524,388167,28750
2020/04/23,Albacete,Albacete,16834,388167,28085,360082,388167,28750
2020/04/23,Albacete,Ciudad Real,546,495761,36252,459509,388167,28750
2020/04/23,Albacete,Alicante,334,1858683,199144,1659539,388167,28750
2020/04/23,Albacete,Murcia,313,1493898,170997,1322901,388167,28750
2020/04/23,Albacete,Jaén,48,633564,54068,579496,388167,28750
2020/04/23,Albacete,Valencia,349,2565124,340919,2224205,388167,28750
2020/04/23,Alicante,Murcia,2489,1493898,170997,1322901,1858683,202918
2020/04/23,Alicante,Alicante,149530,1858683,199144,1659539,1858683,202918
2020/04/23,Alicante,Valencia,874,2565124,340919,2224205,1858683,202918
2020/04/23,Alicante,Albacete,291,388167,28085,360082,1858683,202918
2020/04/23,Almería,Murcia,1743,1493898,170997,1322901,716820,77790
2020/04/23,Almería,Almería,61317,716820,75766,641054,716820,77790
2020/04/23,Almería,Granada,482,914678,96498,818180,716820,77790
2020/04/23,Araba,Araba,35281,331549,43878,287671,331549,49768
2020/04/23,Araba,Gipuzkoa,103,723576,82960,640616,331549,49768
2020/04/23,Araba,Burgos,1295,357072,22605,334467,331549,49768
2020/04/23,Araba,Bizkaia,1090,1152934,166513,986421,331549,49768
2020/04/23,Araba,Rioja,1533,316798,36484,280314,331549,49768
2020/04/23,Araba,Navarra,87,654183,77908,576275,331549,49768
2020/04/23,Asturias,Asturias,84135,1022800,110105,912695,1022800,110490
2020/04/23,Asturias,León,29,460001,35514,424487,1022800,110490
2020/04/23,Asturias,Cantabria,216,580795,69798,510997,1022800,110490
2020/04/23,Asturias,Lugo,725,329587,35192,294395,1022800,110490
2020/04/23,Ávila,Segovia,59,153129,11167,141962,157640,9984
2020/04/23,Ávila,Salamanca,295,330119,25176,304943,157640,9984
2020/04/23,Ávila,Madrid,107,6663394,740326,5923068,157640,9984
2020/04/23,Ávila,Valladolid,58,519546,37378,482168,157640,9984
2020/04/23,Ávila,Cáceres,135,394151,30815,363336,157640,9984
2020/04/23,Ávila,Ávila,5823,157640,9984,147656,157640,9984
2020/04/23,Ávila,Toledo,126,694844,70705,624139,157640,9984
2020/04/23,Badajoz,Sevilla,47,1942389,199037,1743352,673559,63174
2020/04/23,Badajoz,Badajoz,44674,673559,63928,609631,673559,63174
2020/04/23,Badajoz,Cáceres,968,394151,30815,363336,673559,63174
2020/04/23,Badajoz,Huelva,189,521870,52704,469166,673559,63174
2020/04/23,Badajoz,Córdoba,88,782979,79765,703214,673559,63174
2020/04/23,Badajoz,Ciudad Real,43,495761,36252,459509,673559,63174
2020/04/23,Balears,Valencia,55,2565124,340919,2224205,1149460,108047
2020/04/23,Balears,Balears,88869,1149460,106903,1042557,1149460,108047
2020/04/23,Barcelona,Lleida,120,434930,49190,385740,5664579,696867
2020/04/23,Barcelona,Barcelona,420788,5664579,693676,4970903,5664579,696867
2020/04/23,Barcelona,Tarragona,1018,804664,79876,724788,5664579,696867
2020/04/23,Barcelona,Girona,2149,771044,72993,698051,5664579,696867
2020/04/23,Bizkaia,Bizkaia,121078,1152934,166513,986421,1152934,163573
2020/04/23,Bizkaia,Araba,652,331549,43878,287671,1152934,163573
2020/04/23,Bizkaia,Burgos,47,357072,22605,334467,1152934,163573
2020/04/23,Bizkaia,Cantabria,1533,580795,69798,510997,1152934,163573
2020/04/23,Bizkaia,Gipuzkoa,752,723576,82960,640616,1152934,163573
2020/04/23,Burgos,Bizkaia,59,1152934,166513,986421,357072,22073
2020/04/23,Burgos,Araba,550,331549,43878,287671,357072,22073
2020/04/23,Burgos,Soria,28,88636,4561,84075,357072,22073
2020/04/23,Burgos,Palencia,121,160866,11481,149385,357072,22073
2020/04/23,Burgos,Rioja,20,316798,36484,280314,357072,22073
2020/04/23,Burgos,Burgos,14433,357072,22605,334467,357072,22073
2020/04/23,Burgos,Valladolid,81,519546,37378,482168,357072,22073
2020/04/23,Burgos,Cantabria,26,580795,69798,510997,357072,22073
2020/04/23,Cáceres,Badajoz,895,673559,63928,609631,394151,30697
2020/04/23,Cáceres,Toledo,127,694844,70705,624139,394151,30697
2020/04/23,Cáceres,Ávila,94,157640,9984,147656,394151,30697
2020/04/23,Cáceres,Cáceres,19542,394151,30815,363336,394151,30697
2020/04/23,Cádiz,Málaga,1014,1661785,155003,1506782,1240155,115085
2020/04/23,Cádiz,Huelva,638,521870,52704,469166,1240155,115085
2020/04/23,Cádiz,Ceuta,16,84777,8082,76695,1240155,115085
2020/04/23,Cádiz,Cádiz,88976,1240155,112495,1127660,1240155,115085
2020/04/23,Cádiz,Sevilla,801,1942389,199037,1743352,1240155,115085
2020/04/23,Cantabria,Bizkaia,355,1152934,166513,986421,580795,66812
2020/04/23,Cantabria,Cantabria,48829,580795,69798,510997,580795,66812
2020/04/23,Cantabria,Asturias,118,1022800,110105,912695,580795,66812
2020/04/23,Cantabria,Palencia,41,160866,11481,149385,580795,66812
2020/04/23,Castellón,Teruel,39,134137,5390,128747,579962,67247
2020/04/23,Castellón,Castellón,46073,579962,64224,515738,579962,67247
2020/04/23,Castellón,Tarragona,676,804664,79876,724788,579962,67247
2020/04/23,Castellón,Valencia,576,2565124,340919,2224205,579962,67247
2020/04/23,Ceuta,Ceuta,7676,84777,8082,76695,84777,8032
2020/04/23,Ciudad Real,Albacete,470,388167,28085,360082,495761,33630
2020/04/23,Ciudad Real,Jaén,21,633564,54068,579496,495761,33630
2020/04/23,Ciudad Real,Ciudad Real,20823,495761,36252,459509,495761,33630
2020/04/23,Ciudad Real,Badajoz,53,673559,63928,609631,495761,33630
2020/04/23,Ciudad Real,Toledo,192,694844,70705,624139,495761,33630
2020/04/23,Ciudad Real,Córdoba,380,782979,79765,703214,495761,33630
2020/04/23,Córdoba,Málaga,186,1661785,155003,1506782,782979,78061
2020/04/23,Córdoba,Jaén,688,633564,54068,579496,782979,78061
2020/04/23,Córdoba,Granada,124,914678,96498,818180,782979,78061
2020/04/23,Córdoba,Badajoz,97,673559,63928,609631,782979,78061
2020/04/23,Córdoba,Córdoba,53216,782979,79765,703214,782979,78061
2020/04/23,Córdoba,Sevilla,1521,1942389,199037,1743352,782979,78061
2020/04/23,Córdoba,Ciudad Real,229,495761,36252,459509,782979,78061
2020/04/23,Coruña,Pontevedra,4292,942665,122969,819696,1119596,138497
2020/04/23,Coruña,Lugo,556,329587,35192,294395,1119596,138497
2020/04/23,Coruña,Coruña,103136,1119596,138920,980676,1119596,138497
2020/04/23,Cuenca,Albacete,561,388167,28085,360082,196329,16328
2020/04/23,Cuenca,Toledo,153,694844,70705,624139,196329,16328
2020/04/23,Cuenca,Valencia,37,2565124,340919,2224205,196329,16328
2020/04/23,Cuenca,Guadalajara,23,257762,27883,229879,196329,16328
2020/04/23,Cuenca,Madrid,60,6663394,740326,5923068,196329,16328
2020/04/23,Cuenca,Ciudad Real,87,495761,36252,459509,196329,16328
2020/04/23,Cuenca,Cuenca,7747,196329,15805,180524,196329,16328
2020/04/23,Gipuzkoa,Araba,140,331549,43878,287671,723576,86879
2020/04/23,Gipuzkoa,Bizkaia,987,1152934,166513,986421,723576,86879
2020/04/23,Gipuzkoa,Gipuzkoa,60915,723576,82960,640616,723576,86879
2020/04/23,Gipuzkoa,Navarra,270,654183,77908,576275,723576,86879
2020/04/23,Girona,Girona,47453,771044,72993,698051,771044,77312
2020/04/23,Girona,Barcelona,1825,5664579,693676,4970903,771044,77312
2020/04/23,Girona,Lleida,101,434930,49190,385740,771044,77312
2020/04/23,Granada,Málaga,99,1661785,155003,1506782,914678,94499
2020/04/23,Granada,Córdoba,248,782979,79765,703214,914678,94499
2020/04/23,Granada,Almería,395,716820,75766,641054,914678,94499
2020/04/23,Granada,Jaén,333,633564,54068,579496,914678,94499
2020/04/23,Granada,Granada,67625,914678,96498,818180,914678,94499
2020/04/23,Guadalajara,Madrid,1486,6663394,740326,5923068,257762,29076
2020/04/23,Guadalajara,Teruel,22,134137,5390,128747,257762,29076
2020/04/23,Guadalajara,Guadalajara,16166,257762,27883,229879,257762,29076
2020/04/23,Guadalajara,Cuenca,42,196329,15805,180524,257762,29076
2020/04/23,Huelva,Huelva,38000,521870,52704,469166,521870,55494
2020/04/23,Huelva,Cádiz,515,1240155,112495,1127660,521870,55494
2020/04/23,Huelva,Sevilla,1066,1942389,199037,1743352,521870,55494
2020/04/23,Huelva,Badajoz,301,673559,63928,609631,521870,55494
2020/04/23,Huesca,Huesca,9270,220461,15114,205347,220461,16012
2020/04/23,Huesca,Zaragoza,127,964724,81249,883475,220461,16012
2020/04/23,Huesca,Lleida,519,434930,49190,385740,220461,16012
2020/04/23,Jaén,Granada,240,914678,96498,818180,633564,52515
2020/04/23,Jaén,Jaén,36020,633564,54068,579496,633564,52515
2020/04/23,Jaén,Córdoba,700,782979,79765,703214,633564,52515
2020/04/23,Las Palmas de Gran Canaria,Las Palmas de Gran Canaria,104173,1120406,117586,1002820,1120406,117000
2020/04/23,León,Zamora,32,172539,12211,160328,460001,35042
2020/04/23,León,Palencia,26,160866,11481,149385,460001,35042
2020/04/23,León,León,24565,460001,35514,424487,460001,35042
2020/04/23,León,Asturias,21,1022800,110105,912695,460001,35042
2020/04/23,León,Valladolid,18,519546,37378,482168,460001,35042
2020/04/23,León,Ourense,161,307651,39207,268444,460001,35042
2020/04/23,Lleida,Zaragoza,68,964724,81249,883475,434930,47469
2020/04/23,Lleida,Tarragona,44,804664,79876,724788,434930,47469
2020/04/23,Lleida,Barcelona,193,5664579,693676,4970903,434930,47469
2020/04/23,Lleida,Girona,133,771044,72993,698051,434930,47469
2020/04/23,Lleida,Huesca,492,220461,15114,205347,434930,47469
2020/04/23,Lleida,Lleida,30825,434930,49190,385740,434930,47469
2020/04/23,Lugo,Asturias,563,1022800,110105,912695,329587,35708
2020/04/23,Lugo,Ourense,160,307651,39207,268444,329587,35708
2020/04/23,Lugo,Pontevedra,29,942665,122969,819696,329587,35708
2020/04/23,Lugo,Lugo,24272,329587,35192,294395,329587,35708
2020/04/23,Lugo,Coruña,563,1119596,138920,980676,329587,35708
2020/04/23,Madrid,Cuenca,70,196329,15805,180524,6663394,744823
2020/04/23,Madrid,Ávila,180,157640,9984,147656,6663394,744823
2020/04/23,Madrid,Guadalajara,1899,257762,27883,229879,6663394,744823
2020/04/23,Madrid,Toledo,2903,694844,70705,624139,6663394,744823
2020/04/23,Madrid,Valencia,38,2565124,340919,2224205,6663394,744823
2020/04/23,Madrid,Madrid,412988,6663394,740326,5923068,6663394,744823
2020/04/23,Málaga,Córdoba,300,782979,79765,703214,1661785,158353
2020/04/23,Málaga,Málaga,120347,1661785,155003,1506782,1661785,158353
2020/04/23,Málaga,Granada,218,914678,96498,818180,1661785,158353
2020/04/23,Málaga,Melilla,18,86487,10404,76083,1661785,158353
2020/04/23,Málaga,Sevilla,274,1942389,199037,1743352,1661785,158353
2020/04/23,Málaga,Cádiz,732,1240155,112495,1127660,1661785,158353
2020/04/23,Melilla,Melilla,10041,86487,10404,76083,86487,10209
2020/04/23,Murcia,Albacete,413,388167,28085,360082,1493898,168483
2020/04/23,Murcia,Granada,16,914678,96498,818180,1493898,168483
2020/04/23,Murcia,Alicante,2210,1858683,199144,1659539,1493898,168483
2020/04/23,Murcia,Murcia,125778,1493898,170997,1322901,1493898,168483
2020/04/23,Murcia,Almería,1087,716820,75766,641054,1493898,168483
2020/04/23,Navarra,Rioja,2013,316798,36484,280314,654183,79333
2020/04/23,Navarra,Gipuzkoa,270,723576,82960,640616,654183,79333
2020/04/23,Navarra,Zaragoza,442,964724,81249,883475,654183,79333
2020/04/23,Navarra,Alicante,18,1858683,199144,1659539,654183,79333
2020/04/23,Navarra,Navarra,52892,654183,77908,576275,654183,79333
2020/04/23,Ourense,Lugo,145,329587,35192,294395,307651,39260
2020/04/23,Ourense,León,114,460001,35514,424487,307651,39260
2020/04/23,Ourense,Ourense,29806,307651,39207,268444,307651,39260
2020/04/23,Ourense,Pontevedra,171,942665,122969,819696,307651,39260
2020/04/23,Ourense,Zamora,56,172539,12211,160328,307651,39260
2020/04/23,Palencia,Cantabria,53,580795,69798,510997,160866,11671
2020/04/23,Palencia,Palencia,7655,160866,11481,149385,160866,11671
2020/04/23,Palencia,Burgos,108,357072,22605,334467,160866,11671
2020/04/23,Pontevedra,Pontevedra,92065,942665,122969,819696,942665,120770
2020/04/23,Pontevedra,Lugo,28,329587,35192,294395,942665,120770
2020/04/23,Pontevedra,Coruña,3506,1119596,138920,980676,942665,120770
2020/04/23,Pontevedra,Ourense,132,307651,39207,268444,942665,120770
2020/04/23,Rioja,Navarra,1695,654183,77908,576275,316798,34475
2020/04/23,Rioja,Burgos,20,357072,22605,334467,316798,34475
2020/04/23,Rioja,Rioja,25206,316798,36484,280314,316798,34475
2020/04/23,Rioja,Araba,540,331549,43878,287671,316798,34475
2020/04/23,Salamanca,Ávila,226,157640,9984,147656,330119,24607
2020/04/23,Salamanca,Salamanca,18400,330119,25176,304943,330119,24607
2020/04/23,Santa Cruz de Tenerife,Santa Cruz de Tenerife,93961,1032983,108010,924973,1032983,107657
2020/04/23,Segovia,Valladolid,91,519546,37378,482168,153129,11533
2020/04/23,Segovia,Burgos,80,357072,22605,334467,153129,11533
2020/04/23,Segovia,Ávila,53,157640,9984,147656,153129,11533
2020/04/23,Segovia,Segovia,6654,153129,11167,141962,153129,11533
2020/04/23,Sevilla,Badajoz,22,673559,63928,609631,1942389,195110
2020/04/23,Sevilla,Sevilla,126412,1942389,199037,1743352,1942389,195110
2020/04/23,Sevilla,Málaga,95,1661785,155003,1506782,1942389,195110
2020/04/23,Sevilla,Córdoba,1575,782979,79765,703214,1942389,195110
2020/04/23,Sevilla,Huelva,335,521870,52704,469166,1942389,195110
2020/04/23,Sevilla,Cádiz,601,1240155,112495,1127660,1942389,195110
2020/04/23,Soria,Segovia,19,153129,11167,141962,88636,4526
2020/04/23,Soria,Soria,2797,88636,4561,84075,88636,4526
2020/04/23,Soria,Valladolid,19,519546,37378,482168,88636,4526
2020/04/23,Tarragona,Barcelona,701,5664579,693676,4970903,804664,79657
2020/04/23,Tarragona,Tarragona,50373,804664,79876,724788,804664,79657
2020/04/23,Tarragona,Castellón,631,579962,64224,515738,804664,79657
2020/04/23,Tarragona,Teruel,46,134137,5390,128747,804664,79657
2020/04/23,Teruel,Castellón,38,579962,64224,515738,134137,5814
2020/04/23,Teruel,Guadalajara,26,257762,27883,229879,134137,5814
2020/04/23,Teruel,Tarragona,52,804664,79876,724788,134137,5814
2020/04/23,Teruel,Teruel,2242,134137,5390,128747,134137,5814
2020/04/23,Teruel,Zaragoza,34,964724,81249,883475,134137,5814
2020/04/23,Toledo,Cuenca,87,196329,15805,180524,694844,67731
2020/04/23,Toledo,Cáceres,160,394151,30815,363336,694844,67731
2020/04/23,Toledo,Ciudad Real,280,495761,36252,459509,694844,67731
2020/04/23,Toledo,Ávila,128,157640,9984,147656,694844,67731
2020/04/23,Toledo,Madrid,2694,6663394,740326,5923068,694844,67731
2020/04/23,Toledo,Toledo,33376,694844,70705,624139,694844,67731
2020/04/23,Valencia,Valencia,227119,2565124,340919,2224205,2565124,332742
2020/04/23,Valencia,Madrid,20,6663394,740326,5923068,2565124,332742
2020/04/23,Valencia,Castellón,579,579962,64224,515738,2565124,332742
2020/04/23,Valencia,Albacete,323,388167,28085,360082,2565124,332742
2020/04/23,Valencia,Cuenca,64,196329,15805,180524,2565124,332742
2020/04/23,Valencia,Alicante,803,1858683,199144,1659539,2565124,332742
2020/04/23,Valladolid,Ávila,21,157640,9984,147656,519546,35694
2020/04/23,Valladolid,Zamora,84,172539,12211,160328,519546,35694
2020/04/23,Valladolid,Valladolid,24429,519546,37378,482168,519546,35694
2020/04/23,Valladolid,Soria,24,88636,4561,84075,519546,35694
2020/04/23,Valladolid,Segovia,162,153129,11167,141962,519546,35694
2020/04/23,Valladolid,Burgos,80,357072,22605,334467,519546,35694
2020/04/23,Zamora,Zamora,8116,172539,12211,160328,172539,12019
2020/04/23,Zamora,Ourense,69,307651,39207,268444,172539,12019
2020/04/23,Zamora,Salamanca,17,330119,25176,304943,172539,12019
2020/04/23,Zamora,Valladolid,66,519546,37378,482168,172539,12019
2020/04/23,Zaragoza,Teruel,25,134137,5390,128747,964724,77625
2020/04/23,Zaragoza,Navarra,286,654183,77908,576275,964724,77625
2020/04/23,Zaragoza,Huesca,168,220461,15114,205347,964724,77625
2020/04/23,Zaragoza,Zaragoza,55890,964724,81249,883475,964724,77625
2020/04/23,Zaragoza,Lleida,87,434930,49190,385740,964724,77625
2020/04/24,Albacete,Albacete,17042,388167,28167,360000,388167,28339
2020/04/24,Albacete,Cuenca,550,196329,16212,180117,388167,28339
2020/04/24,Albacete,Murcia,301,1493898,171655,1322243,388167,28339
2020/04/24,Albacete,Valencia,343,2565124,342776,2222348,388167,28339
2020/04/24,Albacete,Jaén,37,633564,54302,579262,388167,28339
2020/04/24,Albacete,Alicante,191,1858683,212900,1645783,388167,28339
2020/04/24,Albacete,Ciudad Real,565,495761,35796,459965,388167,28339
2020/04/24,Alicante,Albacete,303,388167,28167,360000,1858683,216508
2020/04/24,Alicante,Murcia,2699,1493898,171655,1322243,1858683,216508
2020/04/24,Alicante,Alicante,162465,1858683,212900,1645783,1858683,216508
2020/04/24,Alicante,Valencia,811,2565124,342776,2222348,1858683,216508
2020/04/24,Almería,Almería,61830,716820,76046,640774,716820,77642
2020/04/24,Almería,Alicante,18,1858683,212900,1645783,716820,77642
2020/04/24,Almería,Murcia,1749,1493898,171655,1322243,716820,77642
2020/04/24,Almería,Granada,486,914678,96973,817705,716820,77642
2020/04/24,Araba,Gipuzkoa,142,723576,83155,640421,331549,50338
2020/04/24,Araba,Araba,36254,331549,44949,286600,331549,50338
2020/04/24,Araba,Rioja,1564,316798,36956,279842,331549,50338
2020/04/24,Araba,Bizkaia,999,1152934,166287,986647,331549,50338
2020/04/24,Araba,Burgos,1312,357072,30481,326591,331549,50338
2020/04/24,Araba,Navarra,128,654183,78578,575605,331549,50338
2020/04/24,Asturias,Asturias,85842,1022800,112019,910781,1022800,112251
2020/04/24,Asturias,Cantabria,167,580795,68065,512730,1022800,112251
2020/04/24,Asturias,León,33,460001,48811,411190,1022800,112251
2020/04/24,Asturias,Lugo,808,329587,36405,293182,1022800,112251
2020/04/24,Ávila,Cáceres,62,394151,30453,363698,157640,13365
2020/04/24,Ávila,Ávila,8189,157640,12778,144862,157640,13365
2020/04/24,Ávila,Segovia,81,153129,14619,138510,157640,13365
2020/04/24,Ávila,Salamanca,232,330119,34564,295555,157640,13365
2020/04/24,Ávila,Madrid,112,6663394,761349,5902045,157640,13365
2020/04/24,Ávila,Toledo,185,694844,69039,625805,157640,13365
2020/04/24,Badajoz,Badajoz,46186,673559,64372,609187,673559,63443
2020/04/24,Badajoz,Ciudad Real,33,495761,35796,459965,673559,63443
2020/04/24,Badajoz,Huelva,223,521870,52737,469133,673559,63443
2020/04/24,Badajoz,Sevilla,30,1942389,199697,1742692,673559,63443
2020/04/24,Badajoz,Córdoba,27,782979,80634,702345,673559,63443
2020/04/24,Badajoz,Cáceres,941,394151,30453,363698,673559,63443
2020/04/24,Balears,Valencia,39,2565124,342776,2222348,1149460,109452
2020/04/24,Balears,Balears,91101,1149460,108665,1040795,1149460,109452
2020/04/24,Barcelona,Barcelona,429703,5664579,701203,4963376,5664579,702829
2020/04/24,Barcelona,Tarragona,1062,804664,81699,722965,5664579,702829
2020/04/24,Barcelona,Lleida,171,434930,50618,384312,5664579,702829
2020/04/24,Barcelona,Girona,2270,771044,74561,696483,5664579,702829
2020/04/24,Bizkaia,Cantabria,1444,580795,68065,512730,1152934,162895
2020/04/24,Bizkaia,Araba,607,331549,44949,286600,1152934,162895
2020/04/24,Bizkaia,Bizkaia,121079,1152934,166287,986647,1152934,162895
2020/04/24,Bizkaia,Gipuzkoa,816,723576,83155,640421,1152934,162895
2020/04/24,Bizkaia,Burgos,31,357072,30481,326591,1152934,162895
2020/04/24,Burgos,Cantabria,26,580795,68065,512730,357072,30658
2020/04/24,Burgos,Burgos,21452,357072,30481,326591,357072,30658
2020/04/24,Burgos,Rioja,28,316798,36956,279842,357072,30658
2020/04/24,Burgos,Valladolid,53,519546,55177,464369,357072,30658
2020/04/24,Burgos,Segovia,29,153129,14619,138510,357072,30658
2020/04/24,Burgos,Bizkaia,66,1152934,166287,986647,357072,30658
2020/04/24,Burgos,Araba,723,331549,44949,286600,357072,30658
2020/04/24,Burgos,Palencia,172,160866,15495,145371,357072,30658
2020/04/24,Cáceres,Ávila,75,157640,12778,144862,394151,30265
2020/04/24,Cáceres,Badajoz,1047,673559,64372,609187,394151,30265
2020/04/24,Cáceres,Toledo,182,694844,69039,625805,394151,30265
2020/04/24,Cáceres,Cáceres,19372,394151,30453,363698,394151,30265
2020/04/24,Cádiz,Almería,19,716820,76046,640774,1240155,115125
2020/04/24,Cádiz,Málaga,1002,1661785,153717,1508068,1240155,115125
2020/04/24,Cádiz,Ceuta,17,84777,8060,76717,1240155,115125
2020/04/24,Cádiz,Huelva,677,521870,52737,469133,1240155,115125
2020/04/24,Cádiz,Sevilla,788,1942389,199697,1742692,1240155,115125
2020/04/24,Cádiz,Cádiz,90185,1240155,112974,1127181,1240155,115125
2020/04/24,Cantabria,Palencia,47,160866,15495,145371,580795,65145
2020/04/24,Cantabria,Bizkaia,373,1152934,166287,986647,580795,65145
2020/04/24,Cantabria,Asturias,145,1022800,112019,910781,580795,65145
2020/04/24,Cantabria,Cantabria,47452,580795,68065,512730,580795,65145
2020/04/24,Castellón,Teruel,44,134137,7703,126434,579962,68734
2020/04/24,Castellón,Tarragona,793,804664,81699,722965,579962,68734
2020/04/24,Castellón,Castellón,48216,579962,65915,514047,579962,68734
2020/04/24,Castellón,Valencia,645,2565124,342776,2222348,579962,68734
2020/04/24,Ceuta,Ceuta,7659,84777,8060,76717,84777,8035
2020/04/24,Ciudad Real,Albacete,447,388167,28167,360000,495761,33498
2020/04/24,Ciudad Real,Cuenca,57,196329,16212,180117,495761,33498
2020/04/24,Ciudad Real,Córdoba,362,782979,80634,702345,495761,33498
2020/04/24,Ciudad Real,Badajoz,54,673559,64372,609187,495761,33498
2020/04/24,Ciudad Real,Toledo,163,694844,69039,625805,495761,33498
2020/04/24,Ciudad Real,Ciudad Real,20572,495761,35796,459965,495761,33498
2020/04/24,Ciudad Real,Jaén,19,633564,54302,579262,495761,33498
2020/04/24,Córdoba,Sevilla,1455,1942389,199697,1742692,782979,78793
2020/04/24,Córdoba,Jaén,672,633564,54302,579262,782979,78793
2020/04/24,Córdoba,Granada,112,914678,96973,817705,782979,78793
2020/04/24,Córdoba,Badajoz,67,673559,64372,609187,782979,78793
2020/04/24,Córdoba,Ciudad Real,263,495761,35796,459965,782979,78793
2020/04/24,Córdoba,Málaga,290,1661785,153717,1508068,782979,78793
2020/04/24,Córdoba,Córdoba,54621,782979,80634,702345,782979,78793
2020/04/24,Coruña,Coruña,108275,1119596,144451,975145,1119596,145821
2020/04/24,Coruña,Pontevedra,4208,942665,128042,814623,1119596,145821
2020/04/24,Coruña,Lugo,505,329587,36405,293182,1119596,145821
2020/04/24,Cuenca,Madrid,66,6663394,761349,5902045,196329,16343
2020/04/24,Cuenca,Valencia,73,2565124,342776,2222348,196329,16343
2020/04/24,Cuenca,Ciudad Real,89,495761,35796,459965,196329,16343
2020/04/24,Cuenca,Albacete,571,388167,28167,360000,196329,16343
2020/04/24,Cuenca,Guadalajara,24,257762,28717,229045,196329,16343
2020/04/24,Cuenca,Cuenca,8064,196329,16212,180117,196329,16343
2020/04/24,Cuenca,Toledo,142,694844,69039,625805,196329,16343
2020/04/24,Gipuzkoa,Araba,91,331549,44949,286600,723576,86348
2020/04/24,Gipuzkoa,Gipuzkoa,61055,723576,83155,640421,723576,86348
2020/04/24,Gipuzkoa,Bizkaia,998,1152934,166287,986647,723576,86348
2020/04/24,Gipuzkoa,Navarra,207,654183,78578,575605,723576,86348
2020/04/24,Girona,Barcelona,1788,5664579,701203,4963376,771044,78035
2020/04/24,Girona,Girona,48708,771044,74561,696483,771044,78035
2020/04/24,Girona,Murcia,16,1493898,171655,1322243,771044,78035
2020/04/24,Girona,Lleida,140,434930,50618,384312,771044,78035
2020/04/24,Granada,Jaén,391,633564,54302,579262,914678,95112
2020/04/24,Granada,Almería,318,716820,76046,640774,914678,95112
2020/04/24,Granada,Granada,68395,914678,96973,817705,914678,95112
2020/04/24,Granada,Málaga,143,1661785,153717,1508068,914678,95112
2020/04/24,Granada,Córdoba,257,782979,80634,702345,914678,95112
2020/04/24,Guadalajara,Madrid,1445,6663394,761349,5902045,257762,29727
2020/04/24,Guadalajara,Cuenca,57,196329,16212,180117,257762,29727
2020/04/24,Guadalajara,Guadalajara,16793,257762,28717,229045,257762,29727
2020/04/24,Huelva,Badajoz,382,673559,64372,609187,521870,55116
2020/04/24,Huelva,Cádiz,541,1240155,112974,1127181,521870,55116
2020/04/24,Huelva,Sevilla,1173,1942389,199697,1742692,521870,55116
2020/04/24,Huelva,Huelva,38740,521870,52737,469133,521870,55116
2020/04/24,Huesca,Lleida,783,434930,50618,384312,220461,23153
2020/04/24,Huesca,Zaragoza,172,964724,110926,853798,220461,23153
2020/04/24,Huesca,Huesca,13879,220461,20926,199535,220461,23153
2020/04/24,Jaén,Jaén,36769,633564,54302,579262,633564,53209
2020/04/24,Jaén,Córdoba,765,782979,80634,702345,633564,53209
2020/04/24,Jaén,Albacete,18,388167,28167,360000,633564,53209
2020/04/24,Jaén,Granada,270,914678,96973,817705,633564,53209
2020/04/24,Las Palmas de Gran Canaria,Las Palmas de Gran Canaria,106841,1120406,119437,1000969,1120406,118268
2020/04/24,León,Asturias,31,1022800,112019,910781,460001,48449
2020/04/24,León,Ourense,196,307651,40497,267154,460001,48449
2020/04/24,León,Palencia,30,160866,15495,145371,460001,48449
2020/04/24,León,León,35406,460001,48811,411190,460001,48449
2020/04/24,León,Zamora,106,172539,16738,155801,460001,48449
2020/04/24,Lleida,Lleida,31800,434930,50618,384312,434930,48238
2020/04/24,Lleida,Huesca,550,220461,20926,199535,434930,48238
2020/04/24,Lleida,Girona,134,771044,74561,696483,434930,48238
2020/04/24,Lleida,Barcelona,174,5664579,701203,4963376,434930,48238
2020/04/24,Lleida,Zaragoza,80,964724,110926,853798,434930,48238
2020/04/24,Lugo,Ourense,101,307651,40497,267154,329587,37355
2020/04/24,Lugo,Coruña,535,1119596,144451,975145,329587,37355
2020/04/24,Lugo,Lugo,25301,329587,36405,293182,329587,37355
2020/04/24,Lugo,Asturias,591,1022800,112019,910781,329587,37355
2020/04/24,Madrid,Ávila,207,157640,12778,144862,6663394,765730
2020/04/24,Madrid,Segovia,17,153129,14619,138510,6663394,765730
2020/04/24,Madrid,Melilla,17,86487,10584,75903,6663394,765730
2020/04/24,Madrid,Toledo,2988,694844,69039,625805,6663394,765730
2020/04/24,Madrid,Ciudad Real,17,495761,35796,459965,6663394,765730
2020/04/24,Madrid,Cuenca,109,196329,16212,180117,6663394,765730
2020/04/24,Madrid,Valencia,58,2565124,342776,2222348,6663394,765730
2020/04/24,Madrid,Guadalajara,1926,257762,28717,229045,6663394,765730
2020/04/24,Madrid,Madrid,429298,6663394,761349,5902045,6663394,765730
2020/04/24,Madrid,Alicante,18,1858683,212900,1645783,6663394,765730
2020/04/24,Málaga,Sevilla,295,1942389,199697,1742692,1661785,156163
2020/04/24,Málaga,Granada,240,914678,96973,817705,1661785,156163
2020/04/24,Málaga,Córdoba,330,782979,80634,702345,1661785,156163
2020/04/24,Málaga,Málaga,119438,1661785,153717,1508068,1661785,156163
2020/04/24,Málaga,Cádiz,645,1240155,112974,1127181,1661785,156163
2020/04/24,Melilla,Melilla,10314,86487,10584,75903,86487,10506
2020/04/24,Murcia,Albacete,365,388167,28167,360000,1493898,168632
2020/04/24,Murcia,Almería,1116,716820,76046,640774,1493898,168632
2020/04/24,Murcia,Barcelona,16,5664579,701203,4963376,1493898,168632
2020/04/24,Murcia,Alicante,2128,1858683,212900,1645783,1493898,168632
2020/04/24,Murcia,Murcia,127017,1493898,171655,1322243,1493898,168632
2020/04/24,Navarra,Gipuzkoa,209,723576,83155,640421,654183,79155
2020/04/24,Navarra,Navarra,53602,654183,78578,575605,654183,79155
2020/04/24,Navarra,Rioja,2063,316798,36956,279842,654183,79155
2020/04/24,Navarra,Zaragoza,496,964724,110926,853798,654183,79155
2020/04/24,Navarra,Araba,59,331549,44949,286600,654183,79155
2020/04/24,Ourense,León,103,460001,48811,411190,307651,40650
2020/04/24,Ourense,Ourense,30673,307651,40497,267154,307651,40650
2020/04/24,Ourense,Pontevedra,174,942665,128042,814623,307651,40650
2020/04/24,Ourense,Zamora,61,172539,16738,155801,307651,40650
2020/04/24,Ourense,Lugo,203,329587,36405,293182,307651,40650
2020/04/24,Palencia,Palencia,10718,160866,15495,145371,160866,16313
2020/04/24,Palencia,Burgos,161,357072,30481,326591,160866,16313
2020/04/24,Palencia,Cantabria,81,580795,68065,512730,160866,16313
2020/04/24,Palencia,Valladolid,32,519546,55177,464369,160866,16313
2020/04/24,Pontevedra,Coruña,3449,1119596,144451,975145,942665,127227
2020/04/24,Pontevedra,Ourense,152,307651,40497,267154,942665,127227
2020/04/24,Pontevedra,Pontevedra,97096,942665,128042,814623,942665,127227
2020/04/24,Rioja,Araba,652,331549,44949,286600,316798,35375
2020/04/24,Rioja,Rioja,25999,316798,36956,279842,316798,35375
2020/04/24,Rioja,Navarra,1858,654183,78578,575605,316798,35375
2020/04/24,Salamanca,Salamanca,26281,330119,34564,295555,330119,33726
2020/04/24,Salamanca,Ávila,127,157640,12778,144862,330119,33726
2020/04/24,Santa Cruz de Tenerife,Santa Cruz de Tenerife,95773,1032983,109701,923282,1032983,109086
2020/04/24,Santa Cruz de Tenerife,Las Palmas de Gran Canaria,16,1120406,119437,1000969,1032983,109086
2020/04/24,Segovia,Valladolid,339,519546,55177,464369,153129,15930
2020/04/24,Segovia,Burgos,91,357072,30481,326591,153129,15930
2020/04/24,Segovia,Segovia,9261,153129,14619,138510,153129,15930
2020/04/24,Segovia,Ávila,119,157640,12778,144862,153129,15930
2020/04/24,Sevilla,Córdoba,1629,782979,80634,702345,1942389,196900
2020/04/24,Sevilla,Málaga,95,1661785,153717,1508068,1942389,196900
2020/04/24,Sevilla,Huelva,409,521870,52737,469133,1942389,196900
2020/04/24,Sevilla,Cádiz,579,1240155,112974,1127181,1942389,196900
2020/04/24,Sevilla,Sevilla,128851,1942389,199697,1742692,1942389,196900
2020/04/24,Soria,Soria,3891,88636,5706,82930,88636,6055
2020/04/24,Soria,Segovia,21,153129,14619,138510,88636,6055
2020/04/24,Soria,Burgos,33,357072,30481,326591,88636,6055
2020/04/24,Soria,Valladolid,70,519546,55177,464369,88636,6055
2020/04/24,Soria,Zaragoza,74,964724,110926,853798,88636,6055
2020/04/24,Tarragona,Tarragona,51900,804664,81699,722965,804664,81380
2020/04/24,Tarragona,Castellón,640,579962,65915,514047,804664,81380
2020/04/24,Tarragona,Teruel,36,134137,7703,126434,804664,81380
2020/04/24,Tarragona,Zaragoza,42,964724,110926,853798,804664,81380
2020/04/24,Tarragona,Barcelona,702,5664579,701203,4963376,804664,81380
2020/04/24,Tarragona,Lleida,25,434930,50618,384312,804664,81380
2020/04/24,Teruel,Teruel,4147,134137,7703,126434,134137,8883
2020/04/24,Teruel,Zaragoza,39,964724,110926,853798,134137,8883
2020/04/24,Teruel,Castellón,80,579962,65915,514047,134137,8883
2020/04/24,Teruel,Tarragona,71,804664,81699,722965,134137,8883
2020/04/24,Toledo,Cuenca,53,196329,16212,180117,694844,66036
2020/04/24,Toledo,Ávila,91,157640,12778,144862,694844,66036
2020/04/24,Toledo,Toledo,32029,694844,69039,625805,694844,66036
2020/04/24,Toledo,Cáceres,167,394151,30453,363698,694844,66036
2020/04/24,Toledo,Ciudad Real,234,495761,35796,459965,694844,66036
2020/04/24,Toledo,Madrid,2795,6663394,761349,5902045,694844,66036
2020/04/24,Valencia,Cuenca,100,196329,16212,180117,2565124,335609
2020/04/24,Valencia,Valencia,230968,2565124,342776,2222348,2565124,335609
2020/04/24,Valencia,Alicante,823,1858683,212900,1645783,2565124,335609
2020/04/24,Valencia,Madrid,27,6663394,761349,5902045,2565124,335609
2020/04/24,Valencia,Castellón,626,579962,65915,514047,2565124,335609
2020/04/24,Valencia,Albacete,308,388167,28167,360000,2565124,335609
2020/04/24,Valladolid,Segovia,239,153129,14619,138510,519546,53439
2020/04/24,Valladolid,Ávila,23,157640,12778,144862,519546,53439
2020/04/24,Valladolid,Burgos,81,357072,30481,326591,519546,53439
2020/04/24,Valladolid,Palencia,21,160866,15495,145371,519546,53439
2020/04/24,Valladolid,Soria,44,88636,5706,82930,519546,53439
2020/04/24,Valladolid,Zamora,145,172539,16738,155801,519546,53439
2020/04/24,Valladolid,Valladolid,37878,519546,55177,464369,519546,53439
2020/04/24,Zamora,Zamora,11311,172539,16738,155801,172539,16707
2020/04/24,Zamora,Ourense,35,307651,40497,267154,172539,16707
2020/04/24,Zamora,Valladolid,108,519546,55177,464369,172539,16707
2020/04/24,Zamora,León,57,460001,48811,411190,172539,16707
2020/04/24,Zaragoza,Zaragoza,78218,964724,110926,853798,964724,106273
2020/04/24,Zaragoza,Huesca,289,220461,20926,199535,964724,106273
2020/04/24,Zaragoza,Lleida,81,434930,50618,384312,964724,106273
2020/04/24,Zaragoza,Navarra,309,654183,78578,575605,964724,106273
2020/04/24,Zaragoza,Teruel,143,134137,7703,126434,964724,106273
2020/04/25,Albacete,Cuenca,400,196329,10579,185750,388167,19010
2020/04/25,Albacete,Albacete,12075,388167,19067,369100,388167,19010
2020/04/25,Albacete,Jaén,44,633564,34981,598583,388167,19010
2020/04/25,Albacete,Alicante,83,1858683,143322,1715361,388167,19010
2020/04/25,Albacete,Ciudad Real,363,495761,23159,472602,388167,19010
2020/04/25,Albacete,Murcia,269,1493898,112110,1381788,388167,19010
2020/04/25,Albacete,Valencia,264,2565124,223026,2342098,388167,19010
2020/04/25,Alicante,Murcia,1907,1493898,112110,1381788,1858683,144195
2020/04/25,Alicante,Albacete,146,388167,19067,369100,1858683,144195
2020/04/25,Alicante,Valencia,452,2565124,223026,2342098,1858683,144195
2020/04/25,Alicante,Alicante,113716,1858683,143322,1715361,1858683,144195
2020/04/25,Almería,Almería,40375,716820,50806,666014,716820,51017
2020/04/25,Almería,Granada,336,914678,66565,848113,716820,51017
2020/04/25,Almería,Murcia,712,1493898,112110,1381788,716820,51017
2020/04/25,Almería,Melilla,21,86487,8229,78258,716820,51017
2020/04/25,Araba,Araba,23031,331549,28318,303231,331549,29273
2020/04/25,Araba,Navarra,32,654183,49769,604414,331549,29273
2020/04/25,Araba,Burgos,581,357072,20418,336654,331549,29273
2020/04/25,Araba,Bizkaia,447,1152934,108970,1043964,331549,29273
2020/04/25,Araba,Rioja,574,316798,22429,294369,331549,29273
2020/04/25,Araba,Gipuzkoa,41,723576,50033,673543,331549,29273
2020/04/25,Asturias,Asturias,56611,1022800,73126,949674,1022800,73615
2020/04/25,Asturias,Lugo,482,329587,24105,305482,1022800,73615
2020/04/25,Asturias,Cantabria,135,580795,44629,536166,1022800,73615
2020/04/25,Asturias,León,26,460001,36295,423706,1022800,73615
2020/04/25,Ávila,Cáceres,88,394151,21429,372722,157640,9835
2020/04/25,Ávila,Segovia,89,153129,10576,142553,157640,9835
2020/04/25,Ávila,Madrid,100,6663394,524403,6138991,157640,9835
2020/04/25,Ávila,Ávila,6370,157640,9284,148356,157640,9835
2020/04/25,Ávila,Toledo,237,694844,43893,650951,157640,9835
2020/04/25,Ávila,Salamanca,190,330119,25528,304591,157640,9835
2020/04/25,Badajoz,Huelva,205,521870,36796,485074,673559,42950
2020/04/25,Badajoz,Ciudad Real,53,495761,23159,472602,673559,42950
2020/04/25,Badajoz,Cáceres,611,394151,21429,372722,673559,42950
2020/04/25,Badajoz,Córdoba,44,782979,54417,728562,673559,42950
2020/04/25,Badajoz,Badajoz,31303,673559,43284,630275,673559,42950
2020/04/25,Balears,Balears,53609,1149460,66808,1082652,1149460,67508
2020/04/25,Barcelona,Lleida,46,434930,35160,399770,5664579,490131
2020/04/25,Barcelona,Girona,1834,771044,49224,721820,5664579,490131
2020/04/25,Barcelona,Barcelona,341109,5664579,488139,5176440,5664579,490131
2020/04/25,Barcelona,Tarragona,560,804664,56446,748218,5664579,490131
2020/04/25,Bizkaia,Araba,433,331549,28318,303231,1152934,108029
2020/04/25,Bizkaia,Bizkaia,83227,1152934,108970,1043964,1152934,108029
2020/04/25,Bizkaia,Gipuzkoa,344,723576,50033,673543,1152934,108029
2020/04/25,Bizkaia,Cantabria,346,580795,44629,536166,1152934,108029
2020/04/25,Burgos,Araba,589,331549,28318,303231,357072,20689
2020/04/25,Burgos,Soria,28,88636,3887,84749,357072,20689
2020/04/25,Burgos,Burgos,14806,357072,20418,336654,357072,20689
2020/04/25,Burgos,Rioja,20,316798,22429,294369,357072,20689
2020/04/25,Burgos,Palencia,110,160866,11489,149377,357072,20689
2020/04/25,Burgos,Valladolid,77,519546,39442,480104,357072,20689
2020/04/25,Burgos,Bizkaia,61,1152934,108970,1043964,357072,20689
2020/04/25,Cáceres,Ávila,70,157640,9284,148356,394151,21255
2020/04/25,Cáceres,Cáceres,13822,394151,21429,372722,394151,21255
2020/04/25,Cáceres,Badajoz,718,673559,43284,630275,394151,21255
2020/04/25,Cáceres,Toledo,110,694844,43893,650951,394151,21255
2020/04/25,Cádiz,Málaga,419,1661785,98070,1563715,1240155,82391
2020/04/25,Cádiz,Sevilla,520,1942389,134326,1808063,1240155,82391
2020/04/25,Cádiz,Huelva,593,521870,36796,485074,1240155,82391
2020/04/25,Cádiz,Cádiz,67198,1240155,81087,1159068,1240155,82391
2020/04/25,Cantabria,Palencia,30,160866,11489,149377,580795,44494
2020/04/25,Cantabria,Cantabria,32691,580795,44629,536166,580795,44494
2020/04/25,Cantabria,Asturias,125,1022800,73126,949674,580795,44494
2020/04/25,Cantabria,Bizkaia,273,1152934,108970,1043964,580795,44494
2020/04/25,Castellón,Teruel,32,134137,4663,129474,579962,39646
2020/04/25,Castellón,Valencia,535,2565124,223026,2342098,579962,39646
2020/04/25,Castellón,Castellón,27606,579962,39286,540676,579962,39646
2020/04/25,Castellón,Tarragona,664,804664,56446,748218,579962,39646
2020/04/25,Ceuta,Ceuta,5690,84777,6022,78755,84777,5951
2020/04/25,Ciudad Real,Toledo,104,694844,43893,650951,495761,22524
2020/04/25,Ciudad Real,Ciudad Real,13972,495761,23159,472602,495761,22524
2020/04/25,Ciudad Real,Badajoz,56,673559,43284,630275,495761,22524
2020/04/25,Ciudad Real,Albacete,440,388167,19067,369100,495761,22524
2020/04/25,Ciudad Real,Córdoba,294,782979,54417,728562,495761,22524
2020/04/25,Córdoba,Málaga,150,1661785,98070,1563715,782979,54148
2020/04/25,Córdoba,Sevilla,717,1942389,134326,1808063,782979,54148
2020/04/25,Córdoba,Badajoz,74,673559,43284,630275,782979,54148
2020/04/25,Córdoba,Ciudad Real,230,495761,23159,472602,782979,54148
2020/04/25,Córdoba,Granada,131,914678,66565,848113,782979,54148
2020/04/25,Córdoba,Jaén,419,633564,34981,598583,782979,54148
2020/04/25,Córdoba,Córdoba,39306,782979,54417,728562,782979,54148
2020/04/25,Coruña,Pontevedra,3188,942665,83385,859280,1119596,96788
2020/04/25,Coruña,Coruña,73110,1119596,95589,1024007,1119596,96788
2020/04/25,Coruña,Lugo,363,329587,24105,305482,1119596,96788
2020/04/25,Cuenca,Albacete,571,388167,19067,369100,196329,10840
2020/04/25,Cuenca,Toledo,149,694844,43893,650951,196329,10840
2020/04/25,Cuenca,Valencia,34,2565124,223026,2342098,196329,10840
2020/04/25,Cuenca,Ciudad Real,56,495761,23159,472602,196329,10840
2020/04/25,Cuenca,Madrid,22,6663394,524403,6138991,196329,10840
2020/04/25,Cuenca,Cuenca,5496,196329,10579,185750,196329,10840
2020/04/25,Gipuzkoa,Araba,18,331549,28318,303231,723576,50719
2020/04/25,Gipuzkoa,Bizkaia,434,1152934,108970,1043964,723576,50719
2020/04/25,Gipuzkoa,Gipuzkoa,37927,723576,50033,673543,723576,50719
2020/04/25,Gipuzkoa,Navarra,115,654183,49769,604414,723576,50719
2020/04/25,Girona,Girona,33294,771044,49224,721820,771044,50755
2020/04/25,Girona,Lleida,69,434930,35160,399770,771044,50755
2020/04/25,Girona,Barcelona,1290,5664579,488139,5176440,771044,50755
2020/04/25,Granada,Córdoba,106,782979,54417,728562,914678,66153
2020/04/25,Granada,Murcia,16,1493898,112110,1381788,914678,66153
2020/04/25,Granada,Granada,49088,914678,66565,848113,914678,66153
2020/04/25,Granada,Almería,181,716820,50806,666014,914678,66153
2020/04/25,Granada,Málaga,65,1661785,98070,1563715,914678,66153
2020/04/25,Granada,Jaén,75,633564,34981,598583,914678,66153
2020/04/25,Guadalajara,Guadalajara,10971,257762,17602,240160,257762,17378
2020/04/25,Guadalajara,Madrid,923,6663394,524403,6138991,257762,17378
2020/04/25,Guadalajara,Cuenca,46,196329,10579,185750,257762,17378
2020/04/25,Huelva,Cádiz,465,1240155,81087,1159068,521870,37393
2020/04/25,Huelva,Sevilla,875,1942389,134326,1808063,521870,37393
2020/04/25,Huelva,Badajoz,246,673559,43284,630275,521870,37393
2020/04/25,Huelva,Huelva,27007,521870,36796,485074,521870,37393
2020/04/25,Huesca,Zaragoza,205,964724,78696,886028,220461,14513
2020/04/25,Huesca,Huesca,9530,220461,14029,206432,220461,14513
2020/04/25,Huesca,Lleida,505,434930,35160,399770,220461,14513
2020/04/25,Jaén,Jaén,24706,633564,34981,598583,633564,34552
2020/04/25,Jaén,Córdoba,478,782979,54417,728562,633564,34552
2020/04/25,Jaén,Granada,166,914678,66565,848113,633564,34552
2020/04/25,Las Palmas de Gran Canaria,Las Palmas de Gran Canaria,65558,1120406,79355,1041051,1120406,78641
2020/04/25,Las Palmas de Gran Canaria,Santa Cruz de Tenerife,18,1032983,73734,959249,1120406,78641
2020/04/25,León,Ourense,54,307651,28249,279402,460001,35972
2020/04/25,León,León,26851,460001,36295,423706,460001,35972
2020/04/25,León,Zamora,38,172539,12211,160328,460001,35972
2020/04/25,León,Asturias,31,1022800,73126,949674,460001,35972
2020/04/25,Lleida,Girona,72,771044,49224,721820,434930,33848
2020/04/25,Lleida,Zaragoza,65,964724,78696,886028,434930,33848
2020/04/25,Lleida,Tarragona,24,804664,56446,748218,434930,33848
2020/04/25,Lleida,Barcelona,86,5664579,488139,5176440,434930,33848
2020/04/25,Lleida,Huesca,371,220461,14029,206432,434930,33848
2020/04/25,Lleida,Lleida,23248,434930,35160,399770,434930,33848
2020/04/25,Lugo,Ourense,94,307651,28249,279402,329587,24589
2020/04/25,Lugo,Lugo,17077,329587,24105,305482,329587,24589
2020/04/25,Lugo,Coruña,374,1119596,95589,1024007,329587,24589
2020/04/25,Lugo,Asturias,404,1022800,73126,949674,329587,24589
2020/04/25,Madrid,Madrid,351313,6663394,524403,6138991,6663394,525353
2020/04/25,Madrid,Ávila,117,157640,9284,148356,6663394,525353
2020/04/25,Madrid,Cuenca,73,196329,10579,185750,6663394,525353
2020/04/25,Madrid,Toledo,1851,694844,43893,650951,6663394,525353
2020/04/25,Madrid,Valencia,17,2565124,223026,2342098,6663394,525353
2020/04/25,Madrid,Guadalajara,941,257762,17602,240160,6663394,525353
2020/04/25,Málaga,Granada,74,914678,66565,848113,1661785,97607
2020/04/25,Málaga,Málaga,76121,1661785,98070,1563715,1661785,97607
2020/04/25,Málaga,Córdoba,89,782979,54417,728562,1661785,97607
2020/04/25,Málaga,Sevilla,66,1942389,134326,1808063,1661785,97607
2020/04/25,Málaga,Cádiz,400,1240155,81087,1159068,1661785,97607
2020/04/25,Melilla,Melilla,8026,86487,8229,78258,86487,8226
2020/04/25,Murcia,Alicante,1648,1858683,143322,1715361,1493898,111295
2020/04/25,Murcia,Almería,833,716820,50806,666014,1493898,111295
2020/04/25,Murcia,Murcia,83954,1493898,112110,1381788,1493898,111295
2020/04/25,Murcia,Albacete,238,388167,19067,369100,1493898,111295
2020/04/25,Navarra,Araba,20,331549,28318,303231,654183,49839
2020/04/25,Navarra,Zaragoza,322,964724,78696,886028,654183,49839
2020/04/25,Navarra,Gipuzkoa,78,723576,50033,673543,654183,49839
2020/04/25,Navarra,Navarra,34717,654183,49769,604414,654183,49839
2020/04/25,Navarra,Rioja,945,316798,22429,294369,654183,49839
2020/04/25,Ourense,Ourense,22054,307651,28249,279402,307651,28275
2020/04/25,Ourense,Lugo,179,329587,24105,305482,307651,28275
2020/04/25,Ourense,Pontevedra,134,942665,83385,859280,307651,28275
2020/04/25,Ourense,León,24,460001,36295,423706,307651,28275
2020/04/25,Palencia,Cantabria,37,580795,44629,536166,160866,11669
2020/04/25,Palencia,Burgos,130,357072,20418,336654,160866,11669
2020/04/25,Palencia,Valladolid,23,519546,39442,480104,160866,11669
2020/04/25,Palencia,Palencia,8170,160866,11489,149377,160866,11669
2020/04/25,Pontevedra,Ourense,117,307651,28249,279402,942665,83194
2020/04/25,Pontevedra,Pontevedra,64213,942665,83385,859280,942665,83194
2020/04/25,Pontevedra,Coruña,2820,1119596,95589,1024007,942665,83194
2020/04/25,Rioja,Araba,392,331549,28318,303231,316798,22060
2020/04/25,Rioja,Rioja,16108,316798,22429,294369,316798,22060
2020/04/25,Rioja,Navarra,1099,654183,49769,604414,316798,22060
2020/04/25,Salamanca,Zamora,32,172539,12211,160328,330119,25395
2020/04/25,Salamanca,Salamanca,19639,330119,25528,304591,330119,25395
2020/04/25,Salamanca,Ávila,163,157640,9284,148356,330119,25395
2020/04/25,Santa Cruz de Tenerife,Santa Cruz de Tenerife,61491,1032983,73734,959249,1032983,73722
2020/04/25,Segovia,Segovia,6957,153129,10576,142553,153129,10473
2020/04/25,Segovia,Ávila,39,157640,9284,148356,153129,10473
2020/04/25,Segovia,Valladolid,125,519546,39442,480104,153129,10473
2020/04/25,Segovia,Burgos,52,357072,20418,336654,153129,10473
2020/04/25,Sevilla,Córdoba,926,782979,54417,728562,1942389,133567
2020/04/25,Sevilla,Cádiz,591,1240155,81087,1159068,1942389,133567
2020/04/25,Sevilla,Sevilla,94460,1942389,134326,1808063,1942389,133567
2020/04/25,Sevilla,Málaga,51,1661785,98070,1563715,1942389,133567
2020/04/25,Sevilla,Huelva,254,521870,36796,485074,1942389,133567
2020/04/25,Soria,Valladolid,26,519546,39442,480104,88636,3809
2020/04/25,Soria,Soria,2750,88636,3887,84749,88636,3809
2020/04/25,Soria,Burgos,26,357072,20418,336654,88636,3809
2020/04/25,Tarragona,Castellón,461,579962,39286,540676,804664,55998
2020/04/25,Tarragona,Barcelona,610,5664579,488139,5176440,804664,55998
2020/04/25,Tarragona,Tarragona,37575,804664,56446,748218,804664,55998
2020/04/25,Tarragona,Lleida,35,434930,35160,399770,804664,55998
2020/04/25,Tarragona,Zaragoza,33,964724,78696,886028,804664,55998
2020/04/25,Tarragona,Teruel,36,134137,4663,129474,804664,55998
2020/04/25,Teruel,Teruel,2232,134137,4663,129474,134137,4834
2020/04/25,Teruel,Castellón,40,579962,39286,540676,134137,4834
2020/04/25,Teruel,Tarragona,56,804664,56446,748218,134137,4834
2020/04/25,Teruel,Zaragoza,34,964724,78696,886028,134137,4834
2020/04/25,Toledo,Madrid,1855,6663394,524403,6138991,694844,43131
2020/04/25,Toledo,Cáceres,117,394151,21429,372722,694844,43131
2020/04/25,Toledo,Toledo,23793,694844,43893,650951,694844,43131
2020/04/25,Toledo,Ávila,117,157640,9284,148356,694844,43131
2020/04/25,Toledo,Ciudad Real,150,495761,23159,472602,694844,43131
2020/04/25,Toledo,Cuenca,28,196329,10579,185750,694844,43131
2020/04/25,Valencia,Albacete,197,388167,19067,369100,2565124,221980
2020/04/25,Valencia,Alicante,525,1858683,143322,1715361,2565124,221980
2020/04/25,Valencia,Castellón,412,579962,39286,540676,2565124,221980
2020/04/25,Valencia,Madrid,23,6663394,524403,6138991,2565124,221980
2020/04/25,Valencia,Valencia,158675,2565124,223026,2342098,2565124,221980
2020/04/25,Valencia,Cuenca,64,196329,10579,185750,2565124,221980
2020/04/25,Valladolid,Soria,24,88636,3887,84749,519546,38786
2020/04/25,Valladolid,Segovia,178,153129,10576,142553,519546,38786
2020/04/25,Valladolid,León,18,460001,36295,423706,519546,38786
2020/04/25,Valladolid,Palencia,22,160866,11489,149377,519546,38786
2020/04/25,Valladolid,Ávila,22,157640,9284,148356,519546,38786
2020/04/25,Valladolid,Burgos,69,357072,20418,336654,519546,38786
2020/04/25,Valladolid,Valladolid,27365,519546,39442,480104,519546,38786
2020/04/25,Valladolid,Zamora,69,172539,12211,160328,519546,38786
2020/04/25,Zamora,Valladolid,29,519546,39442,480104,172539,12061
2020/04/25,Zamora,Zamora,8605,172539,12211,160328,172539,12061
2020/04/25,Zaragoza,Lleida,90,434930,35160,399770,964724,76358
2020/04/25,Zaragoza,Navarra,221,654183,49769,604414,964724,76358
2020/04/25,Zaragoza,Huesca,146,220461,14029,206432,964724,76358
2020/04/25,Zaragoza,Zaragoza,56542,964724,78696,886028,964724,76358
2020/04/25,Zaragoza,Teruel,28,134137,4663,129474,964724,76358
2020/04/26,Albacete,Albacete,8811,388167,13485,374682,388167,13524
2020/04/26,Albacete,Alicante,78,1858683,109241,1749442,388167,13524
2020/04/26,Albacete,Murcia,112,1493898,80896,1413002,388167,13524
2020/04/26,Albacete,Cuenca,233,196329,6930,189399,388167,13524
2020/04/26,Albacete,Jaén,42,633564,26389,607175,388167,13524
2020/04/26,Albacete,Ciudad Real,298,495761,16394,479367,388167,13524
2020/04/26,Albacete,Valencia,216,2565124,167316,2397808,388167,13524
2020/04/26,Alicante,Valencia,315,2565124,167316,2397808,1858683,109253
2020/04/26,Alicante,Alicante,90058,1858683,109241,1749442,1858683,109253
2020/04/26,Alicante,Murcia,1303,1493898,80896,1413002,1858683,109253
2020/04/26,Alicante,Albacete,145,388167,13485,374682,1858683,109253
2020/04/26,Almería,Granada,107,914678,52238,862440,716820,31160
2020/04/26,Almería,Almería,23882,716820,32223,684597,716820,31160
2020/04/26,Almería,Murcia,381,1493898,80896,1413002,716820,31160
2020/04/26,Araba,Rioja,267,316798,16472,300326,331549,22476
2020/04/26,Araba,Burgos,419,357072,14374,342698,331549,22476
2020/04/26,Araba,Bizkaia,333,1152934,89317,1063617,331549,22476
2020/04/26,Araba,Araba,18057,331549,21769,309780,331549,22476
2020/04/26,Asturias,Cantabria,133,580795,33957,546838,1022800,54294
2020/04/26,Asturias,Asturias,41893,1022800,54400,968400,1022800,54294
2020/04/26,Asturias,Lugo,372,329587,18096,311491,1022800,54294
2020/04/26,Ávila,Madrid,31,6663394,417363,6246031,157640,7465
2020/04/26,Ávila,Salamanca,121,330119,19871,310248,157640,7465
2020/04/26,Ávila,Ávila,5068,157640,7206,150434,157640,7465
2020/04/26,Ávila,Segovia,85,153129,7962,145167,157640,7465
2020/04/26,Ávila,Cáceres,53,394151,17308,376843,157640,7465
2020/04/26,Ávila,Toledo,58,694844,30114,664730,157640,7465
2020/04/26,Badajoz,Cáceres,580,394151,17308,376843,673559,34186
2020/04/26,Badajoz,Sevilla,28,1942389,105930,1836459,673559,34186
2020/04/26,Badajoz,Huelva,141,521870,29486,492384,673559,34186
2020/04/26,Badajoz,Ciudad Real,71,495761,16394,479367,673559,34186
2020/04/26,Badajoz,Córdoba,16,782979,44490,738489,673559,34186
2020/04/26,Badajoz,Badajoz,25437,673559,34773,638786,673559,34186
2020/04/26,Balears,Balears,37707,1149460,48369,1101091,1149460,48235
2020/04/26,Barcelona,Tarragona,504,804664,42018,762646,5664579,387196
2020/04/26,Barcelona,Barcelona,284260,5664579,385606,5278973,5664579,387196
2020/04/26,Barcelona,Lleida,35,434930,24622,410308,5664579,387196
2020/04/26,Barcelona,Girona,1060,771044,35790,735254,5664579,387196
2020/04/26,Bizkaia,Cantabria,254,580795,33957,546838,1152934,88773
2020/04/26,Bizkaia,Bizkaia,71229,1152934,89317,1063617,1152934,88773
2020/04/26,Bizkaia,Gipuzkoa,214,723576,35597,687979,1152934,88773
2020/04/26,Bizkaia,Araba,324,331549,21769,309780,1152934,88773
2020/04/26,Burgos,Cantabria,23,580795,33957,546838,357072,14615
2020/04/26,Burgos,Palencia,103,160866,8429,152437,357072,14615
2020/04/26,Burgos,Burgos,10377,357072,14374,342698,357072,14615
2020/04/26,Burgos,Bizkaia,28,1152934,89317,1063617,357072,14615
2020/04/26,Burgos,Valladolid,49,519546,30254,489292,357072,14615
2020/04/26,Burgos,Araba,372,331549,21769,309780,357072,14615
2020/04/26,Cáceres,Badajoz,551,673559,34773,638786,394151,17019
2020/04/26,Cáceres,Toledo,31,694844,30114,664730,394151,17019
2020/04/26,Cáceres,Salamanca,27,330119,19871,310248,394151,17019
2020/04/26,Cáceres,Ávila,59,157640,7206,150434,394151,17019
2020/04/26,Cáceres,Cáceres,11110,394151,17308,376843,394151,17019
2020/04/26,Cádiz,Málaga,431,1661785,76654,1585131,1240155,68149
2020/04/26,Cádiz,Huelva,467,521870,29486,492384,1240155,68149
2020/04/26,Cádiz,Granada,17,914678,52238,862440,1240155,68149
2020/04/26,Cádiz,Cádiz,55884,1240155,67199,1172956,1240155,68149
2020/04/26,Cádiz,Sevilla,468,1942389,105930,1836459,1240155,68149
2020/04/26,Cantabria,Asturias,96,1022800,54400,968400,580795,33867
2020/04/26,Cantabria,Cantabria,25069,580795,33957,546838,580795,33867
2020/04/26,Cantabria,Bizkaia,268,1152934,89317,1063617,580795,33867
2020/04/26,Castellón,Valencia,502,2565124,167316,2397808,579962,29642
2020/04/26,Castellón,Castellón,20998,579962,29233,550729,579962,29642
2020/04/26,Castellón,Tarragona,440,804664,42018,762646,579962,29642
2020/04/26,Ceuta,Ceuta,4287,84777,4646,80131,84777,4575
2020/04/26,Ciudad Real,Toledo,36,694844,30114,664730,495761,16141
2020/04/26,Ciudad Real,Albacete,322,388167,13485,374682,495761,16141
2020/04/26,Ciudad Real,Melilla,20,86487,6962,79525,495761,16141
2020/04/26,Ciudad Real,Ciudad Real,9842,495761,16394,479367,495761,16141
2020/04/26,Ciudad Real,Cuenca,16,196329,6930,189399,495761,16141
2020/04/26,Ciudad Real,Córdoba,342,782979,44490,738489,495761,16141
2020/04/26,Ciudad Real,Badajoz,53,673559,34773,638786,495761,16141
2020/04/26,Córdoba,Málaga,47,1661785,76654,1585131,782979,43973
2020/04/26,Córdoba,Badajoz,38,673559,34773,638786,782979,43973
2020/04/26,Córdoba,Córdoba,32906,782979,44490,738489,782979,43973
2020/04/26,Córdoba,Sevilla,594,1942389,105930,1836459,782979,43973
2020/04/26,Córdoba,Jaén,361,633564,26389,607175,782979,43973
2020/04/26,Córdoba,Ciudad Real,192,495761,16394,479367,782979,43973
2020/04/26,Córdoba,Granada,109,914678,52238,862440,782979,43973
2020/04/26,Coruña,Lugo,211,329587,18096,311491,1119596,71577
2020/04/26,Coruña,Coruña,54193,1119596,71536,1048060,1119596,71577
2020/04/26,Coruña,Pontevedra,2345,942665,62024,880641,1119596,71577
2020/04/26,Cuenca,Madrid,30,6663394,417363,6246031,196329,7047
2020/04/26,Cuenca,Albacete,302,388167,13485,374682,196329,7047
2020/04/26,Cuenca,Valencia,35,2565124,167316,2397808,196329,7047
2020/04/26,Cuenca,Cuenca,3575,196329,6930,189399,196329,7047
2020/04/26,Cuenca,Ciudad Real,64,495761,16394,479367,196329,7047
2020/04/26,Gipuzkoa,Navarra,57,654183,36638,617545,723576,36416
2020/04/26,Gipuzkoa,Bizkaia,238,1152934,89317,1063617,723576,36416
2020/04/26,Gipuzkoa,Gipuzkoa,27374,723576,35597,687979,723576,36416
2020/04/26,Girona,Girona,24556,771044,35790,735254,771044,37007
2020/04/26,Girona,Lleida,64,434930,24622,410308,771044,37007
2020/04/26,Girona,Barcelona,1075,5664579,385606,5278973,771044,37007
2020/04/26,Granada,Granada,38414,914678,52238,862440,914678,51560
2020/04/26,Granada,Jaén,41,633564,26389,607175,914678,51560
2020/04/26,Granada,Córdoba,113,782979,44490,738489,914678,51560
2020/04/26,Granada,Málaga,45,1661785,76654,1585131,914678,51560
2020/04/26,Granada,Almería,136,716820,32223,684597,914678,51560
2020/04/26,Guadalajara,Guadalajara,8655,257762,13516,244246,257762,13340
2020/04/26,Guadalajara,Madrid,804,6663394,417363,6246031,257762,13340
2020/04/26,Huelva,Sevilla,287,1942389,105930,1836459,521870,28993
2020/04/26,Huelva,Huelva,20769,521870,29486,492384,521870,28993
2020/04/26,Huelva,Cádiz,383,1240155,67199,1172956,521870,28993
2020/04/26,Huelva,Badajoz,205,673559,34773,638786,521870,28993
2020/04/26,Huesca,Zaragoza,102,964724,60729,903995,220461,10951
2020/04/26,Huesca,Huesca,7172,220461,10536,209925,220461,10951
2020/04/26,Huesca,Lleida,355,434930,24622,410308,220461,10951
2020/04/26,Jaén,Córdoba,325,782979,44490,738489,633564,25768
2020/04/26,Jaén,Jaén,18588,633564,26389,607175,633564,25768
2020/04/26,Jaén,Granada,51,914678,52238,862440,633564,25768
2020/04/26,Las Palmas de Gran Canaria,Las Palmas de Gran Canaria,48328,1120406,60043,1060363,1120406,59668
2020/04/26,León,Ourense,56,307651,21571,286080,460001,25477
2020/04/26,León,León,18739,460001,25567,434434,460001,25477
2020/04/26,Lleida,Zaragoza,46,964724,60729,903995,434930,23980
2020/04/26,Lleida,Girona,59,771044,35790,735254,434930,23980
2020/04/26,Lleida,Barcelona,16,5664579,385606,5278973,434930,23980
2020/04/26,Lleida,Lleida,16066,434930,24622,410308,434930,23980
2020/04/26,Lleida,Huesca,240,220461,10536,209925,434930,23980
2020/04/26,Lugo,Coruña,257,1119596,71536,1048060,329587,18203
2020/04/26,Lugo,Ourense,74,307651,21571,286080,329587,18203
2020/04/26,Lugo,Asturias,248,1022800,54400,968400,329587,18203
2020/04/26,Lugo,Lugo,12575,329587,18096,311491,329587,18203
2020/04/26,Madrid,Cuenca,42,196329,6930,189399,6663394,420042
2020/04/26,Madrid,Toledo,1277,694844,30114,664730,6663394,420042
2020/04/26,Madrid,Madrid,297462,6663394,417363,6246031,6663394,420042
2020/04/26,Madrid,Guadalajara,737,257762,13516,244246,6663394,420042
2020/04/26,Madrid,Ávila,50,157640,7206,150434,6663394,420042
2020/04/26,Málaga,Málaga,59274,1661785,76654,1585131,1661785,76261
2020/04/26,Málaga,Granada,84,914678,52238,862440,1661785,76261
2020/04/26,Málaga,Cádiz,317,1240155,67199,1172956,1661785,76261
2020/04/26,Málaga,Córdoba,41,782979,44490,738489,1661785,76261
2020/04/26,Málaga,Sevilla,60,1942389,105930,1836459,1661785,76261
2020/04/26,Melilla,Melilla,6793,86487,6962,79525,86487,7042
2020/04/26,Murcia,Albacete,79,388167,13485,374682,1493898,80153
2020/04/26,Murcia,Barcelona,23,5664579,385606,5278973,1493898,80153
2020/04/26,Murcia,Granada,22,914678,52238,862440,1493898,80153
2020/04/26,Murcia,Alicante,977,1858683,109241,1749442,1493898,80153
2020/04/26,Murcia,Murcia,61965,1493898,80896,1413002,1493898,80153
2020/04/26,Murcia,Almería,442,716820,32223,684597,1493898,80153
2020/04/26,Navarra,Rioja,580,316798,16472,300326,654183,37142
2020/04/26,Navarra,Navarra,26091,654183,36638,617545,654183,37142
2020/04/26,Navarra,Zaragoza,151,964724,60729,903995,654183,37142
2020/04/26,Navarra,Gipuzkoa,91,723576,35597,687979,654183,37142
2020/04/26,Navarra,Araba,23,331549,21769,309780,654183,37142
2020/04/26,Ourense,Ourense,16668,307651,21571,286080,307651,21405
2020/04/26,Ourense,Lugo,114,329587,18096,311491,307651,21405
2020/04/26,Ourense,León,70,460001,25567,434434,307651,21405
2020/04/26,Ourense,Pontevedra,112,942665,62024,880641,307651,21405
2020/04/26,Palencia,Burgos,114,357072,14374,342698,160866,8533
2020/04/26,Palencia,Palencia,5859,160866,8429,152437,160866,8533
2020/04/26,Pontevedra,Pontevedra,47847,942665,62024,880641,942665,61869
2020/04/26,Pontevedra,Coruña,2359,1119596,71536,1048060,942665,61869
2020/04/26,Pontevedra,Ourense,108,307651,21571,286080,942665,61869
2020/04/26,Rioja,Araba,249,331549,21769,309780,316798,16390
2020/04/26,Rioja,Rioja,12150,316798,16472,300326,316798,16390
2020/04/26,Rioja,Navarra,643,654183,36638,617545,316798,16390
2020/04/26,Salamanca,Salamanca,15084,330119,19871,310248,330119,19881
2020/04/26,Salamanca,Cáceres,17,394151,17308,376843,330119,19881
2020/04/26,Salamanca,Ávila,90,157640,7206,150434,330119,19881
2020/04/26,Santa Cruz de Tenerife,Santa Cruz de Tenerife,44606,1032983,54592,978391,1032983,54452
2020/04/26,Segovia,Segovia,5250,153129,7962,145167,153129,8027
2020/04/26,Segovia,Ávila,37,157640,7206,150434,153129,8027
2020/04/26,Segovia,Valladolid,99,519546,30254,489292,153129,8027
2020/04/26,Sevilla,Huelva,200,521870,29486,492384,1942389,105304
2020/04/26,Sevilla,Sevilla,77652,1942389,105930,1836459,1942389,105304
2020/04/26,Sevilla,Cádiz,477,1240155,67199,1172956,1942389,105304
2020/04/26,Sevilla,Córdoba,664,782979,44490,738489,1942389,105304
2020/04/26,Sevilla,Málaga,35,1661785,76654,1585131,1942389,105304
2020/04/26,Soria,Valladolid,30,519546,30254,489292,88636,2761
2020/04/26,Soria,Soria,1888,88636,2697,85939,88636,2761
2020/04/26,Tarragona,Castellón,301,579962,29233,550729,804664,41526
2020/04/26,Tarragona,Teruel,30,134137,3227,130910,804664,41526
2020/04/26,Tarragona,Zaragoza,16,964724,60729,903995,804664,41526
2020/04/26,Tarragona,Barcelona,500,5664579,385606,5278973,804664,41526
2020/04/26,Tarragona,Tarragona,28025,804664,42018,762646,804664,41526
2020/04/26,Teruel,Tarragona,16,804664,42018,762646,134137,3335
2020/04/26,Teruel,Zaragoza,34,964724,60729,903995,134137,3335
2020/04/26,Teruel,Teruel,1552,134137,3227,130910,134137,3335
2020/04/26,Toledo,Cáceres,119,394151,17308,376843,694844,30149
2020/04/26,Toledo,Ávila,115,157640,7206,150434,694844,30149
2020/04/26,Toledo,Ciudad Real,43,495761,16394,479367,694844,30149
2020/04/26,Toledo,Madrid,1491,6663394,417363,6246031,694844,30149
2020/04/26,Toledo,Toledo,16261,694844,30114,664730,694844,30149
2020/04/26,Valencia,Valencia,127271,2565124,167316,2397808,2565124,166971
2020/04/26,Valencia,Madrid,18,6663394,417363,6246031,2565124,166971
2020/04/26,Valencia,Albacete,147,388167,13485,374682,2565124,166971
2020/04/26,Valencia,Castellón,312,579962,29233,550729,2565124,166971
2020/04/26,Valencia,Alicante,359,1858683,109241,1749442,2565124,166971
2020/04/26,Valencia,Cuenca,52,196329,6930,189399,2565124,166971
2020/04/26,Valladolid,Palencia,28,160866,8429,152437,519546,29909
2020/04/26,Valladolid,Segovia,67,153129,7962,145167,519546,29909
2020/04/26,Valladolid,Burgos,67,357072,14374,342698,519546,29909
2020/04/26,Valladolid,Valladolid,22095,519546,30254,489292,519546,29909
2020/04/26,Zamora,Zamora,6570,172539,8985,163554,172539,9240
2020/04/26,Zamora,Salamanca,36,330119,19871,310248,172539,9240
2020/04/26,Zaragoza,Teruel,32,134137,3227,130910,964724,60112
2020/04/26,Zaragoza,Zaragoza,45335,964724,60729,903995,964724,60112
2020/04/26,Zaragoza,Huesca,51,220461,10536,209925,964724,60112
2020/04/26,Zaragoza,Lleida,36,434930,24622,410308,964724,60112
2020/04/26,Zaragoza,Navarra,136,654183,36638,617545,964724,60112
2020/04/27,Albacete,Cuenca,495,196329,15887,180442,388167,26978
2020/04/27,Albacete,Murcia,231,1493898,165970,1327928,388167,26978
2020/04/27,Albacete,Ciudad Real,499,495761,35412,460349,388167,26978
2020/04/27,Albacete,Alicante,165,1858683,207942,1650741,388167,26978
2020/04/27,Albacete,Albacete,15443,388167,27420,360747,388167,26978
2020/04/27,Albacete,Valencia,277,2565124,333344,2231780,388167,26978
2020/04/27,Albacete,Jaén,41,633564,51110,582454,388167,26978
2020/04/27,Alicante,Murcia,2352,1493898,165970,1327928,1858683,211189
2020/04/27,Alicante,Valencia,966,2565124,333344,2231780,1858683,211189
2020/04/27,Alicante,Albacete,251,388167,27420,360747,1858683,211189
2020/04/27,Alicante,Alicante,156993,1858683,207942,1650741,1858683,211189
2020/04/27,Almería,Granada,385,914678,94575,820103,716820,76111
2020/04/27,Almería,Murcia,1699,1493898,165970,1327928,716820,76111
2020/04/27,Almería,Almería,59320,716820,73568,643252,716820,76111
2020/04/27,Araba,Rioja,1442,316798,35983,280815,331549,45655
2020/04/27,Araba,Araba,31853,331549,40259,291290,331549,45655
2020/04/27,Araba,Burgos,1287,357072,32988,324084,331549,45655
2020/04/27,Araba,Navarra,59,654183,76859,577324,331549,45655
2020/04/27,Araba,Bizkaia,811,1152934,160420,992514,331549,45655
2020/04/27,Araba,Gipuzkoa,51,723576,79688,643888,331549,45655
2020/04/27,Asturias,Lugo,720,329587,36234,293353,1022800,107239
2020/04/27,Asturias,Asturias,81418,1022800,108423,914377,1022800,107239
2020/04/27,Asturias,León,43,460001,51886,408115,1022800,107239
2020/04/27,Asturias,Cantabria,160,580795,65256,515539,1022800,107239
2020/04/27,Ávila,Toledo,109,694844,68589,626255,157640,13504
2020/04/27,Ávila,Madrid,59,6663394,744936,5918458,157640,13504
2020/04/27,Ávila,Segovia,79,153129,15919,137210,157640,13504
2020/04/27,Ávila,Salamanca,236,330119,35415,294704,157640,13504
2020/04/27,Ávila,Ávila,8171,157640,12993,144647,157640,13504
2020/04/27,Ávila,Cáceres,60,394151,30699,363452,157640,13504
2020/04/27,Badajoz,Badajoz,44012,673559,63577,609982,673559,63400
2020/04/27,Badajoz,Huelva,191,521870,48839,473031,673559,63400
2020/04/27,Badajoz,Córdoba,73,782979,74706,708273,673559,63400
2020/04/27,Badajoz,Ciudad Real,36,495761,35412,460349,673559,63400
2020/04/27,Badajoz,Cáceres,838,394151,30699,363452,673559,63400
2020/04/27,Balears,Valencia,21,2565124,333344,2231780,1149460,107507
2020/04/27,Balears,Balears,88720,1149460,106803,1042657,1149460,107507
2020/04/27,Barcelona,Barcelona,399853,5664579,675736,4988843,5664579,676895
2020/04/27,Barcelona,Tarragona,1056,804664,80955,723709,5664579,676895
2020/04/27,Barcelona,Girona,1959,771044,72588,698456,5664579,676895
2020/04/27,Barcelona,Lleida,65,434930,47489,387441,5664579,676895
2020/04/27,Bizkaia,Cantabria,1354,580795,65256,515539,1152934,156939
2020/04/27,Bizkaia,Araba,546,331549,40259,291290,1152934,156939
2020/04/27,Bizkaia,Bizkaia,115494,1152934,160420,992514,1152934,156939
2020/04/27,Bizkaia,Burgos,47,357072,32988,324084,1152934,156939
2020/04/27,Bizkaia,Gipuzkoa,704,723576,79688,643888,1152934,156939
2020/04/27,Burgos,Araba,658,331549,40259,291290,357072,34047
2020/04/27,Burgos,Rioja,57,316798,35983,280815,357072,34047
2020/04/27,Burgos,Segovia,26,153129,15919,137210,357072,34047
2020/04/27,Burgos,Bizkaia,54,1152934,160420,992514,357072,34047
2020/04/27,Burgos,Soria,25,88636,5823,82813,357072,34047
2020/04/27,Burgos,Valladolid,72,519546,59379,460167,357072,34047
2020/04/27,Burgos,Palencia,132,160866,16943,143923,357072,34047
2020/04/27,Burgos,Burgos,23322,357072,32988,324084,357072,34047
2020/04/27,Cáceres,Badajoz,993,673559,63577,609982,394151,31448
2020/04/27,Cáceres,Ávila,95,157640,12993,144647,394151,31448
2020/04/27,Cáceres,Toledo,154,694844,68589,626255,394151,31448
2020/04/27,Cáceres,Cáceres,18903,394151,30699,363452,394151,31448
2020/04/27,Cádiz,Huelva,627,521870,48839,473031,1240155,115575
2020/04/27,Cádiz,Melilla,18,86487,10491,75996,1240155,115575
2020/04/27,Cádiz,Málaga,1010,1661785,150659,1511126,1240155,115575
2020/04/27,Cádiz,Sevilla,603,1942389,185312,1757077,1240155,115575
2020/04/27,Cádiz,Cádiz,87891,1240155,111868,1128287,1240155,115575
2020/04/27,Cantabria,Palencia,30,160866,16943,143923,580795,61105
2020/04/27,Cantabria,Bizkaia,432,1152934,160420,992514,580795,61105
2020/04/27,Cantabria,Cantabria,43832,580795,65256,515539,580795,61105
2020/04/27,Cantabria,Asturias,140,1022800,108423,914377,580795,61105
2020/04/27,Castellón,Tarragona,596,804664,80955,723709,579962,63784
2020/04/27,Castellón,Teruel,44,134137,7857,126280,579962,63784
2020/04/27,Castellón,Castellón,43193,579962,60506,519456,579962,63784
2020/04/27,Castellón,Valencia,592,2565124,333344,2231780,579962,63784
2020/04/27,Ceuta,Ceuta,7326,84777,7739,77038,84777,7713
2020/04/27,Ciudad Real,Córdoba,311,782979,74706,708273,495761,31646
2020/04/27,Ciudad Real,Albacete,388,388167,27420,360747,495761,31646
2020/04/27,Ciudad Real,Toledo,105,694844,68589,626255,495761,31646
2020/04/27,Ciudad Real,Ciudad Real,18993,495761,35412,460349,495761,31646
2020/04/27,Ciudad Real,Badajoz,112,673559,63577,609982,495761,31646
2020/04/27,Córdoba,Sevilla,1002,1942389,185312,1757077,782979,72618
2020/04/27,Córdoba,Badajoz,67,673559,63577,609982,782979,72618
2020/04/27,Córdoba,Ciudad Real,253,495761,35412,460349,782979,72618
2020/04/27,Córdoba,Jaén,584,633564,51110,582454,782979,72618
2020/04/27,Córdoba,Málaga,109,1661785,150659,1511126,782979,72618
2020/04/27,Córdoba,Granada,119,914678,94575,820103,782979,72618
2020/04/27,Córdoba,Córdoba,49426,782979,74706,708273,782979,72618
2020/04/27,Coruña,Lugo,515,329587,36234,293353,1119596,139323
2020/04/27,Coruña,Coruña,102092,1119596,140296,979300,1119596,139323
2020/04/27,Coruña,Pontevedra,4101,942665,122417,820248,1119596,139323
2020/04/27,Cuenca,Albacete,646,388167,27420,360747,196329,16550
2020/04/27,Cuenca,Guadalajara,18,257762,27979,229783,196329,16550
2020/04/27,Cuenca,Cuenca,7555,196329,15887,180442,196329,16550
2020/04/27,Cuenca,Madrid,53,6663394,744936,5918458,196329,16550
2020/04/27,Cuenca,Toledo,153,694844,68589,626255,196329,16550
2020/04/27,Cuenca,Valencia,56,2565124,333344,2231780,196329,16550
2020/04/27,Cuenca,Ciudad Real,120,495761,35412,460349,196329,16550
2020/04/27,Gipuzkoa,Bizkaia,1009,1152934,160420,992514,723576,84886
2020/04/27,Gipuzkoa,Navarra,287,654183,76859,577324,723576,84886
2020/04/27,Gipuzkoa,Araba,157,331549,40259,291290,723576,84886
2020/04/27,Gipuzkoa,Gipuzkoa,57927,723576,79688,643888,723576,84886
2020/04/27,Girona,Barcelona,1730,5664579,675736,4988843,771044,76049
2020/04/27,Girona,Lleida,121,434930,47489,387441,771044,76049
2020/04/27,Girona,Girona,46347,771044,72588,698456,771044,76049
2020/04/27,Granada,Almería,347,716820,73568,643252,914678,91129
2020/04/27,Granada,Jaén,282,633564,51110,582454,914678,91129
2020/04/27,Granada,Córdoba,209,782979,74706,708273,914678,91129
2020/04/27,Granada,Granada,64644,914678,94575,820103,914678,91129
2020/04/27,Granada,Málaga,140,1661785,150659,1511126,914678,91129
2020/04/27,Guadalajara,Cuenca,39,196329,15887,180442,257762,29104
2020/04/27,Guadalajara,Guadalajara,15687,257762,27979,229783,257762,29104
2020/04/27,Guadalajara,Madrid,1407,6663394,744936,5918458,257762,29104
2020/04/27,Huelva,Sevilla,995,1942389,185312,1757077,521870,52077
2020/04/27,Huelva,Badajoz,299,673559,63577,609982,521870,52077
2020/04/27,Huelva,Cádiz,467,1240155,111868,1128287,521870,52077
2020/04/27,Huelva,Huelva,35078,521870,48839,473031,521870,52077
2020/04/27,Huesca,Huesca,13430,220461,20941,199520,220461,24011
2020/04/27,Huesca,Zaragoza,183,964724,118326,846398,220461,24011
2020/04/27,Huesca,Lleida,774,434930,47489,387441,220461,24011
2020/04/27,Jaén,Jaén,32695,633564,51110,582454,633564,47955
2020/04/27,Jaén,Córdoba,617,782979,74706,708273,633564,47955
2020/04/27,Jaén,Granada,194,914678,94575,820103,633564,47955
2020/04/27,Las Palmas de Gran Canaria,Las Palmas de Gran Canaria,105395,1120406,117981,1002425,1120406,117067
2020/04/27,León,Palencia,56,160866,16943,143923,460001,51121
2020/04/27,León,Ourense,190,307651,39628,268023,460001,51121
2020/04/27,León,Asturias,52,1022800,108423,914377,460001,51121
2020/04/27,León,Lugo,29,329587,36234,293353,460001,51121
2020/04/27,León,León,37182,460001,51886,408115,460001,51121
2020/04/27,León,Zamora,127,172539,16626,155913,460001,51121
2020/04/27,Lleida,Zaragoza,44,964724,118326,846398,434930,45016
2020/04/27,Lleida,Barcelona,142,5664579,675736,4988843,434930,45016
2020/04/27,Lleida,Girona,131,771044,72588,698456,434930,45016
2020/04/27,Lleida,Lleida,28427,434930,47489,387441,434930,45016
2020/04/27,Lleida,Huesca,385,220461,20941,199520,434930,45016
2020/04/27,Lugo,Coruña,477,1119596,140296,979300,329587,36228
2020/04/27,Lugo,Ourense,107,307651,39628,268023,329587,36228
2020/04/27,Lugo,Lugo,24224,329587,36234,293353,329587,36228
2020/04/27,Lugo,Asturias,557,1022800,108423,914377,329587,36228
2020/04/27,Madrid,Ávila,143,157640,12993,144647,6663394,749144
2020/04/27,Madrid,Toledo,2818,694844,68589,626255,6663394,749144
2020/04/27,Madrid,Cuenca,57,196329,15887,180442,6663394,749144
2020/04/27,Madrid,Guadalajara,1952,257762,27979,229783,6663394,749144
2020/04/27,Madrid,Madrid,403996,6663394,744936,5918458,6663394,749144
2020/04/27,Málaga,Málaga,115237,1661785,150659,1511126,1661785,159070
2020/04/27,Málaga,Córdoba,174,782979,74706,708273,1661785,159070
2020/04/27,Málaga,Sevilla,272,1942389,185312,1757077,1661785,159070
2020/04/27,Málaga,Cádiz,657,1240155,111868,1128287,1661785,159070
2020/04/27,Málaga,Granada,172,914678,94575,820103,1661785,159070
2020/04/27,Melilla,Melilla,10318,86487,10491,75996,86487,10579
2020/04/27,Murcia,Albacete,422,388167,27420,360747,1493898,163030
2020/04/27,Murcia,Alicante,2003,1858683,207942,1650741,1493898,163030
2020/04/27,Murcia,Almería,1148,716820,73568,643252,1493898,163030
2020/04/27,Murcia,Murcia,121639,1493898,165970,1327928,1493898,163030
2020/04/27,Murcia,Barcelona,38,5664579,675736,4988843,1493898,163030
2020/04/27,Navarra,Araba,38,331549,40259,291290,654183,78734
2020/04/27,Navarra,Gipuzkoa,280,723576,79688,643888,654183,78734
2020/04/27,Navarra,Rioja,1989,316798,35983,280815,654183,78734
2020/04/27,Navarra,Navarra,52287,654183,76859,577324,654183,78734
2020/04/27,Navarra,Zaragoza,444,964724,118326,846398,654183,78734
2020/04/27,Ourense,Lugo,241,329587,36234,293353,307651,39892
2020/04/27,Ourense,Ourense,29252,307651,39628,268023,307651,39892
2020/04/27,Ourense,Zamora,33,172539,16626,155913,307651,39892
2020/04/27,Ourense,León,80,460001,51886,408115,307651,39892
2020/04/27,Ourense,Pontevedra,134,942665,122417,820248,307651,39892
2020/04/27,Palencia,Palencia,11592,160866,16943,143923,160866,18230
2020/04/27,Palencia,León,26,460001,51886,408115,160866,18230
2020/04/27,Palencia,Burgos,187,357072,32988,324084,160866,18230
2020/04/27,Palencia,Cantabria,127,580795,65256,515539,160866,18230
2020/04/27,Palencia,Valladolid,60,519546,59379,460167,160866,18230
2020/04/27,Pontevedra,Pontevedra,89641,942665,122417,820248,942665,118499
2020/04/27,Pontevedra,Lugo,28,329587,36234,293353,942665,118499
2020/04/27,Pontevedra,Coruña,3134,1119596,140296,979300,942665,118499
2020/04/27,Pontevedra,Ourense,132,307651,39628,268023,942665,118499
2020/04/27,Rioja,Araba,441,331549,40259,291290,316798,33710
2020/04/27,Rioja,Navarra,1430,654183,76859,577324,316798,33710
2020/04/27,Rioja,Rioja,24668,316798,35983,280815,316798,33710
2020/04/27,Salamanca,Zamora,30,172539,16626,155913,330119,34719
2020/04/27,Salamanca,Ávila,180,157640,12993,144647,330119,34719
2020/04/27,Salamanca,Salamanca,26582,330119,35415,294704,330119,34719
2020/04/27,Santa Cruz de Tenerife,Santa Cruz de Tenerife,93517,1032983,108753,924230,1032983,107721
2020/04/27,Segovia,Valladolid,276,519546,59379,460167,153129,17099
2020/04/27,Segovia,Segovia,10096,153129,15919,137210,153129,17099
2020/04/27,Segovia,Ávila,92,157640,12993,144647,153129,17099
2020/04/27,Segovia,Burgos,89,357072,32988,324084,153129,17099
2020/04/27,Sevilla,Córdoba,1109,782979,74706,708273,1942389,183676
2020/04/27,Sevilla,Málaga,61,1661785,150659,1511126,1942389,183676
2020/04/27,Sevilla,Huelva,167,521870,48839,473031,1942389,183676
2020/04/27,Sevilla,Cádiz,636,1240155,111868,1128287,1942389,183676
2020/04/27,Sevilla,Sevilla,115154,1942389,185312,1757077,1942389,183676
2020/04/27,Soria,Valladolid,31,519546,59379,460167,88636,7097
2020/04/27,Soria,Burgos,31,357072,32988,324084,88636,7097
2020/04/27,Soria,Segovia,19,153129,15919,137210,88636,7097
2020/04/27,Soria,Soria,4138,88636,5823,82813,88636,7097
2020/04/27,Soria,Zaragoza,92,964724,118326,846398,88636,7097
2020/04/27,Tarragona,Tarragona,50710,804664,80955,723709,804664,79352
2020/04/27,Tarragona,Teruel,35,134137,7857,126280,804664,79352
2020/04/27,Tarragona,Barcelona,590,5664579,675736,4988843,804664,79352
2020/04/27,Tarragona,Castellón,544,579962,60506,519456,804664,79352
2020/04/27,Tarragona,Lleida,42,434930,47489,387441,804664,79352
2020/04/27,Teruel,Tarragona,74,804664,80955,723709,134137,9469
2020/04/27,Teruel,Castellón,39,579962,60506,519456,134137,9469
2020/04/27,Teruel,Zaragoza,80,964724,118326,846398,134137,9469
2020/04/27,Teruel,Guadalajara,61,257762,27979,229783,134137,9469
2020/04/27,Teruel,Teruel,4134,134137,7857,126280,134137,9469
2020/04/27,Toledo,Madrid,2817,6663394,744936,5918458,694844,64812
2020/04/27,Toledo,Cuenca,87,196329,15887,180442,694844,64812
2020/04/27,Toledo,Ávila,105,157640,12993,144647,694844,64812
2020/04/27,Toledo,Cáceres,101,394151,30699,363452,694844,64812
2020/04/27,Toledo,Toledo,30512,694844,68589,626255,694844,64812
2020/04/27,Toledo,Ciudad Real,234,495761,35412,460349,694844,64812
2020/04/27,Valencia,Valencia,219647,2565124,333344,2231780,2565124,323920
2020/04/27,Valencia,Castellón,539,579962,60506,519456,2565124,323920
2020/04/27,Valencia,Cuenca,56,196329,15887,180442,2565124,323920
2020/04/27,Valencia,Alicante,772,1858683,207942,1650741,2565124,323920
2020/04/27,Valencia,Albacete,295,388167,27420,360747,2565124,323920
2020/04/27,Valladolid,Soria,37,88636,5823,82813,519546,57596
2020/04/27,Valladolid,Burgos,61,357072,32988,324084,519546,57596
2020/04/27,Valladolid,Valladolid,40319,519546,59379,460167,519546,57596
2020/04/27,Valladolid,Zamora,98,172539,16626,155913,519546,57596
2020/04/27,Valladolid,Segovia,269,153129,15919,137210,519546,57596
2020/04/27,Zamora,León,42,460001,51886,408115,172539,16710
2020/04/27,Zamora,Zamora,10768,172539,16626,155913,172539,16710
2020/04/27,Zamora,Valladolid,43,519546,59379,460167,172539,16710
2020/04/27,Zamora,Ourense,34,307651,39628,268023,172539,16710
2020/04/27,Zaragoza,Huesca,347,220461,20941,199520,964724,115080
2020/04/27,Zaragoza,Lleida,85,434930,47489,387441,964724,115080
2020/04/27,Zaragoza,Soria,37,88636,5823,82813,964724,115080
2020/04/27,Zaragoza,Navarra,299,654183,76859,577324,964724,115080
2020/04/27,Zaragoza,Zaragoza,84213,964724,118326,846398,964724,115080
2020/04/27,Zaragoza,Teruel,144,134137,7857,126280,964724,115080
2020/04/28,Albacete,Murcia,409,1493898,179793,1314105,388167,29471
2020/04/28,Albacete,Albacete,17416,388167,29165,359002,388167,29471
2020/04/28,Albacete,Alicante,225,1858683,222214,1636469,388167,29471
2020/04/28,Albacete,Valencia,311,2565124,351841,2213283,388167,29471
2020/04/28,Albacete,Cuenca,599,196329,16790,179539,388167,29471
2020/04/28,Albacete,Jaén,47,633564,51628,581936,388167,29471
2020/04/28,Albacete,Ciudad Real,573,495761,37382,458379,388167,29471
2020/04/28,Alicante,Albacete,230,388167,29165,359002,1858683,225626
2020/04/28,Alicante,Murcia,2797,1493898,179793,1314105,1858683,225626
2020/04/28,Alicante,Alicante,168392,1858683,222214,1636469,1858683,225626
2020/04/28,Alicante,Valencia,990,2565124,351841,2213283,1858683,225626
2020/04/28,Almería,Melilla,276,86487,11050,75437,716820,80685
2020/04/28,Almería,Murcia,1841,1493898,179793,1314105,716820,80685
2020/04/28,Almería,Almería,64142,716820,78167,638653,716820,80685
2020/04/28,Almería,Granada,486,914678,99232,815446,716820,80685
2020/04/28,Araba,Araba,22242,331549,30646,300903,331549,33356
2020/04/28,Araba,Bizkaia,586,1152934,169349,983585,331549,33356
2020/04/28,Araba,Rioja,1517,316798,37440,279358,331549,33356
2020/04/28,Araba,Navarra,27,654183,80821,573362,331549,33356
2020/04/28,Araba,Burgos,971,357072,35366,321706,331549,33356
2020/04/28,Araba,Gipuzkoa,43,723576,85957,637619,331549,33356
2020/04/28,Asturias,Asturias,87168,1022800,114112,908688,1022800,113863
2020/04/28,Asturias,Lugo,737,329587,36665,292922,1022800,113863
2020/04/28,Asturias,León,38,460001,52116,407885,1022800,113863
2020/04/28,Asturias,Cantabria,192,580795,68252,512543,1022800,113863
2020/04/28,Ávila,Cáceres,85,394151,33267,360884,157640,14236
2020/04/28,Ávila,Madrid,103,6663394,797836,5865558,157640,14236
2020/04/28,Ávila,Ávila,8453,157640,13488,144152,157640,14236
2020/04/28,Ávila,Salamanca,218,330119,36407,293712,157640,14236
2020/04/28,Ávila,Segovia,97,153129,16761,136368,157640,14236
2020/04/28,Ávila,Toledo,132,694844,73597,621247,157640,14236
2020/04/28,Badajoz,Badajoz,50480,673559,71101,602458,673559,70016
2020/04/28,Badajoz,Córdoba,59,782979,84305,698674,673559,70016
2020/04/28,Badajoz,Ciudad Real,46,495761,37382,458379,673559,70016
2020/04/28,Badajoz,Huelva,227,521870,58856,463014,673559,70016
2020/04/28,Badajoz,Cáceres,928,394151,33267,360884,673559,70016
2020/04/28,Balears,Valencia,23,2565124,351841,2213283,1149460,112918
2020/04/28,Balears,Balears,93907,1149460,112446,1037014,1149460,112918
2020/04/28,Barcelona,Tarragona,1119,804664,84980,719684,5664579,726060
2020/04/28,Barcelona,Barcelona,436485,5664579,724098,4940481,5664579,726060
2020/04/28,Barcelona,Girona,1996,771044,75619,695425,5664579,726060
2020/04/28,Barcelona,Lleida,122,434930,51434,383496,5664579,726060
2020/04/28,Bizkaia,Araba,628,331549,30646,300903,1152934,167003
2020/04/28,Bizkaia,Gipuzkoa,840,723576,85957,637619,1152934,167003
2020/04/28,Bizkaia,Burgos,50,357072,35366,321706,1152934,167003
2020/04/28,Bizkaia,Cantabria,1534,580795,68252,512543,1152934,167003
2020/04/28,Bizkaia,Bizkaia,124379,1152934,169349,983585,1152934,167003
2020/04/28,Burgos,Palencia,160,160866,17922,142944,357072,36065
2020/04/28,Burgos,Araba,650,331549,30646,300903,357072,36065
2020/04/28,Burgos,Bizkaia,96,1152934,169349,983585,357072,36065
2020/04/28,Burgos,Burgos,25498,357072,35366,321706,357072,36065
2020/04/28,Burgos,Rioja,52,316798,37440,279358,357072,36065
2020/04/28,Burgos,Valladolid,101,519546,64114,455432,357072,36065
2020/04/28,Burgos,Segovia,39,153129,16761,136368,357072,36065
2020/04/28,Cáceres,Badajoz,1010,673559,71101,602458,394151,33332
2020/04/28,Cáceres,Cáceres,21057,394151,33267,360884,394151,33332
2020/04/28,Cáceres,Toledo,137,694844,73597,621247,394151,33332
2020/04/28,Cáceres,Ávila,96,157640,13488,144152,394151,33332
2020/04/28,Cádiz,Cádiz,102873,1240155,128594,1111561,1240155,130225
2020/04/28,Cádiz,Huelva,755,521870,58856,463014,1240155,130225
2020/04/28,Cádiz,Málaga,1032,1661785,170193,1491592,1240155,130225
2020/04/28,Cádiz,Sevilla,790,1942389,223905,1718484,1240155,130225
2020/04/28,Cantabria,Bizkaia,475,1152934,169349,983585,580795,65345
2020/04/28,Cantabria,Asturias,152,1022800,114112,908688,580795,65345
2020/04/28,Cantabria,Palencia,35,160866,17922,142944,580795,65345
2020/04/28,Cantabria,Cantabria,46976,580795,68252,512543,580795,65345
2020/04/28,Castellón,Tarragona,764,804664,84980,719684,579962,68694
2020/04/28,Castellón,Valencia,603,2565124,351841,2213283,579962,68694
2020/04/28,Castellón,Teruel,88,134137,8866,125271,579962,68694
2020/04/28,Castellón,Castellón,47148,579962,65190,514772,579962,68694
2020/04/28,Ceuta,Ceuta,8166,84777,8540,76237,84777,8509
2020/04/28,Ciudad Real,Ciudad Real,21412,495761,37382,458379,495761,34567
2020/04/28,Ciudad Real,Córdoba,376,782979,84305,698674,495761,34567
2020/04/28,Ciudad Real,Albacete,437,388167,29165,359002,495761,34567
2020/04/28,Ciudad Real,Toledo,162,694844,73597,621247,495761,34567
2020/04/28,Ciudad Real,Badajoz,50,673559,71101,602458,495761,34567
2020/04/28,Córdoba,Badajoz,88,673559,71101,602458,782979,81994
2020/04/28,Córdoba,Granada,109,914678,99232,815446,782979,81994
2020/04/28,Córdoba,Córdoba,56944,782979,84305,698674,782979,81994
2020/04/28,Córdoba,Jaén,627,633564,51628,581936,782979,81994
2020/04/28,Córdoba,Málaga,207,1661785,170193,1491592,782979,81994
2020/04/28,Córdoba,Ciudad Real,261,495761,37382,458379,782979,81994
2020/04/28,Córdoba,Sevilla,1220,1942389,223905,1718484,782979,81994
2020/04/28,Coruña,Lugo,583,329587,36665,292922,1119596,148581
2020/04/28,Coruña,Pontevedra,4270,942665,129423,813242,1119596,148581
2020/04/28,Coruña,Coruña,108786,1119596,146019,973577,1119596,148581
2020/04/28,Cuenca,Ciudad Real,91,495761,37382,458379,196329,17416
2020/04/28,Cuenca,Cuenca,8227,196329,16790,179539,196329,17416
2020/04/28,Cuenca,Albacete,681,388167,29165,359002,196329,17416
2020/04/28,Cuenca,Guadalajara,19,257762,29807,227955,196329,17416
2020/04/28,Cuenca,Madrid,51,6663394,797836,5865558,196329,17416
2020/04/28,Cuenca,Valencia,50,2565124,351841,2213283,196329,17416
2020/04/28,Cuenca,Toledo,163,694844,73597,621247,196329,17416
2020/04/28,Gipuzkoa,Navarra,207,654183,80821,573362,723576,90639
2020/04/28,Gipuzkoa,Bizkaia,1178,1152934,169349,983585,723576,90639
2020/04/28,Gipuzkoa,Araba,134,331549,30646,300903,723576,90639
2020/04/28,Gipuzkoa,Gipuzkoa,63909,723576,85957,637619,723576,90639
2020/04/28,Girona,Girona,49093,771044,75619,695425,771044,81427
2020/04/28,Girona,Lleida,140,434930,51434,383496,771044,81427
2020/04/28,Girona,Barcelona,1919,5664579,724098,4940481,771044,81427
2020/04/28,Granada,Jaén,335,633564,51628,581936,914678,96500
2020/04/28,Granada,Granada,69751,914678,99232,815446,914678,96500
2020/04/28,Granada,Córdoba,202,782979,84305,698674,914678,96500
2020/04/28,Granada,Málaga,138,1661785,170193,1491592,914678,96500
2020/04/28,Granada,Almería,391,716820,78167,638653,914678,96500
2020/04/28,Guadalajara,Madrid,1503,6663394,797836,5865558,257762,31037
2020/04/28,Guadalajara,Guadalajara,17007,257762,29807,227955,257762,31037
2020/04/28,Guadalajara,Cuenca,72,196329,16790,179539,257762,31037
2020/04/28,Huelva,Sevilla,1350,1942389,223905,1718484,521870,61849
2020/04/28,Huelva,Huelva,43218,521870,58856,463014,521870,61849
2020/04/28,Huelva,Cádiz,416,1240155,128594,1111561,521870,61849
2020/04/28,Huelva,Badajoz,313,673559,71101,602458,521870,61849
2020/04/28,Huesca,Lleida,947,434930,51434,383496,220461,25724
2020/04/28,Huesca,Huesca,15054,220461,23153,197308,220461,25724
2020/04/28,Huesca,Zaragoza,285,964724,127178,837546,220461,25724
2020/04/28,Jaén,Córdoba,608,782979,84305,698674,633564,50159
2020/04/28,Jaén,Jaén,33435,633564,51628,581936,633564,50159
2020/04/28,Jaén,Albacete,38,388167,29165,359002,633564,50159
2020/04/28,Jaén,Granada,200,914678,99232,815446,633564,50159
2020/04/28,Las Palmas de Gran Canaria,Las Palmas de Gran Canaria,109399,1120406,122785,997621,1120406,122064
2020/04/28,León,Ourense,217,307651,40834,266817,460001,51630
2020/04/28,León,Zamora,146,172539,17842,154697,460001,51630
2020/04/28,León,Palencia,35,160866,17922,142944,460001,51630
2020/04/28,León,León,36998,460001,52116,407885,460001,51630
2020/04/28,León,Lugo,32,329587,36665,292922,460001,51630
2020/04/28,León,Asturias,30,1022800,114112,908688,460001,51630
2020/04/28,Lleida,Lleida,31620,434930,51434,383496,434930,49450
2020/04/28,Lleida,Tarragona,26,804664,84980,719684,434930,49450
2020/04/28,Lleida,Huesca,644,220461,23153,197308,434930,49450
2020/04/28,Lleida,Girona,156,771044,75619,695425,434930,49450
2020/04/28,Lleida,Zaragoza,131,964724,127178,837546,434930,49450
2020/04/28,Lleida,Barcelona,236,5664579,724098,4940481,434930,49450
2020/04/28,Lugo,Ourense,168,307651,40834,266817,329587,37843
2020/04/28,Lugo,Asturias,594,1022800,114112,908688,329587,37843
2020/04/28,Lugo,Coruña,527,1119596,146019,973577,329587,37843
2020/04/28,Lugo,Lugo,25354,329587,36665,292922,329587,37843
2020/04/28,Madrid,Cuenca,72,196329,16790,179539,6663394,800936
2020/04/28,Madrid,Segovia,18,153129,16761,136368,6663394,800936
2020/04/28,Madrid,Toledo,3125,694844,73597,621247,6663394,800936
2020/04/28,Madrid,Valencia,25,2565124,351841,2213283,6663394,800936
2020/04/28,Madrid,Guadalajara,2068,257762,29807,227955,6663394,800936
2020/04/28,Madrid,Madrid,443051,6663394,797836,5865558,6663394,800936
2020/04/28,Madrid,Ávila,146,157640,13488,144152,6663394,800936
2020/04/28,Málaga,Málaga,132183,1661785,170193,1491592,1661785,173399
2020/04/28,Málaga,Córdoba,215,782979,84305,698674,1661785,173399
2020/04/28,Málaga,Sevilla,219,1942389,223905,1718484,1661785,173399
2020/04/28,Málaga,Cádiz,807,1240155,128594,1111561,1661785,173399
2020/04/28,Málaga,Granada,136,914678,99232,815446,1661785,173399
2020/04/28,Melilla,Melilla,10625,86487,11050,75437,86487,10756
2020/04/28,Murcia,Almería,1123,716820,78167,638653,1493898,175838
2020/04/28,Murcia,Alicante,2366,1858683,222214,1636469,1493898,175838
2020/04/28,Murcia,Murcia,132592,1493898,179793,1314105,1493898,175838
2020/04/28,Murcia,Granada,25,914678,99232,815446,1493898,175838
2020/04/28,Murcia,Albacete,436,388167,29165,359002,1493898,175838
2020/04/28,Navarra,Gipuzkoa,329,723576,85957,637619,654183,83086
2020/04/28,Navarra,Araba,58,331549,30646,300903,654183,83086
2020/04/28,Navarra,Rioja,1986,316798,37440,279358,654183,83086
2020/04/28,Navarra,Zaragoza,556,964724,127178,837546,654183,83086
2020/04/28,Navarra,Navarra,55499,654183,80821,573362,654183,83086
2020/04/28,Ourense,León,103,460001,52116,407885,307651,41179
2020/04/28,Ourense,Pontevedra,196,942665,129423,813242,307651,41179
2020/04/28,Ourense,Ourense,30410,307651,40834,266817,307651,41179
2020/04/28,Ourense,Zamora,59,172539,17842,154697,307651,41179
2020/04/28,Ourense,Lugo,213,329587,36665,292922,307651,41179
2020/04/28,Palencia,Valladolid,87,519546,64114,455432,160866,19308
2020/04/28,Palencia,León,33,460001,52116,407885,160866,19308
2020/04/28,Palencia,Palencia,12553,160866,17922,142944,160866,19308
2020/04/28,Palencia,Cantabria,158,580795,68252,512543,160866,19308
2020/04/28,Palencia,Burgos,190,357072,35366,321706,160866,19308
2020/04/28,Pontevedra,Coruña,3552,1119596,146019,973577,942665,129421
2020/04/28,Pontevedra,Lugo,32,329587,36665,292922,942665,129421
2020/04/28,Pontevedra,Pontevedra,97923,942665,129423,813242,942665,129421
2020/04/28,Pontevedra,Ourense,154,307651,40834,266817,942665,129421
2020/04/28,Rioja,Navarra,1703,654183,80821,573362,316798,35731
2020/04/28,Rioja,Araba,531,331549,30646,300903,316798,35731
2020/04/28,Rioja,Rioja,26145,316798,37440,279358,316798,35731
2020/04/28,Salamanca,Salamanca,27679,330119,36407,293712,330119,36261
2020/04/28,Salamanca,Ávila,179,157640,13488,144152,330119,36261
2020/04/28,Salamanca,Zamora,53,172539,17842,154697,330119,36261
2020/04/28,Santa Cruz de Tenerife,Santa Cruz de Tenerife,99894,1032983,113394,919589,1032983,112753
2020/04/28,Segovia,Segovia,10944,153129,16761,136368,153129,17798
2020/04/28,Segovia,Valladolid,191,519546,64114,455432,153129,17798
2020/04/28,Segovia,Burgos,100,357072,35366,321706,153129,17798
2020/04/28,Segovia,Ávila,95,157640,13488,144152,153129,17798
2020/04/28,Sevilla,Málaga,38,1661785,170193,1491592,1942389,217687
2020/04/28,Sevilla,Huelva,452,521870,58856,463014,1942389,217687
2020/04/28,Sevilla,Cádiz,746,1240155,128594,1111561,1942389,217687
2020/04/28,Sevilla,Sevilla,147109,1942389,223905,1718484,1942389,217687
2020/04/28,Sevilla,Badajoz,29,673559,71101,602458,1942389,217687
2020/04/28,Sevilla,Córdoba,1406,782979,84305,698674,1942389,217687
2020/04/28,Soria,Segovia,18,153129,16761,136368,88636,7207
2020/04/28,Soria,Soria,4634,88636,6461,82175,88636,7207
2020/04/28,Soria,Valladolid,19,519546,64114,455432,88636,7207
2020/04/28,Soria,Zaragoza,115,964724,127178,837546,88636,7207
2020/04/28,Soria,Burgos,64,357072,35366,321706,88636,7207
2020/04/28,Tarragona,Tarragona,53986,804664,84980,719684,804664,84524
2020/04/28,Tarragona,Barcelona,674,5664579,724098,4940481,804664,84524
2020/04/28,Tarragona,Zaragoza,40,964724,127178,837546,804664,84524
2020/04/28,Tarragona,Castellón,659,579962,65190,514772,804664,84524
2020/04/28,Tarragona,Teruel,52,134137,8866,125271,804664,84524
2020/04/28,Teruel,Zaragoza,105,964724,127178,837546,134137,10265
2020/04/28,Teruel,Tarragona,55,804664,84980,719684,134137,10265
2020/04/28,Teruel,Castellón,49,579962,65190,514772,134137,10265
2020/04/28,Teruel,Teruel,4964,134137,8866,125271,134137,10265
2020/04/28,Toledo,Ciudad Real,251,495761,37382,458379,694844,70926
2020/04/28,Toledo,Cáceres,110,394151,33267,360884,694844,70926
2020/04/28,Toledo,Toledo,34294,694844,73597,621247,694844,70926
2020/04/28,Toledo,Cuenca,93,196329,16790,179539,694844,70926
2020/04/28,Toledo,Madrid,2972,6663394,797836,5865558,694844,70926
2020/04/28,Toledo,Ávila,113,157640,13488,144152,694844,70926
2020/04/28,Valencia,Valencia,234347,2565124,351841,2213283,2565124,342407
2020/04/28,Valencia,Castellón,550,579962,65190,514772,2565124,342407
2020/04/28,Valencia,Albacete,293,388167,29165,359002,2565124,342407
2020/04/28,Valencia,Cuenca,93,196329,16790,179539,2565124,342407
2020/04/28,Valencia,Alicante,866,1858683,222214,1636469,2565124,342407
2020/04/28,Valencia,Teruel,19,134137,8866,125271,2565124,342407
2020/04/28,Valladolid,Ávila,27,157640,13488,144152,519546,61459
2020/04/28,Valladolid,Valladolid,44103,519546,64114,455432,519546,61459
2020/04/28,Valladolid,Soria,28,88636,6461,82175,519546,61459
2020/04/28,Valladolid,Segovia,300,153129,16761,136368,519546,61459
2020/04/28,Valladolid,Zamora,112,172539,17842,154697,519546,61459
2020/04/28,Valladolid,Burgos,81,357072,35366,321706,519546,61459
2020/04/28,Zamora,Ourense,73,307651,40834,266817,172539,17645
2020/04/28,Zamora,Zamora,11610,172539,17842,154697,172539,17645
2020/04/28,Zamora,Valladolid,72,519546,64114,455432,172539,17645
2020/04/28,Zamora,León,30,460001,52116,407885,172539,17645
2020/04/28,Zaragoza,Lleida,56,434930,51434,383496,964724,121540
2020/04/28,Zaragoza,Soria,28,88636,6461,82175,964724,121540
2020/04/28,Zaragoza,Huesca,272,220461,23153,197308,964724,121540
2020/04/28,Zaragoza,Navarra,291,654183,80821,573362,964724,121540
2020/04/28,Zaragoza,Teruel,195,134137,8866,125271,964724,121540
2020/04/28,Zaragoza,Zaragoza,92429,964724,127178,837546,964724,121540
2020/04/29,Albacete,Albacete,17579,388167,29661,358506,388167,30009
2020/04/29,Albacete,Ciudad Real,589,495761,37748,458013,388167,30009
2020/04/29,Albacete,Murcia,365,1493898,180698,1313200,388167,30009
2020/04/29,Albacete,Alicante,178,1858683,226542,1632141,388167,30009
2020/04/29,Albacete,Valencia,358,2565124,359395,2205729,388167,30009
2020/04/29,Albacete,Jaén,51,633564,55841,577723,388167,30009
2020/04/29,Albacete,Cuenca,641,196329,17069,179260,388167,30009
2020/04/29,Alicante,Alicante,172732,1858683,226542,1632141,1858683,230880
2020/04/29,Alicante,Valencia,1060,2565124,359395,2205729,1858683,230880
2020/04/29,Alicante,Murcia,2779,1493898,180698,1313200,1858683,230880
2020/04/29,Alicante,Albacete,328,388167,29661,358506,1858683,230880
2020/04/29,Almería,Murcia,1786,1493898,180698,1313200,716820,80899
2020/04/29,Almería,Granada,492,914678,101337,813341,716820,80899
2020/04/29,Almería,Almería,64517,716820,78853,637967,716820,80899
2020/04/29,Araba,Rioja,1801,316798,38730,278068,331549,51514
2020/04/29,Araba,Burgos,1508,357072,36509,320563,331549,51514
2020/04/29,Araba,Bizkaia,1136,1152934,173470,979464,331549,51514
2020/04/29,Araba,Navarra,134,654183,82600,571583,331549,51514
2020/04/29,Araba,Araba,35713,331549,44652,286897,331549,51514
2020/04/29,Araba,Gipuzkoa,124,723576,87060,636516,331549,51514
2020/04/29,Asturias,León,29,460001,52017,407984,1022800,114874
2020/04/29,Asturias,Asturias,87933,1022800,115043,907757,1022800,114874
2020/04/29,Asturias,Lugo,750,329587,36479,293108,1022800,114874
2020/04/29,Asturias,Cantabria,165,580795,69466,511329,1022800,114874
2020/04/29,Ávila,Segovia,58,153129,16456,136673,157640,14346
2020/04/29,Ávila,Madrid,118,6663394,810499,5852895,157640,14346
2020/04/29,Ávila,Salamanca,250,330119,36947,293172,157640,14346
2020/04/29,Ávila,Toledo,149,694844,73973,620871,157640,14346
2020/04/29,Ávila,Ávila,8577,157640,13714,143926,157640,14346
2020/04/29,Ávila,Cáceres,71,394151,34138,360013,157640,14346
2020/04/29,Badajoz,Ciudad Real,47,495761,37748,458013,673559,69151
2020/04/29,Badajoz,Córdoba,90,782979,89097,693882,673559,69151
2020/04/29,Badajoz,Huelva,182,521870,60500,461370,673559,69151
2020/04/29,Badajoz,Sevilla,80,1942389,236037,1706352,673559,69151
2020/04/29,Badajoz,Badajoz,50241,673559,71298,602261,673559,69151
2020/04/29,Badajoz,Cáceres,992,394151,34138,360013,673559,69151
2020/04/29,Balears,Balears,96116,1149460,114528,1034932,1149460,115329
2020/04/29,Balears,Valencia,20,2565124,359395,2205729,1149460,115329
2020/04/29,Barcelona,Barcelona,440081,5664579,729457,4935122,5664579,731244
2020/04/29,Barcelona,Tarragona,1041,804664,86195,718469,5664579,731244
2020/04/29,Barcelona,Lleida,200,434930,52984,381946,5664579,731244
2020/04/29,Barcelona,Girona,2159,771044,77102,693942,5664579,731244
2020/04/29,Bizkaia,Bizkaia,126677,1152934,173470,979464,1152934,169301
2020/04/29,Bizkaia,Burgos,51,357072,36509,320563,1152934,169301
2020/04/29,Bizkaia,Cantabria,1608,580795,69466,511329,1152934,169301
2020/04/29,Bizkaia,Gipuzkoa,839,723576,87060,636516,1152934,169301
2020/04/29,Bizkaia,Araba,584,331549,44652,286897,1152934,169301
2020/04/29,Burgos,Palencia,160,160866,17962,142904,357072,36836
2020/04/29,Burgos,Araba,748,331549,44652,286897,357072,36836
2020/04/29,Burgos,Bizkaia,74,1152934,173470,979464,357072,36836
2020/04/29,Burgos,Valladolid,94,519546,65420,454126,357072,36836
2020/04/29,Burgos,Soria,26,88636,6760,81876,357072,36836
2020/04/29,Burgos,Burgos,25803,357072,36509,320563,357072,36836
2020/04/29,Burgos,Rioja,67,316798,38730,278068,357072,36836
2020/04/29,Cáceres,Badajoz,1056,673559,71298,602261,394151,33942
2020/04/29,Cáceres,Toledo,140,694844,73973,620871,394151,33942
2020/04/29,Cáceres,Ávila,110,157640,13714,143926,394151,33942
2020/04/29,Cáceres,Cáceres,21947,394151,34138,360013,394151,33942
2020/04/29,Cádiz,Málaga,1110,1661785,178971,1482814,1240155,136125
2020/04/29,Cádiz,Sevilla,819,1942389,236037,1706352,1240155,136125
2020/04/29,Cádiz,Huelva,651,521870,60500,461370,1240155,136125
2020/04/29,Cádiz,Cádiz,109393,1240155,135524,1104631,1240155,136125
2020/04/29,Cantabria,Palencia,57,160866,17962,142904,580795,66578
2020/04/29,Cantabria,Asturias,247,1022800,115043,907757,580795,66578
2020/04/29,Cantabria,Bizkaia,465,1152934,173470,979464,580795,66578
2020/04/29,Cantabria,Cantabria,47865,580795,69466,511329,580795,66578
2020/04/29,Castellón,Valencia,590,2565124,359395,2205729,579962,69394
2020/04/29,Castellón,Teruel,109,134137,9041,125096,579962,69394
2020/04/29,Castellón,Tarragona,770,804664,86195,718469,579962,69394
2020/04/29,Castellón,Castellón,47955,579962,65898,514064,579962,69394
2020/04/29,Ceuta,Ceuta,8112,84777,8501,76276,84777,8467
2020/04/29,Ciudad Real,Badajoz,64,673559,71298,602261,495761,35431
2020/04/29,Ciudad Real,Cuenca,33,196329,17069,179260,495761,35431
2020/04/29,Ciudad Real,Toledo,182,694844,73973,620871,495761,35431
2020/04/29,Ciudad Real,Albacete,477,388167,29661,358506,495761,35431
2020/04/29,Ciudad Real,Ciudad Real,21515,495761,37748,458013,495761,35431
2020/04/29,Ciudad Real,Córdoba,416,782979,89097,693882,495761,35431
2020/04/29,Córdoba,Jaén,721,633564,55841,577723,782979,85766
2020/04/29,Córdoba,Málaga,286,1661785,178971,1482814,782979,85766
2020/04/29,Córdoba,Sevilla,1554,1942389,236037,1706352,782979,85766
2020/04/29,Córdoba,Ciudad Real,241,495761,37748,458013,782979,85766
2020/04/29,Córdoba,Córdoba,60580,782979,89097,693882,782979,85766
2020/04/29,Córdoba,Badajoz,110,673559,71298,602261,782979,85766
2020/04/29,Córdoba,Granada,137,914678,101337,813341,782979,85766
2020/04/29,Coruña,Lugo,491,329587,36479,293108,1119596,148111
2020/04/29,Coruña,Coruña,108653,1119596,146035,973561,1119596,148111
2020/04/29,Coruña,Pontevedra,4306,942665,130198,812467,1119596,148111
2020/04/29,Cuenca,Guadalajara,23,257762,30851,226911,196329,17890
2020/04/29,Cuenca,Cuenca,8396,196329,17069,179260,196329,17890
2020/04/29,Cuenca,Toledo,199,694844,73973,620871,196329,17890
2020/04/29,Cuenca,Madrid,68,6663394,810499,5852895,196329,17890
2020/04/29,Cuenca,Valencia,63,2565124,359395,2205729,196329,17890
2020/04/29,Cuenca,Albacete,561,388167,29661,358506,196329,17890
2020/04/29,Cuenca,Ciudad Real,94,495761,37748,458013,196329,17890
2020/04/29,Gipuzkoa,Araba,102,331549,44652,286897,723576,90812
2020/04/29,Gipuzkoa,Bizkaia,1240,1152934,173470,979464,723576,90812
2020/04/29,Gipuzkoa,Gipuzkoa,64394,723576,87060,636516,723576,90812
2020/04/29,Gipuzkoa,Navarra,258,654183,82600,571583,723576,90812
2020/04/29,Girona,Barcelona,1987,5664579,729457,4935122,771044,81689
2020/04/29,Girona,Lleida,153,434930,52984,381946,771044,81689
2020/04/29,Girona,Girona,49400,771044,77102,693942,771044,81689
2020/04/29,Granada,Jaén,391,633564,55841,577723,914678,98965
2020/04/29,Granada,Córdoba,231,782979,89097,693882,914678,98965
2020/04/29,Granada,Málaga,143,1661785,178971,1482814,914678,98965
2020/04/29,Granada,Almería,394,716820,78853,637967,914678,98965
2020/04/29,Granada,Granada,71340,914678,101337,813341,914678,98965
2020/04/29,Guadalajara,Guadalajara,17943,257762,30851,226911,257762,32283
2020/04/29,Guadalajara,Cuenca,48,196329,17069,179260,257762,32283
2020/04/29,Guadalajara,Madrid,1646,6663394,810499,5852895,257762,32283
2020/04/29,Huelva,Badajoz,322,673559,71298,602261,521870,63021
2020/04/29,Huelva,Huelva,45420,521870,60500,461370,521870,63021
2020/04/29,Huelva,Sevilla,1378,1942389,236037,1706352,521870,63021
2020/04/29,Huelva,Cádiz,454,1240155,135524,1104631,521870,63021
2020/04/29,Huesca,Huesca,14946,220461,23096,197365,220461,26098
2020/04/29,Huesca,Zaragoza,274,964724,129686,835038,220461,26098
2020/04/29,Huesca,Lleida,880,434930,52984,381946,220461,26098
2020/04/29,Jaén,Albacete,34,388167,29661,358506,633564,54397
2020/04/29,Jaén,Jaén,37057,633564,55841,577723,633564,54397
2020/04/29,Jaén,Granada,264,914678,101337,813341,633564,54397
2020/04/29,Jaén,Córdoba,715,782979,89097,693882,633564,54397
2020/04/29,Las Palmas de Gran Canaria,Santa Cruz de Tenerife,18,1032983,115391,917592,1120406,123432
2020/04/29,Las Palmas de Gran Canaria,Las Palmas de Gran Canaria,110947,1120406,124312,996094,1120406,123432
2020/04/29,León,Asturias,39,1022800,115043,907757,460001,52077
2020/04/29,León,León,37581,460001,52017,407984,460001,52077
2020/04/29,León,Ourense,189,307651,40863,266788,460001,52077
2020/04/29,León,Zamora,147,172539,18250,154289,460001,52077
2020/04/29,León,Palencia,27,160866,17962,142904,460001,52077
2020/04/29,Lleida,Lleida,32942,434930,52984,381946,434930,50776
2020/04/29,Lleida,Girona,146,771044,77102,693942,434930,50776
2020/04/29,Lleida,Huesca,610,220461,23096,197365,434930,50776
2020/04/29,Lleida,Barcelona,208,5664579,729457,4935122,434930,50776
2020/04/29,Lleida,Tarragona,26,804664,86195,718469,434930,50776
2020/04/29,Lleida,Zaragoza,95,964724,129686,835038,434930,50776
2020/04/29,Lugo,Pontevedra,32,942665,130198,812467,329587,37927
2020/04/29,Lugo,Ourense,85,307651,40863,266788,329587,37927
2020/04/29,Lugo,Lugo,25164,329587,36479,293108,329587,37927
2020/04/29,Lugo,Coruña,556,1119596,146035,973561,329587,37927
2020/04/29,Lugo,Asturias,616,1022800,115043,907757,329587,37927
2020/04/29,Madrid,Toledo,3458,694844,73973,620871,6663394,816611
2020/04/29,Madrid,Cuenca,80,196329,17069,179260,6663394,816611
2020/04/29,Madrid,Madrid,452679,6663394,810499,5852895,6663394,816611
2020/04/29,Madrid,Valencia,17,2565124,359395,2205729,6663394,816611
2020/04/29,Madrid,Ávila,197,157640,13714,143926,6663394,816611
2020/04/29,Madrid,Guadalajara,2120,257762,30851,226911,6663394,816611
2020/04/29,Málaga,Málaga,141898,1661785,178971,1482814,1661785,181792
2020/04/29,Málaga,Sevilla,274,1942389,236037,1706352,1661785,181792
2020/04/29,Málaga,Granada,241,914678,101337,813341,1661785,181792
2020/04/29,Málaga,Cádiz,907,1240155,135524,1104631,1661785,181792
2020/04/29,Málaga,Córdoba,821,782979,89097,693882,1661785,181792
2020/04/29,Melilla,Melilla,10463,86487,10679,75808,86487,10603
2020/04/29,Murcia,Almería,1221,716820,78853,637967,1493898,177926
2020/04/29,Murcia,Albacete,438,388167,29661,358506,1493898,177926
2020/04/29,Murcia,Murcia,134167,1493898,180698,1313200,1493898,177926
2020/04/29,Murcia,Alicante,2462,1858683,226542,1632141,1493898,177926
2020/04/29,Murcia,Barcelona,17,5664579,729457,4935122,1493898,177926
2020/04/29,Navarra,Araba,59,331549,44652,286897,654183,83949
2020/04/29,Navarra,Gipuzkoa,335,723576,87060,636516,654183,83949
2020/04/29,Navarra,Rioja,2210,316798,38730,278068,654183,83949
2020/04/29,Navarra,Zaragoza,513,964724,129686,835038,654183,83949
2020/04/29,Navarra,Navarra,56319,654183,82600,571583,654183,83949
2020/04/29,Ourense,Pontevedra,101,942665,130198,812467,307651,41255
2020/04/29,Ourense,Zamora,63,172539,18250,154289,307651,41255
2020/04/29,Ourense,Lugo,177,329587,36479,293108,307651,41255
2020/04/29,Ourense,Ourense,30540,307651,40863,266788,307651,41255
2020/04/29,Ourense,León,130,460001,52017,407984,307651,41255
2020/04/29,Palencia,Valladolid,45,519546,65420,454126,160866,19096
2020/04/29,Palencia,Cantabria,155,580795,69466,511329,160866,19096
2020/04/29,Palencia,Palencia,12343,160866,17962,142904,160866,19096
2020/04/29,Palencia,Burgos,214,357072,36509,320563,160866,19096
2020/04/29,Pontevedra,Coruña,3548,1119596,146035,973561,942665,130235
2020/04/29,Pontevedra,Pontevedra,98709,942665,130198,812467,942665,130235
2020/04/29,Pontevedra,Ourense,130,307651,40863,266788,942665,130235
2020/04/29,Rioja,Araba,613,331549,44652,286897,316798,36669
2020/04/29,Rioja,Burgos,20,357072,36509,320563,316798,36669
2020/04/29,Rioja,Navarra,1658,654183,82600,571583,316798,36669
2020/04/29,Rioja,Rioja,26916,316798,38730,278068,316798,36669
2020/04/29,Salamanca,Salamanca,28194,330119,36947,293172,330119,36334
2020/04/29,Salamanca,Zamora,23,172539,18250,154289,330119,36334
2020/04/29,Salamanca,Ávila,162,157640,13714,143926,330119,36334
2020/04/29,Santa Cruz de Tenerife,Santa Cruz de Tenerife,100612,1032983,115391,917592,1032983,115332
2020/04/29,Segovia,Burgos,91,357072,36509,320563,153129,17741
2020/04/29,Segovia,Segovia,10636,153129,16456,136673,153129,17741
2020/04/29,Segovia,Ávila,104,157640,13714,143926,153129,17741
2020/04/29,Segovia,Valladolid,195,519546,65420,454126,153129,17741
2020/04/29,Sevilla,Huelva,581,521870,60500,461370,1942389,227450
2020/04/29,Sevilla,Sevilla,158228,1942389,236037,1706352,1942389,227450
2020/04/29,Sevilla,Málaga,141,1661785,178971,1482814,1942389,227450
2020/04/29,Sevilla,Cádiz,672,1240155,135524,1104631,1942389,227450
2020/04/29,Sevilla,Badajoz,25,673559,71298,602261,1942389,227450
2020/04/29,Sevilla,Córdoba,1737,782979,89097,693882,1942389,227450
2020/04/29,Soria,Segovia,21,153129,16456,136673,88636,7590
2020/04/29,Soria,Soria,4927,88636,6760,81876,88636,7590
2020/04/29,Soria,Burgos,60,357072,36509,320563,88636,7590
2020/04/29,Soria,Valladolid,31,519546,65420,454126,88636,7590
2020/04/29,Soria,Zaragoza,119,964724,129686,835038,88636,7590
2020/04/29,Tarragona,Tarragona,55373,804664,86195,718469,804664,86417
2020/04/29,Tarragona,Teruel,62,134137,9041,125096,804664,86417
2020/04/29,Tarragona,Barcelona,759,5664579,729457,4935122,804664,86417
2020/04/29,Tarragona,Zaragoza,45,964724,129686,835038,804664,86417
2020/04/29,Tarragona,Castellón,662,579962,65898,514064,804664,86417
2020/04/29,Teruel,Zaragoza,92,964724,129686,835038,134137,10474
2020/04/29,Teruel,Tarragona,59,804664,86195,718469,134137,10474
2020/04/29,Teruel,Teruel,5090,134137,9041,125096,134137,10474
2020/04/29,Teruel,Castellón,81,579962,65898,514064,134137,10474
2020/04/29,Toledo,Toledo,34240,694844,73973,620871,694844,71355
2020/04/29,Toledo,Cuenca,67,196329,17069,179260,694844,71355
2020/04/29,Toledo,Cáceres,163,394151,34138,360013,694844,71355
2020/04/29,Toledo,Ciudad Real,199,495761,37748,458013,694844,71355
2020/04/29,Toledo,Madrid,3101,6663394,810499,5852895,694844,71355
2020/04/29,Toledo,Ávila,158,157640,13714,143926,694844,71355
2020/04/29,Valencia,Alicante,906,1858683,226542,1632141,2565124,349778
2020/04/29,Valencia,Valencia,241402,2565124,359395,2205729,2565124,349778
2020/04/29,Valencia,Castellón,617,579962,65898,514064,2565124,349778
2020/04/29,Valencia,Albacete,288,388167,29661,358506,2565124,349778
2020/04/29,Valencia,Murcia,21,1493898,180698,1313200,2565124,349778
2020/04/29,Valencia,Cuenca,83,196329,17069,179260,2565124,349778
2020/04/29,Valladolid,Soria,21,88636,6760,81876,519546,62525
2020/04/29,Valladolid,Ávila,24,157640,13714,143926,519546,62525
2020/04/29,Valladolid,Zamora,144,172539,18250,154289,519546,62525
2020/04/29,Valladolid,Palencia,40,160866,17962,142904,519546,62525
2020/04/29,Valladolid,Burgos,94,357072,36509,320563,519546,62525
2020/04/29,Valladolid,Segovia,240,153129,16456,136673,519546,62525
2020/04/29,Valladolid,Valladolid,45155,519546,65420,454126,519546,62525
2020/04/29,Zamora,Zamora,12076,172539,18250,154289,172539,18227
2020/04/29,Zamora,León,27,460001,52017,407984,172539,18227
2020/04/29,Zamora,Valladolid,40,519546,65420,454126,172539,18227
2020/04/29,Zamora,Ourense,93,307651,40863,266788,172539,18227
2020/04/29,Zaragoza,Barcelona,17,5664579,729457,4935122,964724,124621
2020/04/29,Zaragoza,Navarra,387,654183,82600,571583,964724,124621
2020/04/29,Zaragoza,Huesca,278,220461,23096,197365,964724,124621
2020/04/29,Zaragoza,Zaragoza,95008,964724,129686,835038,964724,124621
2020/04/29,Zaragoza,Teruel,209,134137,9041,125096,964724,124621
2020/04/29,Zaragoza,Lleida,70,434930,52984,381946,964724,124621
2020/04/29,Zaragoza,Soria,57,88636,6760,81876,964724,124621
2020/04/30,Albacete,Alicante,207,1858683,229971,1628712,388167,32107
2020/04/30,Albacete,Jaén,42,633564,56341,577223,388167,32107
2020/04/30,Albacete,Ciudad Real,574,495761,37401,458360,388167,32107
2020/04/30,Albacete,Albacete,19408,388167,31333,356834,388167,32107
2020/04/30,Albacete,Cuenca,697,196329,17020,179309,388167,32107
2020/04/30,Albacete,Valencia,422,2565124,362691,2202433,388167,32107
2020/04/30,Albacete,Murcia,402,1493898,183668,1310230,388167,32107
2020/04/30,Alicante,Murcia,2643,1493898,183668,1310230,1858683,234624
2020/04/30,Alicante,Albacete,316,388167,31333,356834,1858683,234624
2020/04/30,Alicante,Valencia,1108,2565124,362691,2202433,1858683,234624
2020/04/30,Alicante,Alicante,176432,1858683,229971,1628712,1858683,234624
2020/04/30,Almería,Murcia,1884,1493898,183668,1310230,716820,82677
2020/04/30,Almería,Granada,497,914678,102597,812081,716820,82677
2020/04/30,Almería,Almería,65601,716820,80556,636264,716820,82677
2020/04/30,Araba,Rioja,1781,316798,39954,276844,331549,52152
2020/04/30,Araba,Burgos,1553,357072,36390,320682,331549,52152
2020/04/30,Araba,Bizkaia,1092,1152934,175729,977205,331549,52152
2020/04/30,Araba,Araba,37181,331549,46543,285006,331549,52152
2020/04/30,Araba,Navarra,91,654183,85725,568458,331549,52152
2020/04/30,Araba,Gipuzkoa,121,723576,88614,634962,331549,52152
2020/04/30,Asturias,Lugo,793,329587,36871,292716,1022800,117124
2020/04/30,Asturias,Cantabria,156,580795,70506,510289,1022800,117124
2020/04/30,Asturias,Asturias,90333,1022800,117513,905287,1022800,117124
2020/04/30,Ávila,Segovia,77,153129,16444,136685,157640,14413
2020/04/30,Ávila,Salamanca,281,330119,37485,292634,157640,14413
2020/04/30,Ávila,Ávila,8802,157640,13698,143942,157640,14413
2020/04/30,Ávila,Toledo,153,694844,72822,622022,157640,14413
2020/04/30,Ávila,Cáceres,116,394151,33855,360296,157640,14413
2020/04/30,Ávila,Madrid,147,6663394,815780,5847614,157640,14413
2020/04/30,Badajoz,Ciudad Real,34,495761,37401,458360,673559,69906
2020/04/30,Badajoz,Cáceres,1047,394151,33855,360296,673559,69906
2020/04/30,Badajoz,Badajoz,50724,673559,70835,602724,673559,69906
2020/04/30,Badajoz,Sevilla,76,1942389,238905,1703484,673559,69906
2020/04/30,Badajoz,Huelva,213,521870,59927,461943,673559,69906
2020/04/30,Badajoz,Córdoba,113,782979,89844,693135,673559,69906
2020/04/30,Balears,Balears,97891,1149460,116518,1032942,1149460,117682
2020/04/30,Balears,Valencia,99,2565124,362691,2202433,1149460,117682
2020/04/30,Barcelona,Tarragona,1286,804664,87389,717275,5664579,747335
2020/04/30,Barcelona,Lleida,136,434930,53336,381594,5664579,747335
2020/04/30,Barcelona,Barcelona,454295,5664579,745885,4918694,5664579,747335
2020/04/30,Barcelona,Girona,2402,771044,77835,693209,5664579,747335
2020/04/30,Bizkaia,Gipuzkoa,957,723576,88614,634962,1152934,172022
2020/04/30,Bizkaia,Burgos,39,357072,36390,320682,1152934,172022
2020/04/30,Bizkaia,Araba,680,331549,46543,285006,1152934,172022
2020/04/30,Bizkaia,Cantabria,1517,580795,70506,510289,1152934,172022
2020/04/30,Bizkaia,Bizkaia,129794,1152934,175729,977205,1152934,172022
2020/04/30,Burgos,Rioja,35,316798,39954,276844,357072,36413
2020/04/30,Burgos,Soria,28,88636,6682,81954,357072,36413
2020/04/30,Burgos,Burgos,25779,357072,36390,320682,357072,36413
2020/04/30,Burgos,Bizkaia,76,1152934,175729,977205,357072,36413
2020/04/30,Burgos,Valladolid,64,519546,64460,455086,357072,36413
2020/04/30,Burgos,Araba,779,331549,46543,285006,357072,36413
2020/04/30,Burgos,Palencia,174,160866,18006,142860,357072,36413
2020/04/30,Cáceres,Toledo,160,694844,72822,622022,394151,34008
2020/04/30,Cáceres,Badajoz,1017,673559,70835,602724,394151,34008
2020/04/30,Cáceres,Cáceres,21997,394151,33855,360296,394151,34008
2020/04/30,Cáceres,Ávila,114,157640,13698,143942,394151,34008
2020/04/30,Cádiz,Cádiz,112440,1240155,137719,1102436,1240155,140026
2020/04/30,Cádiz,Málaga,1169,1661785,180249,1481536,1240155,140026
2020/04/30,Cádiz,Sevilla,806,1942389,238905,1703484,1240155,140026
2020/04/30,Cádiz,Huelva,730,521870,59927,461943,1240155,140026
2020/04/30,Cantabria,Cantabria,49153,580795,70506,510289,580795,67828
2020/04/30,Cantabria,Asturias,418,1022800,117513,905287,580795,67828
2020/04/30,Cantabria,Palencia,74,160866,18006,142860,580795,67828
2020/04/30,Cantabria,Bizkaia,472,1152934,175729,977205,580795,67828
2020/04/30,Castellón,Valencia,656,2565124,362691,2202433,579962,69654
2020/04/30,Castellón,Castellón,48037,579962,66130,513832,579962,69654
2020/04/30,Castellón,Tarragona,876,804664,87389,717275,579962,69654
2020/04/30,Castellón,Teruel,68,134137,9018,125119,579962,69654
2020/04/30,Ceuta,Ceuta,8185,84777,8590,76187,84777,8533
2020/04/30,Ciudad Real,Albacete,450,388167,31333,356834,495761,34470
2020/04/30,Ciudad Real,Badajoz,55,673559,70835,602724,495761,34470
2020/04/30,Ciudad Real,Toledo,234,694844,72822,622022,495761,34470
2020/04/30,Ciudad Real,Córdoba,375,782979,89844,693135,495761,34470
2020/04/30,Ciudad Real,Jaén,16,633564,56341,577223,495761,34470
2020/04/30,Ciudad Real,Ciudad Real,21185,495761,37401,458360,495761,34470
2020/04/30,Córdoba,Jaén,769,633564,56341,577223,782979,88297
2020/04/30,Córdoba,Ciudad Real,273,495761,37401,458360,782979,88297
2020/04/30,Córdoba,Sevilla,1457,1942389,238905,1703484,782979,88297
2020/04/30,Córdoba,Granada,130,914678,102597,812081,782979,88297
2020/04/30,Córdoba,Badajoz,82,673559,70835,602724,782979,88297
2020/04/30,Córdoba,Córdoba,62168,782979,89844,693135,782979,88297
2020/04/30,Córdoba,Málaga,348,1661785,180249,1481536,782979,88297
2020/04/30,Coruña,Lugo,540,329587,36871,292716,1119596,148237
2020/04/30,Coruña,Coruña,109503,1119596,146914,972682,1119596,148237
2020/04/30,Coruña,Pontevedra,4537,942665,130900,811765,1119596,148237
2020/04/30,Cuenca,Ciudad Real,50,495761,37401,458360,196329,17431
2020/04/30,Cuenca,Toledo,125,694844,72822,622022,196329,17431
2020/04/30,Cuenca,Cuenca,8424,196329,17020,179309,196329,17431
2020/04/30,Cuenca,Albacete,681,388167,31333,356834,196329,17431
2020/04/30,Cuenca,Guadalajara,21,257762,30656,227106,196329,17431
2020/04/30,Cuenca,Valencia,44,2565124,362691,2202433,196329,17431
2020/04/30,Cuenca,Madrid,76,6663394,815780,5847614,196329,17431
2020/04/30,Gipuzkoa,Araba,147,331549,46543,285006,723576,91898
2020/04/30,Gipuzkoa,Navarra,271,654183,85725,568458,723576,91898
2020/04/30,Gipuzkoa,Gipuzkoa,66142,723576,88614,634962,723576,91898
2020/04/30,Gipuzkoa,Bizkaia,1153,1152934,175729,977205,723576,91898
2020/04/30,Girona,Barcelona,1894,5664579,745885,4918694,771044,81508
2020/04/30,Girona,Murcia,18,1493898,183668,1310230,771044,81508
2020/04/30,Girona,Lleida,141,434930,53336,381594,771044,81508
2020/04/30,Girona,Girona,50023,771044,77835,693209,771044,81508
2020/04/30,Granada,Córdoba,229,782979,89844,693135,914678,100224
2020/04/30,Granada,Málaga,103,1661785,180249,1481536,914678,100224
2020/04/30,Granada,Granada,72754,914678,102597,812081,914678,100224
2020/04/30,Granada,Almería,411,716820,80556,636264,914678,100224
2020/04/30,Granada,Murcia,16,1493898,183668,1310230,914678,100224
2020/04/30,Granada,Jaén,336,633564,56341,577223,914678,100224
2020/04/30,Guadalajara,Guadalajara,17375,257762,30656,227106,257762,31512
2020/04/30,Guadalajara,Cuenca,39,196329,17020,179309,257762,31512
2020/04/30,Guadalajara,Madrid,1432,6663394,815780,5847614,257762,31512
2020/04/30,Huelva,Badajoz,297,673559,70835,602724,521870,63035
2020/04/30,Huelva,Sevilla,1463,1942389,238905,1703484,521870,63035
2020/04/30,Huelva,Huelva,45573,521870,59927,461943,521870,63035
2020/04/30,Huelva,Cádiz,480,1240155,137719,1102436,521870,63035
2020/04/30,Huesca,Lleida,870,434930,53336,381594,220461,26185
2020/04/30,Huesca,Zaragoza,186,964724,129560,835164,220461,26185
2020/04/30,Huesca,Huesca,15743,220461,23538,196923,220461,26185
2020/04/30,Jaén,Albacete,18,388167,31333,356834,633564,55150
2020/04/30,Jaén,Jaén,38052,633564,56341,577223,633564,55150
2020/04/30,Jaén,Córdoba,706,782979,89844,693135,633564,55150
2020/04/30,Jaén,Granada,257,914678,102597,812081,633564,55150
2020/04/30,Las Palmas de Gran Canaria,Las Palmas de Gran Canaria,114213,1120406,127380,993026,1120406,126560
2020/04/30,León,Asturias,36,1022800,117513,905287,460001,51947
2020/04/30,León,Ourense,200,307651,41433,266218,460001,51947
2020/04/30,León,León,37884,460001,52346,407655,460001,51947
2020/04/30,León,Zamora,101,172539,18340,154199,460001,51947
2020/04/30,León,Palencia,58,160866,18006,142860,460001,51947
2020/04/30,León,Valladolid,29,519546,64460,455086,460001,51947
2020/04/30,Lleida,Huesca,596,220461,23538,196923,434930,51134
2020/04/30,Lleida,Barcelona,242,5664579,745885,4918694,434930,51134
2020/04/30,Lleida,Lleida,33407,434930,53336,381594,434930,51134
2020/04/30,Lleida,Zaragoza,136,964724,129560,835164,434930,51134
2020/04/30,Lleida,Girona,141,771044,77835,693209,434930,51134
2020/04/30,Lugo,Coruña,572,1119596,146914,972682,329587,38065
2020/04/30,Lugo,Lugo,25540,329587,36871,292716,329587,38065
2020/04/30,Lugo,Asturias,600,1022800,117513,905287,329587,38065
2020/04/30,Lugo,Ourense,103,307651,41433,266218,329587,38065
2020/04/30,Madrid,Guadalajara,2034,257762,30656,227106,6663394,818804
2020/04/30,Madrid,Madrid,456900,6663394,815780,5847614,6663394,818804
2020/04/30,Madrid,Ávila,170,157640,13698,143942,6663394,818804
2020/04/30,Madrid,Toledo,3297,694844,72822,622022,6663394,818804
2020/04/30,Madrid,Valencia,30,2565124,362691,2202433,6663394,818804
2020/04/30,Madrid,Ciudad Real,32,495761,37401,458360,6663394,818804
2020/04/30,Madrid,Segovia,17,153129,16444,136685,6663394,818804
2020/04/30,Madrid,Cuenca,77,196329,17020,179309,6663394,818804
2020/04/30,Málaga,Melilla,23,86487,10967,75520,1661785,184040
2020/04/30,Málaga,Sevilla,354,1942389,238905,1703484,1661785,184040
2020/04/30,Málaga,Córdoba,480,782979,89844,693135,1661785,184040
2020/04/30,Málaga,Málaga,144160,1661785,180249,1481536,1661785,184040
2020/04/30,Málaga,Cádiz,988,1240155,137719,1102436,1661785,184040
2020/04/30,Málaga,Granada,181,914678,102597,812081,1661785,184040
2020/04/30,Melilla,Melilla,10697,86487,10967,75520,86487,10789
2020/04/30,Murcia,Albacete,454,388167,31333,356834,1493898,180751
2020/04/30,Murcia,Granada,27,914678,102597,812081,1493898,180751
2020/04/30,Murcia,Alicante,2440,1858683,229971,1628712,1493898,180751
2020/04/30,Murcia,Almería,1176,716820,80556,636264,1493898,180751
2020/04/30,Murcia,Murcia,136786,1493898,183668,1310230,1493898,180751
2020/04/30,Navarra,Navarra,59804,654183,85725,568458,654183,86817
2020/04/30,Navarra,Zaragoza,487,964724,129560,835164,654183,86817
2020/04/30,Navarra,Gipuzkoa,343,723576,88614,634962,654183,86817
2020/04/30,Navarra,Rioja,2269,316798,39954,276844,654183,86817
2020/04/30,Navarra,Araba,37,331549,46543,285006,654183,86817
2020/04/30,Ourense,León,114,460001,52346,407655,307651,41619
2020/04/30,Ourense,Zamora,51,172539,18340,154199,307651,41619
2020/04/30,Ourense,Pontevedra,147,942665,130900,811765,307651,41619
2020/04/30,Ourense,Ourense,31293,307651,41433,266218,307651,41619
2020/04/30,Ourense,Lugo,180,329587,36871,292716,307651,41619
2020/04/30,Palencia,Palencia,12705,160866,18006,142860,160866,19513
2020/04/30,Palencia,Valladolid,126,519546,64460,455086,160866,19513
2020/04/30,Palencia,Burgos,241,357072,36390,320682,160866,19513
2020/04/30,Palencia,Cantabria,166,580795,70506,510289,160866,19513
2020/04/30,Palencia,León,42,460001,52346,407655,160866,19513
2020/04/30,Pontevedra,Pontevedra,99229,942665,130900,811765,942665,130043
2020/04/30,Pontevedra,Coruña,3560,1119596,146914,972682,942665,130043
2020/04/30,Pontevedra,Ourense,152,307651,41433,266218,942665,130043
2020/04/30,Pontevedra,Lugo,27,329587,36871,292716,942665,130043
2020/04/30,Rioja,Rioja,27889,316798,39954,276844,316798,37397
2020/04/30,Rioja,Burgos,19,357072,36390,320682,316798,37397
2020/04/30,Rioja,Araba,732,331549,46543,285006,316798,37397
2020/04/30,Rioja,Navarra,1570,654183,85725,568458,316798,37397
2020/04/30,Salamanca,Zamora,54,172539,18340,154199,330119,36898
2020/04/30,Salamanca,Ávila,176,157640,13698,143942,330119,36898
2020/04/30,Salamanca,Salamanca,28573,330119,37485,292634,330119,36898
2020/04/30,Santa Cruz de Tenerife,Santa Cruz de Tenerife,102894,1032983,116862,916121,1032983,116268
2020/04/30,Segovia,Burgos,96,357072,36390,320682,153129,17638
2020/04/30,Segovia,Ávila,103,157640,13698,143942,153129,17638
2020/04/30,Segovia,Segovia,10664,153129,16444,136685,153129,17638
2020/04/30,Segovia,Valladolid,224,519546,64460,455086,153129,17638
2020/04/30,Segovia,Madrid,20,6663394,815780,5847614,153129,17638
2020/04/30,Sevilla,Badajoz,55,673559,70835,602724,1942389,233957
2020/04/30,Sevilla,Huelva,439,521870,59927,461943,1942389,233957
2020/04/30,Sevilla,Málaga,71,1661785,180249,1481536,1942389,233957
2020/04/30,Sevilla,Córdoba,1608,782979,89844,693135,1942389,233957
2020/04/30,Sevilla,Sevilla,162465,1942389,238905,1703484,1942389,233957
2020/04/30,Sevilla,Cádiz,549,1240155,137719,1102436,1942389,233957
2020/04/30,Soria,Guadalajara,17,257762,30656,227106,88636,7211
2020/04/30,Soria,Soria,4765,88636,6682,81954,88636,7211
2020/04/30,Soria,Valladolid,52,519546,64460,455086,88636,7211
2020/04/30,Soria,Burgos,27,357072,36390,320682,88636,7211
2020/04/30,Soria,Zaragoza,88,964724,129560,835164,88636,7211
2020/04/30,Tarragona,Zaragoza,39,964724,129560,835164,804664,87164
2020/04/30,Tarragona,Teruel,34,134137,9018,125119,804664,87164
2020/04/30,Tarragona,Castellón,658,579962,66130,513832,804664,87164
2020/04/30,Tarragona,Barcelona,867,5664579,745885,4918694,804664,87164
2020/04/30,Tarragona,Tarragona,56565,804664,87389,717275,804664,87164
2020/04/30,Teruel,Zaragoza,78,964724,129560,835164,134137,10195
2020/04/30,Teruel,Teruel,5005,134137,9018,125119,134137,10195
2020/04/30,Teruel,Tarragona,86,804664,87389,717275,134137,10195
2020/04/30,Teruel,Castellón,37,579962,66130,513832,134137,10195
2020/04/30,Toledo,Cáceres,137,394151,33855,360296,694844,70576
2020/04/30,Toledo,Ávila,120,157640,13698,143942,694844,70576
2020/04/30,Toledo,Madrid,3159,6663394,815780,5847614,694844,70576
2020/04/30,Toledo,Toledo,33742,694844,72822,622022,694844,70576
2020/04/30,Toledo,Cuenca,74,196329,17020,179309,694844,70576
2020/04/30,Toledo,Ciudad Real,231,495761,37401,458360,694844,70576
2020/04/30,Valencia,Valencia,243890,2565124,362691,2202433,2565124,353847
2020/04/30,Valencia,Albacete,340,388167,31333,356834,2565124,353847
2020/04/30,Valencia,Alicante,946,1858683,229971,1628712,2565124,353847
2020/04/30,Valencia,Cuenca,81,196329,17020,179309,2565124,353847
2020/04/30,Valencia,Madrid,30,6663394,815780,5847614,2565124,353847
2020/04/30,Valencia,Castellón,501,579962,66130,513832,2565124,353847
2020/04/30,Valladolid,Ávila,24,157640,13698,143942,519546,62005
2020/04/30,Valladolid,Soria,31,88636,6682,81954,519546,62005
2020/04/30,Valladolid,Burgos,95,357072,36390,320682,519546,62005
2020/04/30,Valladolid,Segovia,261,153129,16444,136685,519546,62005
2020/04/30,Valladolid,Zamora,164,172539,18340,154199,519546,62005
2020/04/30,Valladolid,Palencia,35,160866,18006,142860,519546,62005
2020/04/30,Valladolid,Valladolid,44320,519546,64460,455086,519546,62005
2020/04/30,Zamora,Zamora,12074,172539,18340,154199,172539,18157
2020/04/30,Zamora,Ourense,72,307651,41433,266218,172539,18157
2020/04/30,Zamora,León,27,460001,52346,407655,172539,18157
2020/04/30,Zamora,Valladolid,78,519546,64460,455086,172539,18157
2020/04/30,Zaragoza,Teruel,132,134137,9018,125119,964724,123906
2020/04/30,Zaragoza,Soria,76,88636,6682,81954,964724,123906
2020/04/30,Zaragoza,Lleida,81,434930,53336,381594,964724,123906
2020/04/30,Zaragoza,Navarra,380,654183,85725,568458,964724,123906
2020/04/30,Zaragoza,Zaragoza,95285,964724,129560,835164,964724,123906
2020/04/30,Zaragoza,Huesca,311,220461,23538,196923,964724,123906
2020/05/01,Albacete,Albacete,11607,388167,18730,369437,388167,18838
2020/05/01,Albacete,Murcia,245,1493898,111881,1382017,388167,18838
2020/05/01,Albacete,Valencia,291,2565124,213998,2351126,388167,18838
2020/05/01,Albacete,Jaén,43,633564,38845,594719,388167,18838
2020/05/01,Albacete,Ciudad Real,382,495761,23779,471982,388167,18838
2020/05/01,Albacete,Cuenca,322,196329,10569,185760,388167,18838
2020/05/01,Albacete,Alicante,97,1858683,141651,1717032,388167,18838
2020/05/01,Alicante,Alicante,113851,1858683,141651,1717032,1858683,142909
2020/05/01,Alicante,Albacete,158,388167,18730,369437,1858683,142909
2020/05/01,Alicante,Valencia,589,2565124,213998,2351126,1858683,142909
2020/05/01,Alicante,Murcia,1793,1493898,111881,1382017,1858683,142909
2020/05/01,Almería,Almería,37408,716820,47748,669072,716820,48298
2020/05/01,Almería,Murcia,952,1493898,111881,1382017,716820,48298
2020/05/01,Almería,Granada,240,914678,69490,845188,716820,48298
2020/05/01,Araba,Araba,21123,331549,26140,305409,331549,26913
2020/05/01,Araba,Bizkaia,327,1152934,104103,1048831,331549,26913
2020/05/01,Araba,Burgos,528,357072,19762,337310,331549,26913
2020/05/01,Araba,Rioja,726,316798,21994,294804,331549,26913
2020/05/01,Asturias,Cantabria,143,580795,43009,537786,1022800,69756
2020/05/01,Asturias,Asturias,52587,1022800,69483,953317,1022800,69756
2020/05/01,Asturias,Lugo,573,329587,21624,307963,1022800,69756
2020/05/01,Ávila,Toledo,191,694844,39832,655012,157640,9513
2020/05/01,Ávila,Ávila,6243,157640,9176,148464,157640,9513
2020/05/01,Ávila,Cáceres,136,394151,22831,371320,157640,9513
2020/05/01,Ávila,Madrid,76,6663394,506502,6156892,157640,9513
2020/05/01,Ávila,Segovia,85,153129,9977,143152,157640,9513
2020/05/01,Ávila,Salamanca,108,330119,23857,306262,157640,9513
2020/05/01,Badajoz,Huelva,203,521870,42006,479864,673559,47261
2020/05/01,Badajoz,Ciudad Real,45,495761,23779,471982,673559,47261
2020/05/01,Badajoz,Cáceres,859,394151,22831,371320,673559,47261
2020/05/01,Badajoz,Córdoba,82,782979,62949,720030,673559,47261
2020/05/01,Badajoz,Sevilla,72,1942389,157380,1785009,673559,47261
2020/05/01,Badajoz,Badajoz,35301,673559,47358,626201,673559,47261
2020/05/01,Balears,Balears,51256,1149460,64092,1085368,1149460,64252
2020/05/01,Barcelona,Girona,1225,771044,45390,725654,5664579,466111
2020/05/01,Barcelona,Lleida,64,434930,34147,400783,5664579,466111
2020/05/01,Barcelona,Barcelona,330139,5664579,464701,5199878,5664579,466111
2020/05/01,Barcelona,Tarragona,641,804664,55262,749402,5664579,466111
2020/05/01,Bizkaia,Gipuzkoa,341,723576,44867,678709,1152934,103543
2020/05/01,Bizkaia,Cantabria,389,580795,43009,537786,1152934,103543
2020/05/01,Bizkaia,Bizkaia,80766,1152934,104103,1048831,1152934,103543
2020/05/01,Bizkaia,Araba,343,331549,26140,305409,1152934,103543
2020/05/01,Burgos,Valladolid,55,519546,36442,483104,357072,19901
2020/05/01,Burgos,Araba,542,331549,26140,305409,357072,19901
2020/05/01,Burgos,Palencia,122,160866,10926,149940,357072,19901
2020/05/01,Burgos,Bizkaia,26,1152934,104103,1048831,357072,19901
2020/05/01,Burgos,Burgos,14271,357072,19762,337310,357072,19901
2020/05/01,Cáceres,Cáceres,14547,394151,22831,371320,394151,22440
2020/05/01,Cáceres,Toledo,103,694844,39832,655012,394151,22440
2020/05/01,Cáceres,Badajoz,735,673559,47358,626201,394151,22440
2020/05/01,Cáceres,Ávila,114,157640,9176,148464,394151,22440
2020/05/01,Cádiz,Sevilla,940,1942389,157380,1785009,1240155,98129
2020/05/01,Cádiz,Cádiz,81120,1240155,96235,1143920,1240155,98129
2020/05/01,Cádiz,Huelva,589,521870,42006,479864,1240155,98129
2020/05/01,Cádiz,Málaga,543,1661785,106795,1554990,1240155,98129
2020/05/01,Cantabria,Bizkaia,376,1152934,104103,1048831,580795,42877
2020/05/01,Cantabria,Palencia,37,160866,10926,149940,580795,42877
2020/05/01,Cantabria,Asturias,155,1022800,69483,953317,580795,42877
2020/05/01,Cantabria,Cantabria,31019,580795,43009,537786,580795,42877
2020/05/01,Castellón,Valencia,496,2565124,213998,2351126,579962,37967
2020/05/01,Castellón,Castellón,26692,579962,38082,541880,579962,37967
2020/05/01,Castellón,Tarragona,657,804664,55262,749402,579962,37967
2020/05/01,Ceuta,Ceuta,5884,84777,6220,78557,84777,6143
2020/05/01,Ciudad Real,Albacete,417,388167,18730,369437,495761,23438
2020/05/01,Ciudad Real,Ciudad Real,14760,495761,23779,471982,495761,23438
2020/05/01,Ciudad Real,Cuenca,29,196329,10569,185760,495761,23438
2020/05/01,Ciudad Real,Badajoz,57,673559,47358,626201,495761,23438
2020/05/01,Ciudad Real,Toledo,84,694844,39832,655012,495761,23438
2020/05/01,Ciudad Real,Córdoba,357,782979,62949,720030,495761,23438
2020/05/01,Córdoba,Sevilla,1071,1942389,157380,1785009,782979,62375
2020/05/01,Córdoba,Córdoba,46255,782979,62949,720030,782979,62375
2020/05/01,Córdoba,Jaén,579,633564,38845,594719,782979,62375
2020/05/01,Córdoba,Ciudad Real,219,495761,23779,471982,782979,62375
2020/05/01,Córdoba,Málaga,181,1661785,106795,1554990,782979,62375
2020/05/01,Córdoba,Granada,141,914678,69490,845188,782979,62375
2020/05/01,Coruña,Coruña,62580,1119596,82927,1036669,1119596,83680
2020/05/01,Coruña,Lugo,304,329587,21624,307963,1119596,83680
2020/05/01,Coruña,Pontevedra,2749,942665,71968,870697,1119596,83680
2020/05/01,Cuenca,Cuenca,5275,196329,10569,185760,196329,10334
2020/05/01,Cuenca,Madrid,27,6663394,506502,6156892,196329,10334
2020/05/01,Cuenca,Toledo,166,694844,39832,655012,196329,10334
2020/05/01,Cuenca,Albacete,477,388167,18730,369437,196329,10334
2020/05/01,Cuenca,Guadalajara,20,257762,16658,241104,196329,10334
2020/05/01,Cuenca,Ciudad Real,61,495761,23779,471982,196329,10334
2020/05/01,Cuenca,Valencia,46,2565124,213998,2351126,196329,10334
2020/05/01,Gipuzkoa,Bizkaia,344,1152934,104103,1048831,723576,45121
2020/05/01,Gipuzkoa,Navarra,79,654183,48212,605971,723576,45121
2020/05/01,Gipuzkoa,Gipuzkoa,33489,723576,44867,678709,723576,45121
2020/05/01,Girona,Girona,30455,771044,45390,725654,771044,46979
2020/05/01,Girona,Lleida,82,434930,34147,400783,771044,46979
2020/05/01,Girona,Barcelona,1413,5664579,464701,5199878,771044,46979
2020/05/01,Granada,Jaén,389,633564,38845,594719,914678,70138
2020/05/01,Granada,Almería,277,716820,47748,669072,914678,70138
2020/05/01,Granada,Málaga,130,1661785,106795,1554990,914678,70138
2020/05/01,Granada,Córdoba,293,782979,62949,720030,914678,70138
2020/05/01,Granada,Granada,51100,914678,69490,845188,914678,70138
2020/05/01,Guadalajara,Guadalajara,9972,257762,16658,241104,257762,16500
2020/05/01,Guadalajara,Cuenca,29,196329,10569,185760,257762,16500
2020/05/01,Guadalajara,Madrid,897,6663394,506502,6156892,257762,16500
2020/05/01,Huelva,Cádiz,425,1240155,96235,1143920,521870,43061
2020/05/01,Huelva,Huelva,31743,521870,42006,479864,521870,43061
2020/05/01,Huelva,Sevilla,1302,1942389,157380,1785009,521870,43061
2020/05/01,Huelva,Badajoz,287,673559,47358,626201,521870,43061
2020/05/01,Huesca,Zaragoza,94,964724,77136,887588,220461,14968
2020/05/01,Huesca,Lleida,576,434930,34147,400783,220461,14968
2020/05/01,Huesca,Huesca,9905,220461,14411,206050,220461,14968
2020/05/01,Jaén,Córdoba,504,782979,62949,720030,633564,38240
2020/05/01,Jaén,Jaén,27256,633564,38845,594719,633564,38240
2020/05/01,Jaén,Granada,279,914678,69490,845188,633564,38240
2020/05/01,Jaén,Albacete,17,388167,18730,369437,633564,38240
2020/05/01,Las Palmas de Gran Canaria,Las Palmas de Gran Canaria,62992,1120406,76953,1043453,1120406,76295
2020/05/01,León,León,23147,460001,32351,427650,460001,31934
2020/05/01,León,Asturias,33,1022800,69483,953317,460001,31934
2020/05/01,León,Zamora,33,172539,11381,161158,460001,31934
2020/05/01,León,Ourense,56,307651,25966,281685,460001,31934
2020/05/01,Lleida,Huesca,426,220461,14411,206050,434930,32856
2020/05/01,Lleida,Lleida,22255,434930,34147,400783,434930,32856
2020/05/01,Lleida,Zaragoza,39,964724,77136,887588,434930,32856
2020/05/01,Lleida,Barcelona,74,5664579,464701,5199878,434930,32856
2020/05/01,Lleida,Girona,109,771044,45390,725654,434930,32856
2020/05/01,Lleida,Tarragona,25,804664,55262,749402,434930,32856
2020/05/01,Lugo,Ourense,79,307651,25966,281685,329587,21956
2020/05/01,Lugo,Lugo,14973,329587,21624,307963,329587,21956
2020/05/01,Lugo,Asturias,373,1022800,69483,953317,329587,21956
2020/05/01,Lugo,Coruña,313,1119596,82927,1036669,329587,21956
2020/05/01,Madrid,Toledo,1625,694844,39832,655012,6663394,507381
2020/05/01,Madrid,Ávila,71,157640,9176,148464,6663394,507381
2020/05/01,Madrid,Guadalajara,967,257762,16658,241104,6663394,507381
2020/05/01,Madrid,Madrid,347716,6663394,506502,6156892,6663394,507381
2020/05/01,Madrid,Cuenca,63,196329,10569,185760,6663394,507381
2020/05/01,Madrid,Valencia,38,2565124,213998,2351126,6663394,507381
2020/05/01,Madrid,Melilla,26,86487,8718,77769,6663394,507381
2020/05/01,Málaga,Málaga,84761,1661785,106795,1554990,1661785,106871
2020/05/01,Málaga,Granada,99,914678,69490,845188,1661785,106871
2020/05/01,Málaga,Cádiz,525,1240155,96235,1143920,1661785,106871
2020/05/01,Málaga,Sevilla,186,1942389,157380,1785009,1661785,106871
2020/05/01,Málaga,Córdoba,199,782979,62949,720030,1661785,106871
2020/05/01,Melilla,Melilla,8458,86487,8718,77769,86487,8567
2020/05/01,Murcia,Albacete,333,388167,18730,369437,1493898,110993
2020/05/01,Murcia,Granada,18,914678,69490,845188,1493898,110993
2020/05/01,Murcia,Alicante,1626,1858683,141651,1717032,1493898,110993
2020/05/01,Murcia,Murcia,83906,1493898,111881,1382017,1493898,110993
2020/05/01,Murcia,Almería,684,716820,47748,669072,1493898,110993
2020/05/01,Navarra,Navarra,33250,654183,48212,605971,654183,47876
2020/05/01,Navarra,Gipuzkoa,98,723576,44867,678709,654183,47876
2020/05/01,Navarra,Rioja,1006,316798,21994,294804,654183,47876
2020/05/01,Navarra,Zaragoza,222,964724,77136,887588,654183,47876
2020/05/01,Ourense,Pontevedra,120,942665,71968,870697,307651,25956
2020/05/01,Ourense,Lugo,71,329587,21624,307963,307651,25956
2020/05/01,Ourense,León,77,460001,32351,427650,307651,25956
2020/05/01,Ourense,Ourense,20117,307651,25966,281685,307651,25956
2020/05/01,Palencia,Palencia,7535,160866,10926,149940,160866,11275
2020/05/01,Palencia,Cantabria,35,580795,43009,537786,160866,11275
2020/05/01,Palencia,Valladolid,27,519546,36442,483104,160866,11275
2020/05/01,Palencia,Burgos,111,357072,19762,337310,160866,11275
2020/05/01,Pontevedra,Pontevedra,55489,942665,71968,870697,942665,72522
2020/05/01,Pontevedra,Ourense,113,307651,25966,281685,942665,72522
2020/05/01,Pontevedra,Coruña,2793,1119596,82927,1036669,942665,72522
2020/05/01,Rioja,Rioja,15712,316798,21994,294804,316798,21400
2020/05/01,Rioja,Araba,401,331549,26140,305409,316798,21400
2020/05/01,Rioja,Navarra,1010,654183,48212,605971,316798,21400
2020/05/01,Salamanca,Ávila,135,157640,9176,148464,330119,23738
2020/05/01,Salamanca,Salamanca,18085,330119,23857,306262,330119,23738
2020/05/01,Santa Cruz de Tenerife,Santa Cruz de Tenerife,58428,1032983,70920,962063,1032983,70968
2020/05/01,Segovia,Ávila,73,157640,9176,148464,153129,10097
2020/05/01,Segovia,Valladolid,98,519546,36442,483104,153129,10097
2020/05/01,Segovia,Segovia,6468,153129,9977,143152,153129,10097
2020/05/01,Segovia,Burgos,48,357072,19762,337310,153129,10097
2020/05/01,Sevilla,Málaga,105,1661785,106795,1554990,1942389,156026
2020/05/01,Sevilla,Córdoba,1372,782979,62949,720030,1942389,156026
2020/05/01,Sevilla,Sevilla,112966,1942389,157380,1785009,1942389,156026
2020/05/01,Sevilla,Cádiz,738,1240155,96235,1143920,1942389,156026
2020/05/01,Sevilla,Badajoz,29,673559,47358,626201,1942389,156026
2020/05/01,Sevilla,Huelva,339,521870,42006,479864,1942389,156026
2020/05/01,Soria,Valladolid,22,519546,36442,483104,88636,3598
2020/05/01,Soria,Soria,2474,88636,3732,84904,88636,3598
2020/05/01,Tarragona,Castellón,352,579962,38082,541880,804664,54457
2020/05/01,Tarragona,Barcelona,524,5664579,464701,5199878,804664,54457
2020/05/01,Tarragona,Teruel,46,134137,4939,129198,804664,54457
2020/05/01,Tarragona,Zaragoza,40,964724,77136,887588,804664,54457
2020/05/01,Tarragona,Tarragona,36764,804664,55262,749402,804664,54457
2020/05/01,Teruel,Tarragona,47,804664,55262,749402,134137,4963
2020/05/01,Teruel,Castellón,31,579962,38082,541880,134137,4963
2020/05/01,Teruel,Teruel,2293,134137,4939,129198,134137,4963
2020/05/01,Teruel,Zaragoza,34,964724,77136,887588,134137,4963
2020/05/01,Toledo,Toledo,20918,694844,39832,655012,694844,39496
2020/05/01,Toledo,Ávila,128,157640,9176,148464,694844,39496
2020/05/01,Toledo,Madrid,1641,6663394,506502,6156892,694844,39496
2020/05/01,Toledo,Cáceres,131,394151,22831,371320,694844,39496
2020/05/01,Toledo,Ciudad Real,201,495761,23779,471982,694844,39496
2020/05/01,Valencia,Cuenca,78,196329,10569,185760,2565124,213421
2020/05/01,Valencia,Albacete,193,388167,18730,369437,2565124,213421
2020/05/01,Valencia,Valencia,157596,2565124,213998,2351126,2565124,213421
2020/05/01,Valencia,Alicante,466,1858683,141651,1717032,2565124,213421
2020/05/01,Valencia,Madrid,22,6663394,506502,6156892,2565124,213421
2020/05/01,Valencia,Castellón,399,579962,38082,541880,2565124,213421
2020/05/01,Valladolid,Palencia,20,160866,10926,149940,519546,35775
2020/05/01,Valladolid,Segovia,131,153129,9977,143152,519546,35775
2020/05/01,Valladolid,Zamora,79,172539,11381,161158,519546,35775
2020/05/01,Valladolid,Valladolid,24993,519546,36442,483104,519546,35775
2020/05/01,Valladolid,León,28,460001,32351,427650,519546,35775
2020/05/01,Valladolid,Burgos,38,357072,19762,337310,519546,35775
2020/05/01,Zamora,Salamanca,17,330119,23857,306262,172539,11161
2020/05/01,Zamora,Zamora,7705,172539,11381,161158,172539,11161
2020/05/01,Zamora,León,27,460001,32351,427650,172539,11161
2020/05/01,Zaragoza,Teruel,43,134137,4939,129198,964724,74855
2020/05/01,Zaragoza,Huesca,93,220461,14411,206050,964724,74855
2020/05/01,Zaragoza,Lleida,103,434930,34147,400783,964724,74855
2020/05/01,Zaragoza,Zaragoza,55341,964724,77136,887588,964724,74855
2020/05/01,Zaragoza,Navarra,185,654183,48212,605971,964724,74855
2020/05/02,Albacete,Albacete,13061,388167,19270,368897,388167,19606
2020/05/02,Albacete,Murcia,279,1493898,119977,1373921,388167,19606
2020/05/02,Albacete,Cuenca,339,196329,10653,185676,388167,19606
2020/05/02,Albacete,Ciudad Real,364,495761,24115,471646,388167,19606
2020/05/02,Albacete,Jaén,49,633564,40690,592874,388167,19606
2020/05/02,Albacete,Alicante,111,1858683,151481,1707202,388167,19606
2020/05/02,Albacete,Valencia,257,2565124,226941,2338183,388167,19606
2020/05/02,Alicante,Murcia,1977,1493898,119977,1373921,1858683,152270
2020/05/02,Alicante,Albacete,168,388167,19270,368897,1858683,152270
2020/05/02,Alicante,Alicante,122796,1858683,151481,1707202,1858683,152270
2020/05/02,Alicante,Valencia,490,2565124,226941,2338183,1858683,152270
2020/05/02,Almería,Almería,43395,716820,53232,663588,716820,53773
2020/05/02,Almería,Murcia,1130,1493898,119977,1373921,716820,53773
2020/05/02,Almería,Granada,348,914678,75496,839182,716820,53773
2020/05/02,Araba,Rioja,724,316798,23205,293593,331549,30276
2020/05/02,Araba,Bizkaia,379,1152934,113654,1039280,331549,30276
2020/05/02,Araba,Navarra,23,654183,49413,604770,331549,30276
2020/05/02,Araba,Gipuzkoa,46,723576,50031,673545,331549,30276
2020/05/02,Araba,Araba,24298,331549,29258,302291,331549,30276
2020/05/02,Araba,Burgos,663,357072,21342,335730,331549,30276
2020/05/02,Asturias,Lugo,515,329587,23807,305780,1022800,78810
2020/05/02,Asturias,Cantabria,127,580795,46841,533954,1022800,78810
2020/05/02,Asturias,Asturias,62567,1022800,78924,943876,1022800,78810
2020/05/02,Ávila,Ávila,6551,157640,9563,148077,157640,9874
2020/05/02,Ávila,Segovia,57,153129,10984,142145,157640,9874
2020/05/02,Ávila,Salamanca,168,330119,26104,304015,157640,9874
2020/05/02,Ávila,Madrid,105,6663394,509111,6154283,157640,9874
2020/05/02,Ávila,Cáceres,91,394151,25693,368458,157640,9874
2020/05/02,Ávila,Toledo,191,694844,41878,652966,157640,9874
2020/05/02,Badajoz,Cáceres,916,394151,25693,368458,673559,50015
2020/05/02,Badajoz,Sevilla,28,1942389,165120,1777269,673559,50015
2020/05/02,Badajoz,Huelva,201,521870,43285,478585,673559,50015
2020/05/02,Badajoz,Ciudad Real,108,495761,24115,471646,673559,50015
2020/05/02,Badajoz,Badajoz,38616,673559,50498,623061,673559,50015
2020/05/02,Badajoz,Córdoba,124,782979,66672,716307,673559,50015
2020/05/02,Balears,Balears,59795,1149460,73269,1076191,1149460,74040
2020/05/02,Barcelona,Tarragona,643,804664,57906,746758,5664579,509539
2020/05/02,Barcelona,Girona,1602,771044,48616,722428,5664579,509539
2020/05/02,Barcelona,Lleida,63,434930,35563,399367,5664579,509539
2020/05/02,Barcelona,Barcelona,361580,5664579,508747,5155832,5664579,509539
2020/05/02,Bizkaia,Gipuzkoa,306,723576,50031,673545,1152934,112862
2020/05/02,Bizkaia,Burgos,17,357072,21342,335730,1152934,112862
2020/05/02,Bizkaia,Araba,378,331549,29258,302291,1152934,112862
2020/05/02,Bizkaia,Cantabria,517,580795,46841,533954,1152934,112862
2020/05/02,Bizkaia,Bizkaia,89621,1152934,113654,1039280,1152934,112862
2020/05/02,Burgos,Palencia,125,160866,11815,149051,357072,21758
2020/05/02,Burgos,Bizkaia,53,1152934,113654,1039280,357072,21758
2020/05/02,Burgos,Burgos,16066,357072,21342,335730,357072,21758
2020/05/02,Burgos,Araba,560,331549,29258,302291,357072,21758
2020/05/02,Burgos,Valladolid,55,519546,40414,479132,357072,21758
2020/05/02,Burgos,Soria,26,88636,3945,84691,357072,21758
2020/05/02,Cáceres,Ávila,99,157640,9563,148077,394151,25569
2020/05/02,Cáceres,Cáceres,17967,394151,25693,368458,394151,25569
2020/05/02,Cáceres,Badajoz,759,673559,50498,623061,394151,25569
2020/05/02,Cáceres,Toledo,62,694844,41878,652966,394151,25569
2020/05/02,Cádiz,Huelva,621,521870,43285,478585,1240155,103764
2020/05/02,Cádiz,Cádiz,87691,1240155,102600,1137555,1240155,103764
2020/05/02,Cádiz,Málaga,635,1661785,119918,1541867,1240155,103764
2020/05/02,Cádiz,Sevilla,675,1942389,165120,1777269,1240155,103764
2020/05/02,Cantabria,Palencia,29,160866,11815,149051,580795,46652
2020/05/02,Cantabria,Bizkaia,322,1152934,113654,1039280,580795,46652
2020/05/02,Cantabria,Cantabria,35472,580795,46841,533954,580795,46652
2020/05/02,Cantabria,Asturias,142,1022800,78924,943876,580795,46652
2020/05/02,Castellón,Teruel,36,134137,4840,129297,579962,40085
2020/05/02,Castellón,Valencia,578,2565124,226941,2338183,579962,40085
2020/05/02,Castellón,Castellón,28954,579962,39335,540627,579962,40085
2020/05/02,Castellón,Tarragona,619,804664,57906,746758,579962,40085
2020/05/02,Ceuta,Ceuta,6529,84777,6932,77845,84777,6896
2020/05/02,Ciudad Real,Albacete,338,388167,19270,368897,495761,23535
2020/05/02,Ciudad Real,Cuenca,56,196329,10653,185676,495761,23535
2020/05/02,Ciudad Real,Córdoba,301,782979,66672,716307,495761,23535
2020/05/02,Ciudad Real,Badajoz,46,673559,50498,623061,495761,23535
2020/05/02,Ciudad Real,Ciudad Real,15317,495761,24115,471646,495761,23535
2020/05/02,Ciudad Real,Toledo,126,694844,41878,652966,495761,23535
2020/05/02,Ciudad Real,Jaén,17,633564,40690,592874,495761,23535
2020/05/02,Córdoba,Sevilla,1342,1942389,165120,1777269,782979,65715
2020/05/02,Córdoba,Jaén,554,633564,40690,592874,782979,65715
2020/05/02,Córdoba,Badajoz,117,673559,50498,623061,782979,65715
2020/05/02,Córdoba,Granada,154,914678,75496,839182,782979,65715
2020/05/02,Córdoba,Málaga,268,1661785,119918,1541867,782979,65715
2020/05/02,Córdoba,Ciudad Real,242,495761,24115,471646,782979,65715
2020/05/02,Córdoba,Córdoba,49180,782979,66672,716307,782979,65715
2020/05/02,Coruña,Pontevedra,3085,942665,81187,861478,1119596,95070
2020/05/02,Coruña,Lugo,348,329587,23807,305780,1119596,95070
2020/05/02,Coruña,Coruña,72617,1119596,94153,1025443,1119596,95070
2020/05/02,Cuenca,Albacete,609,388167,19270,368897,196329,10880
2020/05/02,Cuenca,Madrid,45,6663394,509111,6154283,196329,10880
2020/05/02,Cuenca,Ciudad Real,44,495761,24115,471646,196329,10880
2020/05/02,Cuenca,Toledo,118,694844,41878,652966,196329,10880
2020/05/02,Cuenca,Cuenca,5981,196329,10653,185676,196329,10880
2020/05/02,Cuenca,Valencia,44,2565124,226941,2338183,196329,10880
2020/05/02,Gipuzkoa,Bizkaia,432,1152934,113654,1039280,723576,50882
2020/05/02,Gipuzkoa,Navarra,124,654183,49413,604770,723576,50882
2020/05/02,Gipuzkoa,Gipuzkoa,38896,723576,50031,673545,723576,50882
2020/05/02,Girona,Barcelona,1413,5664579,508747,5155832,771044,49961
2020/05/02,Girona,Girona,33786,771044,48616,722428,771044,49961
2020/05/02,Girona,Lleida,87,434930,35563,399367,771044,49961
2020/05/02,Granada,Córdoba,245,782979,66672,716307,914678,75670
2020/05/02,Granada,Málaga,150,1661785,119918,1541867,914678,75670
2020/05/02,Granada,Granada,56797,914678,75496,839182,914678,75670
2020/05/02,Granada,Murcia,17,1493898,119977,1373921,914678,75670
2020/05/02,Granada,Almería,368,716820,53232,663588,914678,75670
2020/05/02,Granada,Jaén,390,633564,40690,592874,914678,75670
2020/05/02,Guadalajara,Madrid,838,6663394,509111,6154283,257762,17531
2020/05/02,Guadalajara,Guadalajara,11308,257762,17714,240048,257762,17531
2020/05/02,Guadalajara,Cuenca,26,196329,10653,185676,257762,17531
2020/05/02,Huelva,Badajoz,265,673559,50498,623061,521870,43814
2020/05/02,Huelva,Huelva,33256,521870,43285,478585,521870,43814
2020/05/02,Huelva,Sevilla,1045,1942389,165120,1777269,521870,43814
2020/05/02,Huelva,Cádiz,445,1240155,102600,1137555,521870,43814
2020/05/02,Huesca,Huesca,10421,220461,14404,206057,220461,15223
2020/05/02,Huesca,Zaragoza,119,964724,81199,883525,220461,15223
2020/05/02,Huesca,Lleida,587,434930,35563,399367,220461,15223
2020/05/02,Jaén,Córdoba,574,782979,66672,716307,633564,40105
2020/05/02,Jaén,Albacete,19,388167,19270,368897,633564,40105
2020/05/02,Jaén,Granada,345,914678,75496,839182,633564,40105
2020/05/02,Jaén,Jaén,29450,633564,40690,592874,633564,40105
2020/05/02,Las Palmas de Gran Canaria,Santa Cruz de Tenerife,35,1032983,77737,955246,1120406,83192
2020/05/02,Las Palmas de Gran Canaria,Las Palmas de Gran Canaria,70504,1120406,84151,1036255,1120406,83192
2020/05/02,León,Ourense,113,307651,29359,278292,460001,36100
2020/05/02,León,Zamora,81,172539,12261,160278,460001,36100
2020/05/02,León,León,27207,460001,36506,423495,460001,36100
2020/05/02,León,Asturias,31,1022800,78924,943876,460001,36100
2020/05/02,Lleida,Huesca,456,220461,14404,206057,434930,34945
2020/05/02,Lleida,Girona,118,771044,48616,722428,434930,34945
2020/05/02,Lleida,Lleida,24481,434930,35563,399367,434930,34945
2020/05/02,Lleida,Barcelona,117,5664579,508747,5155832,434930,34945
2020/05/02,Lleida,Tarragona,49,804664,57906,746758,434930,34945
2020/05/02,Lleida,Zaragoza,69,964724,81199,883525,434930,34945
2020/05/02,Lugo,Asturias,389,1022800,78924,943876,329587,24138
2020/05/02,Lugo,Coruña,310,1119596,94153,1025443,329587,24138
2020/05/02,Lugo,Ourense,88,307651,29359,278292,329587,24138
2020/05/02,Lugo,Lugo,17076,329587,23807,305780,329587,24138
2020/05/02,Madrid,Cuenca,44,196329,10653,185676,6663394,510741
2020/05/02,Madrid,Ávila,98,157640,9563,148077,6663394,510741
2020/05/02,Madrid,Madrid,350999,6663394,509111,6154283,6663394,510741
2020/05/02,Madrid,Guadalajara,935,257762,17714,240048,6663394,510741
2020/05/02,Madrid,Valencia,40,2565124,226941,2338183,6663394,510741
2020/05/02,Madrid,Toledo,1675,694844,41878,652966,6663394,510741
2020/05/02,Málaga,Córdoba,188,782979,66672,716307,1661785,119762
2020/05/02,Málaga,Granada,157,914678,75496,839182,1661785,119762
2020/05/02,Málaga,Sevilla,250,1942389,165120,1777269,1661785,119762
2020/05/02,Málaga,Málaga,98013,1661785,119918,1541867,1661785,119762
2020/05/02,Málaga,Cádiz,592,1240155,102600,1137555,1661785,119762
2020/05/02,Melilla,Melilla,9141,86487,9379,77108,86487,9301
2020/05/02,Murcia,Granada,36,914678,75496,839182,1493898,118628
2020/05/02,Murcia,Almería,806,716820,53232,663588,1493898,118628
2020/05/02,Murcia,Murcia,91490,1493898,119977,1373921,1493898,118628
2020/05/02,Murcia,Jaén,17,633564,40690,592874,1493898,118628
2020/05/02,Murcia,Alicante,1589,1858683,151481,1707202,1493898,118628
2020/05/02,Murcia,Albacete,300,388167,19270,368897,1493898,118628
2020/05/02,Navarra,Navarra,35239,654183,49413,604770,654183,49468
2020/05/02,Navarra,Rioja,819,316798,23205,293593,654183,49468
2020/05/02,Navarra,Zaragoza,268,964724,81199,883525,654183,49468
2020/05/02,Navarra,Gipuzkoa,86,723576,50031,673545,654183,49468
2020/05/02,Ourense,Ourense,23329,307651,29359,278292,307651,29494
2020/05/02,Ourense,León,75,460001,36506,423495,307651,29494
2020/05/02,Ourense,Pontevedra,149,942665,81187,861478,307651,29494
2020/05/02,Ourense,Lugo,191,329587,23807,305780,307651,29494
2020/05/02,Palencia,León,27,460001,36506,423495,160866,11994
2020/05/02,Palencia,Cantabria,36,580795,46841,533954,160866,11994
2020/05/02,Palencia,Valladolid,28,519546,40414,479132,160866,11994
2020/05/02,Palencia,Palencia,8643,160866,11815,149051,160866,11994
2020/05/02,Palencia,Burgos,155,357072,21342,335730,160866,11994
2020/05/02,Pontevedra,Coruña,2632,1119596,94153,1025443,942665,80603
2020/05/02,Pontevedra,Ourense,137,307651,29359,278292,942665,80603
2020/05/02,Pontevedra,Pontevedra,62954,942665,81187,861478,942665,80603
2020/05/02,Rioja,Araba,398,331549,29258,302291,316798,22763
2020/05/02,Rioja,Navarra,1039,654183,49413,604770,316798,22763
2020/05/02,Rioja,Rioja,17146,316798,23205,293593,316798,22763
2020/05/02,Salamanca,Salamanca,20396,330119,26104,304015,330119,26093
2020/05/02,Salamanca,Ávila,168,157640,9563,148077,330119,26093
2020/05/02,Santa Cruz de Tenerife,Las Palmas de Gran Canaria,25,1120406,84151,1036255,1032983,77509
2020/05/02,Santa Cruz de Tenerife,Santa Cruz de Tenerife,65090,1032983,77737,955246,1032983,77509
2020/05/02,Segovia,Valladolid,130,519546,40414,479132,153129,11322
2020/05/02,Segovia,Burgos,62,357072,21342,335730,153129,11322
2020/05/02,Segovia,Segovia,7778,153129,10984,142145,153129,11322
2020/05/02,Segovia,Ávila,78,157640,9563,148077,153129,11322
2020/05/02,Sevilla,Córdoba,1328,782979,66672,716307,1942389,163284
2020/05/02,Sevilla,Huelva,489,521870,43285,478585,1942389,163284
2020/05/02,Sevilla,Cádiz,623,1240155,102600,1137555,1942389,163284
2020/05/02,Sevilla,Badajoz,33,673559,50498,623061,1942389,163284
2020/05/02,Sevilla,Sevilla,119160,1942389,165120,1777269,1942389,163284
2020/05/02,Sevilla,Málaga,61,1661785,119918,1541867,1942389,163284
2020/05/02,Soria,Soria,2916,88636,3945,84691,88636,3969
2020/05/02,Tarragona,Castellón,391,579962,39335,540627,804664,56848
2020/05/02,Tarragona,Teruel,48,134137,4840,129297,804664,56848
2020/05/02,Tarragona,Barcelona,573,5664579,508747,5155832,804664,56848
2020/05/02,Tarragona,Zaragoza,32,964724,81199,883525,804664,56848
2020/05/02,Tarragona,Tarragona,39738,804664,57906,746758,804664,56848
2020/05/02,Teruel,Teruel,2834,134137,4840,129297,134137,5143
2020/05/02,Teruel,Castellón,32,579962,39335,540627,134137,5143
2020/05/02,Teruel,Tarragona,58,804664,57906,746758,134137,5143
2020/05/02,Toledo,Ciudad Real,115,495761,24115,471646,694844,41756
2020/05/02,Toledo,Cáceres,138,394151,25693,368458,694844,41756
2020/05/02,Toledo,Ávila,147,157640,9563,148077,694844,41756
2020/05/02,Toledo,Madrid,1720,6663394,509111,6154283,694844,41756
2020/05/02,Toledo,Toledo,23633,694844,41878,652966,694844,41756
2020/05/02,Valencia,Albacete,206,388167,19270,368897,2565124,225795
2020/05/02,Valencia,Castellón,373,579962,39335,540627,2565124,225795
2020/05/02,Valencia,Madrid,49,6663394,509111,6154283,2565124,225795
2020/05/02,Valencia,Alicante,586,1858683,151481,1707202,2565124,225795
2020/05/02,Valencia,Valencia,165342,2565124,226941,2338183,2565124,225795
2020/05/02,Valencia,Cuenca,68,196329,10653,185676,2565124,225795
2020/05/02,Valladolid,Segovia,143,153129,10984,142145,519546,39837
2020/05/02,Valladolid,Soria,33,88636,3945,84691,519546,39837
2020/05/02,Valladolid,Palencia,27,160866,11815,149051,519546,39837
2020/05/02,Valladolid,Burgos,50,357072,21342,335730,519546,39837
2020/05/02,Valladolid,Ávila,25,157640,9563,148077,519546,39837
2020/05/02,Valladolid,Valladolid,28158,519546,40414,479132,519546,39837
2020/05/02,Valladolid,Zamora,140,172539,12261,160278,519546,39837
2020/05/02,Zamora,León,32,460001,36506,423495,172539,12387
2020/05/02,Zamora,Salamanca,22,330119,26104,304015,172539,12387
2020/05/02,Zamora,Valladolid,111,519546,40414,479132,172539,12387
2020/05/02,Zamora,Zamora,9035,172539,12261,160278,172539,12387
2020/05/02,Zaragoza,Navarra,251,654183,49413,604770,964724,79933
2020/05/02,Zaragoza,Soria,24,88636,3945,84691,964724,79933
2020/05/02,Zaragoza,Zaragoza,60718,964724,81199,883525,964724,79933
2020/05/02,Zaragoza,Huesca,104,220461,14404,206057,964724,79933
2020/05/02,Zaragoza,Lleida,88,434930,35563,399367,964724,79933
2020/05/03,Albacete,Valencia,353,2565124,201137,2363987,388167,18980
2020/05/03,Albacete,Albacete,13281,388167,19258,368909,388167,18980
2020/05/03,Albacete,Ciudad Real,345,495761,20655,475106,388167,18980
2020/05/03,Albacete,Alicante,139,1858683,134597,1724086,388167,18980
2020/05/03,Albacete,Murcia,86,1493898,102574,1391324,388167,18980
2020/05/03,Albacete,Cuenca,267,196329,9010,187319,388167,18980
2020/05/03,Albacete,Jaén,38,633564,35861,597703,388167,18980
2020/05/03,Alicante,Valencia,562,2565124,201137,2363987,1858683,134230
2020/05/03,Alicante,Alicante,113166,1858683,134597,1724086,1858683,134230
2020/05/03,Alicante,Murcia,1464,1493898,102574,1391324,1858683,134230
2020/05/03,Alicante,Albacete,157,388167,19258,368909,1858683,134230
2020/05/03,Almería,Murcia,489,1493898,102574,1391324,716820,37345
2020/05/03,Almería,Almería,29499,716820,38318,678502,716820,37345
2020/05/03,Almería,Granada,268,914678,67001,847677,716820,37345
2020/05/03,Araba,Rioja,595,316798,21934,294864,331549,29761
2020/05/03,Araba,Araba,24395,331549,28832,302717,331549,29761
2020/05/03,Araba,Gipuzkoa,19,723576,48378,675198,331549,29761
2020/05/03,Araba,Bizkaia,396,1152934,114658,1038276,331549,29761
2020/05/03,Araba,Burgos,585,357072,20431,336641,331549,29761
2020/05/03,Asturias,Cantabria,149,580795,44628,536167,1022800,73511
2020/05/03,Asturias,Asturias,59849,1022800,73316,949484,1022800,73511
2020/05/03,Asturias,Lugo,552,329587,21666,307921,1022800,73511
2020/05/03,Asturias,León,29,460001,34205,425796,1022800,73511
2020/05/03,Ávila,Salamanca,210,330119,25399,304720,157640,9589
2020/05/03,Ávila,Ávila,6777,157640,9401,148239,157640,9589
2020/05/03,Ávila,Madrid,100,6663394,522146,6141248,157640,9589
2020/05/03,Ávila,Toledo,156,694844,37225,657619,157640,9589
2020/05/03,Ávila,Cáceres,79,394151,22777,371374,157640,9589
2020/05/03,Ávila,Segovia,54,153129,10040,143089,157640,9589
2020/05/03,Badajoz,Cáceres,717,394151,22777,371374,673559,44498
2020/05/03,Badajoz,Córdoba,122,782979,61257,721722,673559,44498
2020/05/03,Badajoz,Huelva,150,521870,37998,483872,673559,44498
2020/05/03,Badajoz,Ciudad Real,59,495761,20655,475106,673559,44498
2020/05/03,Badajoz,Badajoz,35144,673559,45354,628205,673559,44498
2020/05/03,Balears,Balears,52566,1149460,63688,1085772,1149460,63790
2020/05/03,Barcelona,Lleida,38,434930,31600,403330,5664579,490163
2020/05/03,Barcelona,Girona,1379,771044,43086,727958,5664579,490163
2020/05/03,Barcelona,Tarragona,576,804664,53057,751607,5664579,490163
2020/05/03,Barcelona,Barcelona,368526,5664579,488389,5176190,5664579,490163
2020/05/03,Bizkaia,Burgos,17,357072,20431,336641,1152934,114267
2020/05/03,Bizkaia,Gipuzkoa,380,723576,48378,675198,1152934,114267
2020/05/03,Bizkaia,Araba,365,331549,28832,302717,1152934,114267
2020/05/03,Bizkaia,Bizkaia,94884,1152934,114658,1038276,1152934,114267
2020/05/03,Bizkaia,Cantabria,486,580795,44628,536167,1152934,114267
2020/05/03,Burgos,Bizkaia,49,1152934,114658,1038276,357072,20919
2020/05/03,Burgos,Burgos,15581,357072,20431,336641,357072,20919
2020/05/03,Burgos,Valladolid,82,519546,39700,479846,357072,20919
2020/05/03,Burgos,Palencia,117,160866,11699,149167,357072,20919
2020/05/03,Burgos,Segovia,19,153129,10040,143089,357072,20919
2020/05/03,Burgos,Araba,490,331549,28832,302717,357072,20919
2020/05/03,Burgos,Cantabria,17,580795,44628,536167,357072,20919
2020/05/03,Cáceres,Badajoz,719,673559,45354,628205,394151,22461
2020/05/03,Cáceres,Toledo,102,694844,37225,657619,394151,22461
2020/05/03,Cáceres,Ávila,106,157640,9401,148239,394151,22461
2020/05/03,Cáceres,Cáceres,15839,394151,22777,371374,394151,22461
2020/05/03,Cádiz,Huelva,608,521870,37998,483872,1240155,94998
2020/05/03,Cádiz,Cádiz,81326,1240155,94330,1145825,1240155,94998
2020/05/03,Cádiz,Málaga,499,1661785,105062,1556723,1240155,94998
2020/05/03,Cádiz,Ceuta,34,84777,6585,78192,1240155,94998
2020/05/03,Cádiz,Sevilla,601,1942389,147492,1794897,1240155,94998
2020/05/03,Cantabria,Bizkaia,382,1152934,114658,1038276,580795,44299
2020/05/03,Cantabria,Palencia,35,160866,11699,149167,580795,44299
2020/05/03,Cantabria,Asturias,108,1022800,73316,949484,580795,44299
2020/05/03,Cantabria,Cantabria,35078,580795,44628,536167,580795,44299
2020/05/03,Castellón,Tarragona,551,804664,53057,751607,579962,35946
2020/05/03,Castellón,Teruel,30,134137,4055,130082,579962,35946
2020/05/03,Castellón,Valencia,547,2565124,201137,2363987,579962,35946
2020/05/03,Castellón,Castellón,26562,579962,35506,544456,579962,35946
2020/05/03,Ceuta,Ceuta,6157,84777,6585,78192,84777,6461
2020/05/03,Ciudad Real,Albacete,396,388167,19258,368909,495761,20983
2020/05/03,Ciudad Real,Toledo,87,694844,37225,657619,495761,20983
2020/05/03,Ciudad Real,Jaén,17,633564,35861,597703,495761,20983
2020/05/03,Ciudad Real,Ciudad Real,13690,495761,20655,475106,495761,20983
2020/05/03,Ciudad Real,Córdoba,336,782979,61257,721722,495761,20983
2020/05/03,Ciudad Real,Badajoz,141,673559,45354,628205,495761,20983
2020/05/03,Ciudad Real,Cuenca,313,196329,9010,187319,495761,20983
2020/05/03,Córdoba,Granada,114,914678,67001,847677,782979,60460
2020/05/03,Córdoba,Jaén,474,633564,35861,597703,782979,60460
2020/05/03,Córdoba,Córdoba,46553,782979,61257,721722,782979,60460
2020/05/03,Córdoba,Melilla,87,86487,8424,78063,782979,60460
2020/05/03,Córdoba,Ciudad Real,186,495761,20655,475106,782979,60460
2020/05/03,Córdoba,Sevilla,913,1942389,147492,1794897,782979,60460
2020/05/03,Córdoba,Badajoz,136,673559,45354,628205,782979,60460
2020/05/03,Córdoba,Málaga,134,1661785,105062,1556723,782979,60460
2020/05/03,Coruña,Coruña,67803,1119596,86695,1032901,1119596,87223
2020/05/03,Coruña,Lugo,358,329587,21666,307921,1119596,87223
2020/05/03,Coruña,Pontevedra,2978,942665,76804,865861,1119596,87223
2020/05/03,Cuenca,Ciudad Real,78,495761,20655,475106,196329,9161
2020/05/03,Cuenca,Guadalajara,47,257762,16086,241676,196329,9161
2020/05/03,Cuenca,Cuenca,4742,196329,9010,187319,196329,9161
2020/05/03,Cuenca,Valencia,38,2565124,201137,2363987,196329,9161
2020/05/03,Cuenca,Albacete,481,388167,19258,368909,196329,9161
2020/05/03,Cuenca,Toledo,59,694844,37225,657619,196329,9161
2020/05/03,Cuenca,Madrid,36,6663394,522146,6141248,196329,9161
2020/05/03,Gipuzkoa,Gipuzkoa,39229,723576,48378,675198,723576,49215
2020/05/03,Gipuzkoa,Araba,21,331549,28832,302717,723576,49215
2020/05/03,Gipuzkoa,Navarra,142,654183,46637,607546,723576,49215
2020/05/03,Gipuzkoa,Bizkaia,362,1152934,114658,1038276,723576,49215
2020/05/03,Gipuzkoa,Barcelona,17,5664579,488389,5176190,723576,49215
2020/05/03,Girona,Girona,30675,771044,43086,727958,771044,44732
2020/05/03,Girona,Barcelona,1215,5664579,488389,5176190,771044,44732
2020/05/03,Girona,Lleida,92,434930,31600,403330,771044,44732
2020/05/03,Granada,Murcia,28,1493898,102574,1391324,914678,66216
2020/05/03,Granada,Córdoba,252,782979,61257,721722,914678,66216
2020/05/03,Granada,Granada,50891,914678,67001,847677,914678,66216
2020/05/03,Granada,Málaga,108,1661785,105062,1556723,914678,66216
2020/05/03,Granada,Jaén,272,633564,35861,597703,914678,66216
2020/05/03,Granada,Almería,239,716820,38318,678502,914678,66216
2020/05/03,Guadalajara,Guadalajara,10566,257762,16086,241676,257762,15690
2020/05/03,Guadalajara,Madrid,867,6663394,522146,6141248,257762,15690
2020/05/03,Guadalajara,Cuenca,24,196329,9010,187319,257762,15690
2020/05/03,Huelva,Badajoz,242,673559,45354,628205,521870,37365
2020/05/03,Huelva,Cádiz,541,1240155,94330,1145825,521870,37365
2020/05/03,Huelva,Sevilla,392,1942389,147492,1794897,521870,37365
2020/05/03,Huelva,Huelva,28809,521870,37998,483872,521870,37365
2020/05/03,Huesca,Zaragoza,91,964724,80433,884291,220461,13587
2020/05/03,Huesca,Lleida,517,434930,31600,403330,220461,13587
2020/05/03,Huesca,Huesca,9683,220461,13202,207259,220461,13587
2020/05/03,Jaén,Albacete,16,388167,19258,368909,633564,35312
2020/05/03,Jaén,Jaén,26448,633564,35861,597703,633564,35312
2020/05/03,Jaén,Córdoba,476,782979,61257,721722,633564,35312
2020/05/03,Jaén,Granada,236,914678,67001,847677,633564,35312
2020/05/03,Las Palmas de Gran Canaria,Las Palmas de Gran Canaria,64491,1120406,76757,1043649,1120406,76091
2020/05/03,Las Palmas de Gran Canaria,Santa Cruz de Tenerife,27,1032983,68488,964495,1120406,76091
2020/05/03,León,León,26707,460001,34205,425796,460001,34188
2020/05/03,León,Ourense,82,307651,26383,281268,460001,34188
2020/05/03,León,Zamora,34,172539,11320,161219,460001,34188
2020/05/03,Lleida,Zaragoza,53,964724,80433,884291,434930,31053
2020/05/03,Lleida,Tarragona,24,804664,53057,751607,434930,31053
2020/05/03,Lleida,Huesca,322,220461,13202,207259,434930,31053
2020/05/03,Lleida,Girona,88,771044,43086,727958,434930,31053
2020/05/03,Lleida,Barcelona,48,5664579,488389,5176190,434930,31053
2020/05/03,Lleida,Lleida,22128,434930,31600,403330,434930,31053
2020/05/03,Lugo,Asturias,407,1022800,73316,949484,329587,21608
2020/05/03,Lugo,Coruña,357,1119596,86695,1032901,329587,21608
2020/05/03,Lugo,Ourense,58,307651,26383,281268,329587,21608
2020/05/03,Lugo,Lugo,15486,329587,21666,307921,329587,21608
2020/05/03,Madrid,Guadalajara,957,257762,16086,241676,6663394,525152
2020/05/03,Madrid,Valencia,49,2565124,201137,2363987,6663394,525152
2020/05/03,Madrid,Madrid,385044,6663394,522146,6141248,6663394,525152
2020/05/03,Madrid,Cuenca,39,196329,9010,187319,6663394,525152
2020/05/03,Madrid,Ávila,123,157640,9401,148239,6663394,525152
2020/05/03,Madrid,Toledo,1649,694844,37225,657619,6663394,525152
2020/05/03,Málaga,Cádiz,492,1240155,94330,1145825,1661785,104474
2020/05/03,Málaga,Córdoba,213,782979,61257,721722,1661785,104474
2020/05/03,Málaga,Granada,168,914678,67001,847677,1661785,104474
2020/05/03,Málaga,Málaga,86068,1661785,105062,1556723,1661785,104474
2020/05/03,Málaga,Sevilla,103,1942389,147492,1794897,1661785,104474
2020/05/03,Melilla,Melilla,8230,86487,8424,78063,86487,8378
2020/05/03,Murcia,Albacete,108,388167,19258,368909,1493898,101433
2020/05/03,Murcia,Almería,541,716820,38318,678502,1493898,101433
2020/05/03,Murcia,Alicante,1333,1858683,134597,1724086,1493898,101433
2020/05/03,Murcia,Granada,39,914678,67001,847677,1493898,101433
2020/05/03,Murcia,Murcia,80435,1493898,102574,1391324,1493898,101433
2020/05/03,Navarra,Gipuzkoa,128,723576,48378,675198,654183,47363
2020/05/03,Navarra,Rioja,848,316798,21934,294864,654183,47363
2020/05/03,Navarra,Araba,43,331549,28832,302717,654183,47363
2020/05/03,Navarra,Navarra,35187,654183,46637,607546,654183,47363
2020/05/03,Navarra,Zaragoza,262,964724,80433,884291,654183,47363
2020/05/03,Ourense,Ourense,21396,307651,26383,281268,307651,26285
2020/05/03,Ourense,Pontevedra,108,942665,76804,865861,307651,26285
2020/05/03,Ourense,Lugo,150,329587,21666,307921,307651,26285
2020/05/03,Palencia,Valladolid,38,519546,39700,479846,160866,11740
2020/05/03,Palencia,Burgos,142,357072,20431,336641,160866,11740
2020/05/03,Palencia,Palencia,8720,160866,11699,149167,160866,11740
2020/05/03,Palencia,Cantabria,17,580795,44628,536167,160866,11740
2020/05/03,Pontevedra,Ourense,117,307651,26383,281268,942665,76341
2020/05/03,Pontevedra,Coruña,2608,1119596,86695,1032901,942665,76341
2020/05/03,Pontevedra,Pontevedra,61141,942665,76804,865861,942665,76341
2020/05/03,Rioja,Navarra,802,654183,46637,607546,316798,21587
2020/05/03,Rioja,Araba,330,331549,28832,302717,316798,21587
2020/05/03,Rioja,Rioja,16788,316798,21934,294864,316798,21587
2020/05/03,Salamanca,Zamora,30,172539,11320,161219,330119,25390
2020/05/03,Salamanca,Ávila,106,157640,9401,148239,330119,25390
2020/05/03,Salamanca,Cáceres,16,394151,22777,371374,330119,25390
2020/05/03,Salamanca,Salamanca,20340,330119,25399,304720,330119,25390
2020/05/03,Santa Cruz de Tenerife,Las Palmas de Gran Canaria,17,1120406,76757,1043649,1032983,68501
2020/05/03,Santa Cruz de Tenerife,Santa Cruz de Tenerife,57721,1032983,68488,964495,1032983,68501
2020/05/03,Segovia,Ávila,66,157640,9401,148239,153129,9998
2020/05/03,Segovia,Valladolid,108,519546,39700,479846,153129,9998
2020/05/03,Segovia,Burgos,16,357072,20431,336641,153129,9998
2020/05/03,Segovia,Segovia,7095,153129,10040,143089,153129,9998
2020/05/03,Sevilla,Córdoba,1205,782979,61257,721722,1942389,146857
2020/05/03,Sevilla,Cádiz,630,1240155,94330,1145825,1942389,146857
2020/05/03,Sevilla,Sevilla,112487,1942389,147492,1794897,1942389,146857
2020/05/03,Sevilla,Málaga,38,1661785,105062,1556723,1942389,146857
2020/05/03,Sevilla,Huelva,346,521870,37998,483872,1942389,146857
2020/05/03,Sevilla,Badajoz,27,673559,45354,628205,1942389,146857
2020/05/03,Soria,Valladolid,34,519546,39700,479846,88636,4015
2020/05/03,Soria,Soria,2987,88636,3873,84763,88636,4015
2020/05/03,Tarragona,Tarragona,38132,804664,53057,751607,804664,52987
2020/05/03,Tarragona,Teruel,76,134137,4055,130082,804664,52987
2020/05/03,Tarragona,Barcelona,616,5664579,488389,5176190,804664,52987
2020/05/03,Tarragona,Castellón,334,579962,35506,544456,804664,52987
2020/05/03,Teruel,Tarragona,46,804664,53057,751607,134137,4279
2020/05/03,Teruel,Castellón,33,579962,35506,544456,134137,4279
2020/05/03,Teruel,Teruel,2178,134137,4055,130082,134137,4279
2020/05/03,Teruel,Zaragoza,54,964724,80433,884291,134137,4279
2020/05/03,Toledo,Ávila,166,157640,9401,148239,694844,37069
2020/05/03,Toledo,Madrid,1617,6663394,522146,6141248,694844,37069
2020/05/03,Toledo,Ciudad Real,70,495761,20655,475106,694844,37069
2020/05/03,Toledo,Toledo,21835,694844,37225,657619,694844,37069
2020/05/03,Toledo,Cáceres,144,394151,22777,371374,694844,37069
2020/05/03,Valencia,Alicante,497,1858683,134597,1724086,2565124,200467
2020/05/03,Valencia,Albacete,240,388167,19258,368909,2565124,200467
2020/05/03,Valencia,Valencia,155612,2565124,201137,2363987,2565124,200467
2020/05/03,Valencia,Madrid,62,6663394,522146,6141248,2565124,200467
2020/05/03,Valencia,Castellón,484,579962,35506,544456,2565124,200467
2020/05/03,Valencia,Cuenca,59,196329,9010,187319,2565124,200467
2020/05/03,Valladolid,Soria,30,88636,3873,84763,519546,39661
2020/05/03,Valladolid,Zamora,97,172539,11320,161219,519546,39661
2020/05/03,Valladolid,Valladolid,29873,519546,39700,479846,519546,39661
2020/05/03,Valladolid,León,37,460001,34205,425796,519546,39661
2020/05/03,Valladolid,Segovia,175,153129,10040,143089,519546,39661
2020/05/03,Valladolid,Burgos,84,357072,20431,336641,519546,39661
2020/05/03,Valladolid,Ávila,26,157640,9401,148239,519546,39661
2020/05/03,Zamora,Valladolid,112,519546,39700,479846,172539,11529
2020/05/03,Zamora,León,24,460001,34205,425796,172539,11529
2020/05/03,Zamora,Zamora,8546,172539,11320,161219,172539,11529
2020/05/03,Zaragoza,Navarra,250,654183,46637,607546,964724,79811
2020/05/03,Zaragoza,Lleida,68,434930,31600,403330,964724,79811
2020/05/03,Zaragoza,Huesca,114,220461,13202,207259,964724,79811
2020/05/03,Zaragoza,Zaragoza,63208,964724,80433,884291,964724,79811
2020/05/03,Zaragoza,Soria,21,88636,3873,84763,964724,79811
2020/05/04,Albacete,Valencia,421,2565124,386193,2178931,388167,33981
2020/05/04,Albacete,Murcia,400,1493898,194657,1299241,388167,33981
2020/05/04,Albacete,Ciudad Real,523,495761,42292,453469,388167,33981
2020/05/04,Albacete,Alicante,222,1858683,240865,1617818,388167,33981
2020/05/04,Albacete,Cuenca,466,196329,18376,177953,388167,33981
2020/05/04,Albacete,Albacete,20801,388167,34031,354136,388167,33981
2020/05/04,Albacete,Jaén,55,633564,59367,574197,388167,33981
2020/05/04,Alicante,Murcia,2807,1493898,194657,1299241,1858683,244047
2020/05/04,Alicante,Alicante,186252,1858683,240865,1617818,1858683,244047
2020/05/04,Alicante,Valencia,1166,2565124,386193,2178931,1858683,244047
2020/05/04,Alicante,Albacete,325,388167,34031,354136,1858683,244047
2020/05/04,Almería,Granada,499,914678,109231,805447,716820,84457
2020/05/04,Almería,Almería,67074,716820,82065,634755,716820,84457
2020/05/04,Almería,Murcia,1775,1493898,194657,1299241,716820,84457
2020/05/04,Araba,Araba,43582,331549,53035,278514,331549,59930
2020/05/04,Araba,Bizkaia,1022,1152934,195147,957787,331549,59930
2020/05/04,Araba,Rioja,2089,316798,44041,272757,331549,59930
2020/05/04,Araba,Navarra,130,654183,92281,561902,331549,59930
2020/05/04,Araba,Burgos,1677,357072,41639,315433,331549,59930
2020/05/04,Araba,Gipuzkoa,164,723576,96562,627014,331549,59930
2020/05/04,Asturias,Lugo,940,329587,39980,289607,1022800,132607
2020/05/04,Asturias,Asturias,105559,1022800,134301,888499,1022800,132607
2020/05/04,Asturias,Cantabria,180,580795,79637,501158,1022800,132607
2020/05/04,Asturias,León,34,460001,61482,398519,1022800,132607
2020/05/04,Ávila,Madrid,131,6663394,882968,5780426,157640,16380
2020/05/04,Ávila,Toledo,272,694844,79828,615016,157640,16380
2020/05/04,Ávila,Ávila,10181,157640,15939,141701,157640,16380
2020/05/04,Ávila,Segovia,88,153129,18532,134597,157640,16380
2020/05/04,Ávila,Cáceres,131,394151,39817,354334,157640,16380
2020/05/04,Ávila,Salamanca,268,330119,43468,286651,157640,16380
2020/05/04,Badajoz,Córdoba,73,782979,97924,685055,673559,75771
2020/05/04,Badajoz,Huelva,221,521870,65261,456609,673559,75771
2020/05/04,Badajoz,Badajoz,55610,673559,77013,596546,673559,75771
2020/05/04,Badajoz,Sevilla,73,1942389,262255,1680134,673559,75771
2020/05/04,Badajoz,Cáceres,1123,394151,39817,354334,673559,75771
2020/05/04,Badajoz,Ciudad Real,55,495761,42292,453469,673559,75771
2020/05/04,Balears,Valencia,30,2565124,386193,2178931,1149460,134805
2020/05/04,Balears,Balears,114929,1149460,132767,1016693,1149460,134805
2020/05/04,Barcelona,Tarragona,1393,804664,94077,710587,5664579,827255
2020/05/04,Barcelona,Barcelona,516535,5664579,826309,4838270,5664579,827255
2020/05/04,Barcelona,Girona,2350,771044,83921,687123,5664579,827255
2020/05/04,Barcelona,Lleida,170,434930,57709,377221,5664579,827255
2020/05/04,Bizkaia,Cantabria,2130,580795,79637,501158,1152934,191368
2020/05/04,Bizkaia,Bizkaia,146550,1152934,195147,957787,1152934,191368
2020/05/04,Bizkaia,Gipuzkoa,881,723576,96562,627014,1152934,191368
2020/05/04,Bizkaia,Araba,701,331549,53035,278514,1152934,191368
2020/05/04,Bizkaia,Burgos,59,357072,41639,315433,1152934,191368
2020/05/04,Burgos,Valladolid,72,519546,75113,444433,357072,43458
2020/05/04,Burgos,Soria,29,88636,7322,81314,357072,43458
2020/05/04,Burgos,Palencia,199,160866,21120,139746,357072,43458
2020/05/04,Burgos,Burgos,31017,357072,41639,315433,357072,43458
2020/05/04,Burgos,Bizkaia,83,1152934,195147,957787,357072,43458
2020/05/04,Burgos,Araba,806,331549,53035,278514,357072,43458
2020/05/04,Burgos,Segovia,38,153129,18532,134597,357072,43458
2020/05/04,Burgos,Rioja,60,316798,44041,272757,357072,43458
2020/05/04,Cáceres,Toledo,204,694844,79828,615016,394151,39830
2020/05/04,Cáceres,Badajoz,1092,673559,77013,596546,394151,39830
2020/05/04,Cáceres,Ávila,157,157640,15939,141701,394151,39830
2020/05/04,Cáceres,Cáceres,26669,394151,39817,354334,394151,39830
2020/05/04,Cádiz,Sevilla,961,1942389,262255,1680134,1240155,153715
2020/05/04,Cádiz,Málaga,1134,1661785,196174,1465611,1240155,153715
2020/05/04,Cádiz,Cádiz,124800,1240155,152388,1087767,1240155,153715
2020/05/04,Cádiz,Huelva,681,521870,65261,456609,1240155,153715
2020/05/04,Cantabria,Burgos,19,357072,41639,315433,580795,75527
2020/05/04,Cantabria,Asturias,211,1022800,134301,888499,580795,75527
2020/05/04,Cantabria,Bizkaia,588,1152934,195147,957787,580795,75527
2020/05/04,Cantabria,Palencia,32,160866,21120,139746,580795,75527
2020/05/04,Cantabria,Cantabria,56135,580795,79637,501158,580795,75527
2020/05/04,Castellón,Castellón,53353,579962,71617,508345,579962,75314
2020/05/04,Castellón,Teruel,102,134137,9504,124633,579962,75314
2020/05/04,Castellón,Tarragona,714,804664,94077,710587,579962,75314
2020/05/04,Castellón,Valencia,703,2565124,386193,2178931,579962,75314
2020/05/04,Ceuta,Cádiz,67,1240155,152388,1087767,84777,9900
2020/05/04,Ceuta,Ceuta,9373,84777,9857,74920,84777,9900
2020/05/04,Ciudad Real,Córdoba,403,782979,97924,685055,495761,38342
2020/05/04,Ciudad Real,Albacete,428,388167,34031,354136,495761,38342
2020/05/04,Ciudad Real,Toledo,174,694844,79828,615016,495761,38342
2020/05/04,Ciudad Real,Ciudad Real,24369,495761,42292,453469,495761,38342
2020/05/04,Ciudad Real,Cuenca,23,196329,18376,177953,495761,38342
2020/05/04,Ciudad Real,Badajoz,66,673559,77013,596546,495761,38342
2020/05/04,Córdoba,Granada,99,914678,109231,805447,782979,93879
2020/05/04,Córdoba,Córdoba,67660,782979,97924,685055,782979,93879
2020/05/04,Córdoba,Ciudad Real,289,495761,42292,453469,782979,93879
2020/05/04,Córdoba,Badajoz,115,673559,77013,596546,782979,93879
2020/05/04,Córdoba,Málaga,303,1661785,196174,1465611,782979,93879
2020/05/04,Córdoba,Jaén,666,633564,59367,574197,782979,93879
2020/05/04,Córdoba,Sevilla,1546,1942389,262255,1680134,782979,93879
2020/05/04,Coruña,Pontevedra,4861,942665,140020,802645,1119596,159478
2020/05/04,Coruña,Coruña,119760,1119596,160500,959096,1119596,159478
2020/05/04,Coruña,Lugo,606,329587,39980,289607,1119596,159478
2020/05/04,Cuenca,Valencia,86,2565124,386193,2178931,196329,19621
2020/05/04,Cuenca,Albacete,598,388167,34031,354136,196329,19621
2020/05/04,Cuenca,Guadalajara,67,257762,32625,225137,196329,19621
2020/05/04,Cuenca,Toledo,184,694844,79828,615016,196329,19621
2020/05/04,Cuenca,Madrid,66,6663394,882968,5780426,196329,19621
2020/05/04,Cuenca,Cuenca,9575,196329,18376,177953,196329,19621
2020/05/04,Cuenca,Ciudad Real,84,495761,42292,453469,196329,19621
2020/05/04,Gipuzkoa,Gipuzkoa,73330,723576,96562,627014,723576,101512
2020/05/04,Gipuzkoa,Araba,191,331549,53035,278514,723576,101512
2020/05/04,Gipuzkoa,Navarra,365,654183,92281,561902,723576,101512
2020/05/04,Gipuzkoa,Bizkaia,1257,1152934,195147,957787,723576,101512
2020/05/04,Girona,Girona,55020,771044,83921,687123,771044,87487
2020/05/04,Girona,Lleida,146,434930,57709,377221,771044,87487
2020/05/04,Girona,Barcelona,2106,5664579,826309,4838270,771044,87487
2020/05/04,Granada,Málaga,103,1661785,196174,1465611,914678,105485
2020/05/04,Granada,Almería,407,716820,82065,634755,914678,105485
2020/05/04,Granada,Córdoba,225,782979,97924,685055,914678,105485
2020/05/04,Granada,Granada,77444,914678,109231,805447,914678,105485
2020/05/04,Granada,Jaén,362,633564,59367,574197,914678,105485
2020/05/04,Guadalajara,Guadalajara,18881,257762,32625,225137,257762,34747
2020/05/04,Guadalajara,Cuenca,31,196329,18376,177953,257762,34747
2020/05/04,Guadalajara,Madrid,2163,6663394,882968,5780426,257762,34747
2020/05/04,Huelva,Badajoz,320,673559,77013,596546,521870,68852
2020/05/04,Huelva,Sevilla,1556,1942389,262255,1680134,521870,68852
2020/05/04,Huelva,Huelva,50003,521870,65261,456609,521870,68852
2020/05/04,Huelva,Cádiz,514,1240155,152388,1087767,521870,68852
2020/05/04,Huesca,Huesca,17183,220461,25336,195125,220461,28538
2020/05/04,Huesca,Lleida,940,434930,57709,377221,220461,28538
2020/05/04,Huesca,Zaragoza,272,964724,144869,819855,220461,28538
2020/05/04,Jaén,Albacete,41,388167,34031,354136,633564,56398
2020/05/04,Jaén,Córdoba,731,782979,97924,685055,633564,56398
2020/05/04,Jaén,Jaén,39232,633564,59367,574197,633564,56398
2020/05/04,Jaén,Granada,277,914678,109231,805447,633564,56398
2020/05/04,Las Palmas de Gran Canaria,Las Palmas de Gran Canaria,131650,1120406,143777,976629,1120406,143802
2020/05/04,Las Palmas de Gran Canaria,Santa Cruz de Tenerife,19,1032983,129358,903625,1120406,143802
2020/05/04,León,Asturias,40,1022800,134301,888499,460001,61380
2020/05/04,León,Palencia,56,160866,21120,139746,460001,61380
2020/05/04,León,León,45736,460001,61482,398519,460001,61380
2020/05/04,León,Valladolid,35,519546,75113,444433,460001,61380
2020/05/04,León,Zamora,163,172539,20165,152374,460001,61380
2020/05/04,León,Ourense,294,307651,45743,261908,460001,61380
2020/05/04,Lleida,Lleida,37083,434930,57709,377221,434930,55594
2020/05/04,Lleida,Zaragoza,177,964724,144869,819855,434930,55594
2020/05/04,Lleida,Girona,170,771044,83921,687123,434930,55594
2020/05/04,Lleida,Tarragona,41,804664,94077,710587,434930,55594
2020/05/04,Lleida,Barcelona,254,5664579,826309,4838270,434930,55594
2020/05/04,Lleida,Huesca,737,220461,25336,195125,434930,55594
2020/05/04,Lugo,Ourense,121,307651,45743,261908,329587,40563
2020/05/04,Lugo,Asturias,740,1022800,134301,888499,329587,40563
2020/05/04,Lugo,Coruña,573,1119596,160500,959096,329587,40563
2020/05/04,Lugo,Lugo,27654,329587,39980,289607,329587,40563
2020/05/04,Madrid,Segovia,18,153129,18532,134597,6663394,889047
2020/05/04,Madrid,Ciudad Real,31,495761,42292,453469,6663394,889047
2020/05/04,Madrid,Cuenca,61,196329,18376,177953,6663394,889047
2020/05/04,Madrid,Toledo,3475,694844,79828,615016,6663394,889047
2020/05/04,Madrid,Madrid,508251,6663394,882968,5780426,6663394,889047
2020/05/04,Madrid,Guadalajara,2369,257762,32625,225137,6663394,889047
2020/05/04,Madrid,Ávila,249,157640,15939,141701,6663394,889047
2020/05/04,Málaga,Granada,213,914678,109231,805447,1661785,203342
2020/05/04,Málaga,Cádiz,983,1240155,152388,1087767,1661785,203342
2020/05/04,Málaga,Sevilla,357,1942389,262255,1680134,1661785,203342
2020/05/04,Málaga,Málaga,158748,1661785,196174,1465611,1661785,203342
2020/05/04,Málaga,Córdoba,297,782979,97924,685055,1661785,203342
2020/05/04,Melilla,Melilla,11485,86487,11591,74896,86487,11715
2020/05/04,Murcia,Albacete,478,388167,34031,354136,1493898,191281
2020/05/04,Murcia,Alicante,2363,1858683,240865,1617818,1493898,191281
2020/05/04,Murcia,Murcia,147151,1493898,194657,1299241,1493898,191281
2020/05/04,Murcia,Granada,54,914678,109231,805447,1493898,191281
2020/05/04,Murcia,Almería,1238,716820,82065,634755,1493898,191281
2020/05/04,Navarra,Navarra,65859,654183,92281,561902,654183,94673
2020/05/04,Navarra,Zaragoza,535,964724,144869,819855,654183,94673
2020/05/04,Navarra,Rioja,2411,316798,44041,272757,654183,94673
2020/05/04,Navarra,Gipuzkoa,319,723576,96562,627014,654183,94673
2020/05/04,Navarra,Araba,23,331549,53035,278514,654183,94673
2020/05/04,Ourense,Pontevedra,166,942665,140020,802645,307651,45940
2020/05/04,Ourense,León,256,460001,61482,398519,307651,45940
2020/05/04,Ourense,Zamora,40,172539,20165,152374,307651,45940
2020/05/04,Ourense,Lugo,236,329587,39980,289607,307651,45940
2020/05/04,Ourense,Ourense,34639,307651,45743,261908,307651,45940
2020/05/04,Palencia,Burgos,199,357072,41639,315433,160866,22748
2020/05/04,Palencia,Palencia,15407,160866,21120,139746,160866,22748
2020/05/04,Palencia,Valladolid,143,519546,75113,444433,160866,22748
2020/05/04,Palencia,Cantabria,157,580795,79637,501158,160866,22748
2020/05/04,Palencia,León,27,460001,61482,398519,160866,22748
2020/05/04,Pontevedra,Pontevedra,106265,942665,140020,802645,942665,137215
2020/05/04,Pontevedra,Ourense,195,307651,45743,261908,942665,137215
2020/05/04,Pontevedra,Coruña,3753,1119596,160500,959096,942665,137215
2020/05/04,Rioja,Araba,693,331549,53035,278514,316798,41911
2020/05/04,Rioja,Rioja,31311,316798,44041,272757,316798,41911
2020/05/04,Rioja,Burgos,48,357072,41639,315433,316798,41911
2020/05/04,Rioja,Navarra,1836,654183,92281,561902,316798,41911
2020/05/04,Salamanca,Salamanca,34043,330119,43468,286651,330119,43229
2020/05/04,Salamanca,Ávila,223,157640,15939,141701,330119,43229
2020/05/04,Salamanca,Zamora,63,172539,20165,152374,330119,43229
2020/05/04,Santa Cruz de Tenerife,Santa Cruz de Tenerife,115147,1032983,129358,903625,1032983,129915
2020/05/04,Santa Cruz de Tenerife,Las Palmas de Gran Canaria,24,1120406,143777,976629,1032983,129915
2020/05/04,Segovia,Burgos,110,357072,41639,315433,153129,20083
2020/05/04,Segovia,Ávila,124,157640,15939,141701,153129,20083
2020/05/04,Segovia,Valladolid,249,519546,75113,444433,153129,20083
2020/05/04,Segovia,Soria,25,88636,7322,81314,153129,20083
2020/05/04,Segovia,Segovia,12267,153129,18532,134597,153129,20083
2020/05/04,Sevilla,Sevilla,180609,1942389,262255,1680134,1942389,254558
2020/05/04,Sevilla,Huelva,371,521870,65261,456609,1942389,254558
2020/05/04,Sevilla,Málaga,152,1661785,196174,1465611,1942389,254558
2020/05/04,Sevilla,Cádiz,720,1240155,152388,1087767,1942389,254558
2020/05/04,Sevilla,Córdoba,1863,782979,97924,685055,1942389,254558
2020/05/04,Sevilla,Badajoz,51,673559,77013,596546,1942389,254558
2020/05/04,Soria,Segovia,20,153129,18532,134597,88636,8712
2020/05/04,Soria,Burgos,56,357072,41639,315433,88636,8712
2020/05/04,Soria,Zaragoza,146,964724,144869,819855,88636,8712
2020/05/04,Soria,Soria,5497,88636,7322,81314,88636,8712
2020/05/04,Soria,Valladolid,35,519546,75113,444433,88636,8712
2020/05/04,Tarragona,Teruel,60,134137,9504,124633,804664,93695
2020/05/04,Tarragona,Tarragona,61470,804664,94077,710587,804664,93695
2020/05/04,Tarragona,Castellón,728,579962,71617,508345,804664,93695
2020/05/04,Tarragona,Barcelona,835,5664579,826309,4838270,804664,93695
2020/05/04,Tarragona,Zaragoza,41,964724,144869,819855,804664,93695
2020/05/04,Teruel,Teruel,5537,134137,9504,124633,134137,11328
2020/05/04,Teruel,Castellón,68,579962,71617,508345,134137,11328
2020/05/04,Teruel,Zaragoza,156,964724,144869,819855,134137,11328
2020/05/04,Teruel,Tarragona,103,804664,94077,710587,134137,11328
2020/05/04,Toledo,Madrid,3068,6663394,882968,5780426,694844,75914
2020/05/04,Toledo,Cáceres,194,394151,39817,354334,694844,75914
2020/05/04,Toledo,Ávila,207,157640,15939,141701,694844,75914
2020/05/04,Toledo,Cuenca,78,196329,18376,177953,694844,75914
2020/05/04,Toledo,Toledo,38080,694844,79828,615016,694844,75914
2020/05/04,Toledo,Ciudad Real,270,495761,42292,453469,694844,75914
2020/05/04,Valencia,Cáceres,17,394151,39817,354334,2565124,376042
2020/05/04,Valencia,Valencia,264097,2565124,386193,2178931,2565124,376042
2020/05/04,Valencia,Alicante,817,1858683,240865,1617818,2565124,376042
2020/05/04,Valencia,Castellón,683,579962,71617,508345,2565124,376042
2020/05/04,Valencia,Albacete,353,388167,34031,354136,2565124,376042
2020/05/04,Valencia,Cuenca,83,196329,18376,177953,2565124,376042
2020/05/04,Valladolid,Ávila,26,157640,15939,141701,519546,73218
2020/05/04,Valladolid,Palencia,35,160866,21120,139746,519546,73218
2020/05/04,Valladolid,Segovia,266,153129,18532,134597,519546,73218
2020/05/04,Valladolid,Zamora,186,172539,20165,152374,519546,73218
2020/05/04,Valladolid,Valladolid,54355,519546,75113,444433,519546,73218
2020/05/04,Valladolid,Burgos,58,357072,41639,315433,519546,73218
2020/05/04,Zamora,Zamora,14002,172539,20165,152374,172539,20565
2020/05/04,Zamora,Ourense,44,307651,45743,261908,172539,20565
2020/05/04,Zamora,Salamanca,42,330119,43468,286651,172539,20565
2020/05/04,Zamora,Valladolid,124,519546,75113,444433,172539,20565
2020/05/04,Zamora,León,64,460001,61482,398519,172539,20565
2020/05/04,Zaragoza,Zaragoza,109437,964724,144869,819855,964724,140858
2020/05/04,Zaragoza,Lleida,87,434930,57709,377221,964724,140858
2020/05/04,Zaragoza,Soria,62,88636,7322,81314,964724,140858
2020/05/04,Zaragoza,Navarra,401,654183,92281,561902,964724,140858
2020/05/04,Zaragoza,Teruel,194,134137,9504,124633,964724,140858
2020/05/04,Zaragoza,Huesca,226,220461,25336,195125,964724,140858
2020/05/05,Albacete,Valencia,439,2565124,407025,2158099,388167,36515
2020/05/05,Albacete,Murcia,492,1493898,208971,1284927,388167,36515
2020/05/05,Albacete,Cuenca,678,196329,19427,176902,388167,36515
2020/05/05,Albacete,Jaén,43,633564,62780,570784,388167,36515
2020/05/05,Albacete,Ciudad Real,638,495761,43927,451834,388167,36515
2020/05/05,Albacete,Albacete,23419,388167,36528,351639,388167,36515
2020/05/05,Albacete,Alicante,254,1858683,257155,1601528,388167,36515
2020/05/05,Alicante,Albacete,408,388167,36528,351639,1858683,260818
2020/05/05,Alicante,Alicante,200606,1858683,257155,1601528,1858683,260818
2020/05/05,Alicante,Murcia,3058,1493898,208971,1284927,1858683,260818
2020/05/05,Alicante,Valencia,1185,2565124,407025,2158099,1858683,260818
2020/05/05,Almería,Granada,578,914678,116966,797712,716820,89379
2020/05/05,Almería,Murcia,2059,1493898,208971,1284927,716820,89379
2020/05/05,Almería,Almería,71819,716820,87450,629370,716820,89379
2020/05/05,Araba,Gipuzkoa,149,723576,101958,621618,331549,62082
2020/05/05,Araba,Bizkaia,1234,1152934,209315,943619,331549,62082
2020/05/05,Araba,Burgos,2017,357072,44537,312535,331549,62082
2020/05/05,Araba,Rioja,2203,316798,45805,270993,331549,62082
2020/05/05,Araba,Araba,45118,331549,55059,276490,331549,62082
2020/05/05,Araba,Navarra,142,654183,96306,557877,331549,62082
2020/05/05,Asturias,Lugo,940,329587,41994,287593,1022800,136244
2020/05/05,Asturias,León,30,460001,64955,395046,1022800,136244
2020/05/05,Asturias,Cantabria,190,580795,82486,498309,1022800,136244
2020/05/05,Asturias,Asturias,108724,1022800,136663,886137,1022800,136244
2020/05/05,Ávila,Madrid,135,6663394,935712,5727682,157640,17403
2020/05/05,Ávila,Cáceres,99,394151,40134,354017,157640,17403
2020/05/05,Ávila,Toledo,221,694844,83316,611528,157640,17403
2020/05/05,Ávila,Segovia,67,153129,19728,133401,157640,17403
2020/05/05,Ávila,Valladolid,34,519546,80060,439486,157640,17403
2020/05/05,Ávila,Ávila,11104,157640,16812,140828,157640,17403
2020/05/05,Ávila,Salamanca,324,330119,44713,285406,157640,17403
2020/05/05,Badajoz,Ciudad Real,54,495761,43927,451834,673559,78995
2020/05/05,Badajoz,Córdoba,37,782979,103569,679410,673559,78995
2020/05/05,Badajoz,Huelva,251,521870,67425,454445,673559,78995
2020/05/05,Badajoz,Badajoz,58729,673559,80085,593474,673559,78995
2020/05/05,Badajoz,Cáceres,1034,394151,40134,354017,673559,78995
2020/05/05,Badajoz,Sevilla,108,1942389,273168,1669221,673559,78995
2020/05/05,Balears,Balears,127587,1149460,145575,1003885,1149460,145946
2020/05/05,Balears,Valencia,31,2565124,407025,2158099,1149460,145946
2020/05/05,Barcelona,Girona,2829,771044,90431,680613,5664579,907788
2020/05/05,Barcelona,Barcelona,582402,5664579,908802,4755777,5664579,907788
2020/05/05,Barcelona,Tarragona,1555,804664,100619,704045,5664579,907788
2020/05/05,Barcelona,Lleida,154,434930,60560,374370,5664579,907788
2020/05/05,Bizkaia,Gipuzkoa,1153,723576,101958,621618,1152934,205867
2020/05/05,Bizkaia,Bizkaia,160868,1152934,209315,943619,1152934,205867
2020/05/05,Bizkaia,Burgos,46,357072,44537,312535,1152934,205867
2020/05/05,Bizkaia,Araba,728,331549,55059,276490,1152934,205867
2020/05/05,Bizkaia,Cantabria,2373,580795,82486,498309,1152934,205867
2020/05/05,Burgos,Araba,870,331549,55059,276490,357072,44689
2020/05/05,Burgos,Bizkaia,105,1152934,209315,943619,357072,44689
2020/05/05,Burgos,Soria,27,88636,7916,80720,357072,44689
2020/05/05,Burgos,Valladolid,74,519546,80060,439486,357072,44689
2020/05/05,Burgos,Burgos,32756,357072,44537,312535,357072,44689
2020/05/05,Burgos,Segovia,42,153129,19728,133401,357072,44689
2020/05/05,Burgos,Palencia,234,160866,22725,138141,357072,44689
2020/05/05,Burgos,Rioja,76,316798,45805,270993,357072,44689
2020/05/05,Cáceres,Cáceres,27316,394151,40134,354017,394151,40852
2020/05/05,Cáceres,Badajoz,1378,673559,80085,593474,394151,40852
2020/05/05,Cáceres,Ávila,145,157640,16812,140828,394151,40852
2020/05/05,Cáceres,Toledo,174,694844,83316,611528,394151,40852
2020/05/05,Cádiz,Sevilla,894,1942389,273168,1669221,1240155,163343
2020/05/05,Cádiz,Ceuta,69,84777,9934,74843,1240155,163343
2020/05/05,Cádiz,Málaga,1233,1661785,210575,1451210,1240155,163343
2020/05/05,Cádiz,Cádiz,133389,1240155,161553,1078602,1240155,163343
2020/05/05,Cádiz,Huelva,706,521870,67425,454445,1240155,163343
2020/05/05,Cantabria,Palencia,50,160866,22725,138141,580795,78763
2020/05/05,Cantabria,Asturias,265,1022800,136663,886137,580795,78763
2020/05/05,Cantabria,Cantabria,59221,580795,82486,498309,580795,78763
2020/05/05,Cantabria,Bizkaia,647,1152934,209315,943619,580795,78763
2020/05/05,Castellón,Castellón,56610,579962,76469,503493,579962,80328
2020/05/05,Castellón,Valencia,728,2565124,407025,2158099,579962,80328
2020/05/05,Castellón,Teruel,118,134137,10129,124008,579962,80328
2020/05/05,Castellón,Tarragona,915,804664,100619,704045,579962,80328
2020/05/05,Ceuta,Ceuta,9489,84777,9934,74843,84777,9900
2020/05/05,Ceuta,Cádiz,25,1240155,161553,1078602,84777,9900
2020/05/05,Ciudad Real,Ciudad Real,26226,495761,43927,451834,495761,40509
2020/05/05,Ciudad Real,Cuenca,32,196329,19427,176902,495761,40509
2020/05/05,Ciudad Real,Albacete,399,388167,36528,351639,495761,40509
2020/05/05,Ciudad Real,Toledo,224,694844,83316,611528,495761,40509
2020/05/05,Ciudad Real,Córdoba,399,782979,103569,679410,495761,40509
2020/05/05,Ciudad Real,Badajoz,60,673559,80085,593474,495761,40509
2020/05/05,Córdoba,Málaga,388,1661785,210575,1451210,782979,101472
2020/05/05,Córdoba,Ciudad Real,297,495761,43927,451834,782979,101472
2020/05/05,Córdoba,Córdoba,74209,782979,103569,679410,782979,101472
2020/05/05,Córdoba,Jaén,654,633564,62780,570784,782979,101472
2020/05/05,Córdoba,Granada,140,914678,116966,797712,782979,101472
2020/05/05,Córdoba,Badajoz,145,673559,80085,593474,782979,101472
2020/05/05,Córdoba,Sevilla,1781,1942389,273168,1669221,782979,101472
2020/05/05,Coruña,Pontevedra,4850,942665,143584,799081,1119596,163381
2020/05/05,Coruña,Lugo,637,329587,41994,287593,1119596,163381
2020/05/05,Coruña,Coruña,122254,1119596,161317,958279,1119596,163381
2020/05/05,Cuenca,Toledo,208,694844,83316,611528,196329,20357
2020/05/05,Cuenca,Guadalajara,40,257762,34558,223204,196329,20357
2020/05/05,Cuenca,Madrid,76,6663394,935712,5727682,196329,20357
2020/05/05,Cuenca,Albacete,685,388167,36528,351639,196329,20357
2020/05/05,Cuenca,Cuenca,10085,196329,19427,176902,196329,20357
2020/05/05,Cuenca,Valencia,56,2565124,407025,2158099,196329,20357
2020/05/05,Cuenca,Ciudad Real,173,495761,43927,451834,196329,20357
2020/05/05,Gipuzkoa,Araba,154,331549,55059,276490,723576,106658
2020/05/05,Gipuzkoa,Gipuzkoa,78109,723576,101958,621618,723576,106658
2020/05/05,Gipuzkoa,Bizkaia,1345,1152934,209315,943619,723576,106658
2020/05/05,Gipuzkoa,Navarra,480,654183,96306,557877,723576,106658
2020/05/05,Girona,Almería,43,716820,87450,629370,771044,97134
2020/05/05,Girona,Barcelona,2457,5664579,908802,4755777,771044,97134
2020/05/05,Girona,Girona,60866,771044,90431,680613,771044,97134
2020/05/05,Girona,Lleida,195,434930,60560,374370,771044,97134
2020/05/05,Granada,Murcia,33,1493898,208971,1284927,914678,114090
2020/05/05,Granada,Málaga,129,1661785,210575,1451210,914678,114090
2020/05/05,Granada,Granada,84847,914678,116966,797712,914678,114090
2020/05/05,Granada,Almería,397,716820,87450,629370,914678,114090
2020/05/05,Granada,Córdoba,286,782979,103569,679410,914678,114090
2020/05/05,Granada,Jaén,334,633564,62780,570784,914678,114090
2020/05/05,Guadalajara,Guadalajara,19866,257762,34558,223204,257762,36117
2020/05/05,Guadalajara,Madrid,2376,6663394,935712,5727682,257762,36117
2020/05/05,Guadalajara,Teruel,31,134137,10129,124008,257762,36117
2020/05/05,Guadalajara,Cuenca,45,196329,19427,176902,257762,36117
2020/05/05,Huelva,Badajoz,348,673559,80085,593474,521870,71164
2020/05/05,Huelva,Cádiz,587,1240155,161553,1078602,521870,71164
2020/05/05,Huelva,Huelva,52280,521870,67425,454445,521870,71164
2020/05/05,Huelva,Sevilla,1430,1942389,273168,1669221,521870,71164
2020/05/05,Huesca,Lleida,1035,434930,60560,374370,220461,30423
2020/05/05,Huesca,Zaragoza,232,964724,152238,812486,220461,30423
2020/05/05,Huesca,Huesca,19061,220461,27326,193135,220461,30423
2020/05/05,Jaén,Granada,240,914678,116966,797712,633564,61136
2020/05/05,Jaén,Jaén,43095,633564,62780,570784,633564,61136
2020/05/05,Jaén,Sevilla,16,1942389,273168,1669221,633564,61136
2020/05/05,Jaén,Córdoba,789,782979,103569,679410,633564,61136
2020/05/05,Las Palmas de Gran Canaria,Las Palmas de Gran Canaria,138300,1120406,149896,970510,1120406,149482
2020/05/05,León,Asturias,27,1022800,136663,886137,460001,64448
2020/05/05,León,Ourense,304,307651,46815,260836,460001,64448
2020/05/05,León,Palencia,29,160866,22725,138141,460001,64448
2020/05/05,León,León,49413,460001,64955,395046,460001,64448
2020/05/05,León,Zamora,249,172539,22394,150145,460001,64448
2020/05/05,Lleida,Tarragona,30,804664,100619,704045,434930,58254
2020/05/05,Lleida,Girona,177,771044,90431,680613,434930,58254
2020/05/05,Lleida,Barcelona,197,5664579,908802,4755777,434930,58254
2020/05/05,Lleida,Lleida,38870,434930,60560,374370,434930,58254
2020/05/05,Lleida,Zaragoza,182,964724,152238,812486,434930,58254
2020/05/05,Lleida,Huesca,625,220461,27326,193135,434930,58254
2020/05/05,Lugo,Lugo,30090,329587,41994,287593,329587,43698
2020/05/05,Lugo,Asturias,784,1022800,136663,886137,329587,43698
2020/05/05,Lugo,Ourense,266,307651,46815,260836,329587,43698
2020/05/05,Lugo,Coruña,560,1119596,161317,958279,329587,43698
2020/05/05,Madrid,Guadalajara,2506,257762,34558,223204,6663394,937875
2020/05/05,Madrid,Cuenca,97,196329,19427,176902,6663394,937875
2020/05/05,Madrid,Madrid,541476,6663394,935712,5727682,6663394,937875
2020/05/05,Madrid,Segovia,25,153129,19728,133401,6663394,937875
2020/05/05,Madrid,Córdoba,16,782979,103569,679410,6663394,937875
2020/05/05,Madrid,Ávila,187,157640,16812,140828,6663394,937875
2020/05/05,Madrid,Toledo,3672,694844,83316,611528,6663394,937875
2020/05/05,Málaga,Granada,261,914678,116966,797712,1661785,215177
2020/05/05,Málaga,Cádiz,1008,1240155,161553,1078602,1661785,215177
2020/05/05,Málaga,Córdoba,350,782979,103569,679410,1661785,215177
2020/05/05,Málaga,Sevilla,359,1942389,273168,1669221,1661785,215177
2020/05/05,Málaga,Málaga,172641,1661785,210575,1451210,1661785,215177
2020/05/05,Melilla,Melilla,11064,86487,11241,75246,86487,11232
2020/05/05,Murcia,Murcia,159891,1493898,208971,1284927,1493898,204863
2020/05/05,Murcia,Alicante,2441,1858683,257155,1601528,1493898,204863
2020/05/05,Murcia,Almería,1417,716820,87450,629370,1493898,204863
2020/05/05,Murcia,Albacete,470,388167,36528,351639,1493898,204863
2020/05/05,Murcia,Granada,58,914678,116966,797712,1493898,204863
2020/05/05,Navarra,Rioja,2500,316798,45805,270993,654183,98361
2020/05/05,Navarra,Navarra,68644,654183,96306,557877,654183,98361
2020/05/05,Navarra,Araba,36,331549,55059,276490,654183,98361
2020/05/05,Navarra,Gipuzkoa,405,723576,101958,621618,654183,98361
2020/05/05,Navarra,Zaragoza,609,964724,152238,812486,654183,98361
2020/05/05,Ourense,Pontevedra,209,942665,143584,799081,307651,46898
2020/05/05,Ourense,León,313,460001,64955,395046,307651,46898
2020/05/05,Ourense,Ourense,35836,307651,46815,260836,307651,46898
2020/05/05,Ourense,Zamora,62,172539,22394,150145,307651,46898
2020/05/05,Ourense,Lugo,171,329587,41994,287593,307651,46898
2020/05/05,Palencia,Burgos,236,357072,44537,312535,160866,24173
2020/05/05,Palencia,Cantabria,166,580795,82486,498309,160866,24173
2020/05/05,Palencia,Valladolid,212,519546,80060,439486,160866,24173
2020/05/05,Palencia,Palencia,16616,160866,22725,138141,160866,24173
2020/05/05,Palencia,León,32,460001,64955,395046,160866,24173
2020/05/05,Pontevedra,Ourense,140,307651,46815,260836,942665,142658
2020/05/05,Pontevedra,Pontevedra,110292,942665,143584,799081,942665,142658
2020/05/05,Pontevedra,Coruña,3809,1119596,161317,958279,942665,142658
2020/05/05,Rioja,Navarra,1890,654183,96306,557877,316798,43592
2020/05/05,Rioja,Rioja,32788,316798,45805,270993,316798,43592
2020/05/05,Rioja,Burgos,79,357072,44537,312535,316798,43592
2020/05/05,Rioja,Araba,778,331549,55059,276490,316798,43592
2020/05/05,Salamanca,Salamanca,35211,330119,44713,285406,330119,44135
2020/05/05,Salamanca,Zamora,56,172539,22394,150145,330119,44135
2020/05/05,Salamanca,Ávila,214,157640,16812,140828,330119,44135
2020/05/05,Santa Cruz de Tenerife,Las Palmas de Gran Canaria,38,1120406,149896,970510,1032983,135058
2020/05/05,Santa Cruz de Tenerife,Santa Cruz de Tenerife,121654,1032983,135340,897643,1032983,135058
2020/05/05,Segovia,Burgos,92,357072,44537,312535,153129,21238
2020/05/05,Segovia,Segovia,13199,153129,19728,133401,153129,21238
2020/05/05,Segovia,Valladolid,314,519546,80060,439486,153129,21238
2020/05/05,Segovia,Ávila,106,157640,16812,140828,153129,21238
2020/05/05,Sevilla,Málaga,142,1661785,210575,1451210,1942389,267621
2020/05/05,Sevilla,Córdoba,2024,782979,103569,679410,1942389,267621
2020/05/05,Sevilla,Cádiz,2006,1240155,161553,1078602,1942389,267621
2020/05/05,Sevilla,Huelva,507,521870,67425,454445,1942389,267621
2020/05/05,Sevilla,Sevilla,191643,1942389,273168,1669221,1942389,267621
2020/05/05,Sevilla,Badajoz,79,673559,80085,593474,1942389,267621
2020/05/05,Soria,Segovia,23,153129,19728,133401,88636,8844
2020/05/05,Soria,Soria,5894,88636,7916,80720,88636,8844
2020/05/05,Soria,Valladolid,44,519546,80060,439486,88636,8844
2020/05/05,Soria,Burgos,32,357072,44537,312535,88636,8844
2020/05/05,Soria,Zaragoza,126,964724,152238,812486,88636,8844
2020/05/05,Tarragona,Zaragoza,36,964724,152238,812486,804664,100401
2020/05/05,Tarragona,Barcelona,1006,5664579,908802,4755777,804664,100401
2020/05/05,Tarragona,Teruel,96,134137,10129,124008,804664,100401
2020/05/05,Tarragona,Tarragona,66318,804664,100619,704045,804664,100401
2020/05/05,Tarragona,Castellón,781,579962,76469,503493,804664,100401
2020/05/05,Teruel,Castellón,80,579962,76469,503493,134137,11886
2020/05/05,Teruel,Teruel,5933,134137,10129,124008,134137,11886
2020/05/05,Teruel,Tarragona,63,804664,100619,704045,134137,11886
2020/05/05,Teruel,Zaragoza,219,964724,152238,812486,134137,11886
2020/05/05,Toledo,Ávila,214,157640,16812,140828,694844,79368
2020/05/05,Toledo,Cáceres,175,394151,40134,354017,694844,79368
2020/05/05,Toledo,Cuenca,100,196329,19427,176902,694844,79368
2020/05/05,Toledo,Toledo,39435,694844,83316,611528,694844,79368
2020/05/05,Toledo,Ciudad Real,288,495761,43927,451834,694844,79368
2020/05/05,Toledo,Madrid,3296,6663394,935712,5727682,694844,79368
2020/05/05,Valencia,Albacete,411,388167,36528,351639,2565124,397343
2020/05/05,Valencia,Alicante,1031,1858683,257155,1601528,2565124,397343
2020/05/05,Valencia,Castellón,912,579962,76469,503493,2565124,397343
2020/05/05,Valencia,Cuenca,132,196329,19427,176902,2565124,397343
2020/05/05,Valencia,Valencia,282272,2565124,407025,2158099,2565124,397343
2020/05/05,Valladolid,León,18,460001,64955,395046,519546,77141
2020/05/05,Valladolid,Ávila,29,157640,16812,140828,519546,77141
2020/05/05,Valladolid,Zamora,172,172539,22394,150145,519546,77141
2020/05/05,Valladolid,Palencia,39,160866,22725,138141,519546,77141
2020/05/05,Valladolid,Burgos,93,357072,44537,312535,519546,77141
2020/05/05,Valladolid,Valladolid,58556,519546,80060,439486,519546,77141
2020/05/05,Valladolid,Soria,29,88636,7916,80720,519546,77141
2020/05/05,Valladolid,Segovia,292,153129,19728,133401,519546,77141
2020/05/05,Zamora,Córdoba,16,782979,103569,679410,172539,22299
2020/05/05,Zamora,León,32,460001,64955,395046,172539,22299
2020/05/05,Zamora,Zamora,15525,172539,22394,150145,172539,22299
2020/05/05,Zamora,Valladolid,91,519546,80060,439486,172539,22299
2020/05/05,Zamora,Ourense,69,307651,46815,260836,172539,22299
2020/05/05,Zaragoza,Zaragoza,115788,964724,152238,812486,964724,146659
2020/05/05,Zaragoza,Lleida,127,434930,60560,374370,964724,146659
2020/05/05,Zaragoza,Soria,83,88636,7916,80720,964724,146659
2020/05/05,Zaragoza,Huesca,285,220461,27326,193135,964724,146659
2020/05/05,Zaragoza,Navarra,505,654183,96306,557877,964724,146659
2020/05/05,Zaragoza,Teruel,262,134137,10129,124008,964724,146659
2020/05/06,Albacete,Alicante,175,1858683,254142,1604541,388167,36857
2020/05/06,Albacete,Valencia,282,2565124,402050,2163074,388167,36857
2020/05/06,Albacete,Ciudad Real,646,495761,43219,452542,388167,36857
2020/05/06,Albacete,Cuenca,639,196329,19338,176991,388167,36857
2020/05/06,Albacete,Jaén,16,633564,62085,571479,388167,36857
2020/05/06,Albacete,Albacete,23715,388167,37343,350824,388167,36857
2020/05/06,Albacete,Murcia,420,1493898,204915,1288983,388167,36857
2020/05/06,Alicante,Alicante,197493,1858683,254142,1604541,1858683,257993
2020/05/06,Alicante,Valencia,1119,2565124,402050,2163074,1858683,257993
2020/05/06,Alicante,Murcia,2965,1493898,204915,1288983,1858683,257993
2020/05/06,Alicante,Albacete,360,388167,37343,350824,1858683,257993
2020/05/06,Almería,Almería,67755,716820,83175,633645,716820,85431
2020/05/06,Almería,Granada,526,914678,116021,798657,716820,85431
2020/05/06,Almería,Murcia,1875,1493898,204915,1288983,716820,85431
2020/05/06,Araba,Bizkaia,1259,1152934,206258,946676,331549,63167
2020/05/06,Araba,Burgos,2055,357072,44244,312828,331549,63167
2020/05/06,Araba,Rioja,2236,316798,47464,269334,331549,63167
2020/05/06,Araba,Gipuzkoa,197,723576,103132,620444,331549,63167
2020/05/06,Araba,Navarra,161,654183,97936,556247,331549,63167
2020/05/06,Araba,Araba,45554,331549,55690,275859,331549,63167
2020/05/06,Asturias,Asturias,109436,1022800,137175,885625,1022800,136975
2020/05/06,Asturias,León,28,460001,63040,396961,1022800,136975
2020/05/06,Asturias,Cantabria,219,580795,82480,498315,1022800,136975
2020/05/06,Asturias,Lugo,910,329587,40490,289097,1022800,136975
2020/05/06,Ávila,Salamanca,348,330119,43421,286698,157640,16741
2020/05/06,Ávila,Toledo,177,694844,81074,613770,157640,16741
2020/05/06,Ávila,Valladolid,35,519546,78675,440871,157640,16741
2020/05/06,Ávila,Ávila,10616,157640,16379,141261,157640,16741
2020/05/06,Ávila,Segovia,107,153129,18492,134637,157640,16741
2020/05/06,Ávila,Cáceres,73,394151,38876,355275,157640,16741
2020/05/06,Ávila,Madrid,176,6663394,915223,5748171,157640,16741
2020/05/06,Badajoz,Cáceres,1200,394151,38876,355275,673559,78565
2020/05/06,Badajoz,Badajoz,58226,673559,79321,594238,673559,78565
2020/05/06,Badajoz,Sevilla,131,1942389,272438,1669951,673559,78565
2020/05/06,Badajoz,Ciudad Real,63,495761,43219,452542,673559,78565
2020/05/06,Badajoz,Córdoba,95,782979,103118,679861,673559,78565
2020/05/06,Badajoz,Huelva,236,521870,66843,455027,673559,78565
2020/05/06,Balears,Balears,121820,1149460,141476,1007984,1149460,141108
2020/05/06,Balears,Valencia,51,2565124,402050,2163074,1149460,141108
2020/05/06,Barcelona,Barcelona,536223,5664579,858371,4806208,5664579,859824
2020/05/06,Barcelona,Girona,2439,771044,87172,683872,5664579,859824
2020/05/06,Barcelona,Lleida,208,434930,59880,375050,5664579,859824
2020/05/06,Barcelona,Tarragona,1394,804664,97955,706709,5664579,859824
2020/05/06,Bizkaia,Araba,756,331549,55690,275859,1152934,202398
2020/05/06,Bizkaia,Burgos,72,357072,44244,312828,1152934,202398
2020/05/06,Bizkaia,Gipuzkoa,1253,723576,103132,620444,1152934,202398
2020/05/06,Bizkaia,Cantabria,2194,580795,82480,498315,1152934,202398
2020/05/06,Bizkaia,Bizkaia,156208,1152934,206258,946676,1152934,202398
2020/05/06,Burgos,Cantabria,26,580795,82480,498315,357072,43814
2020/05/06,Burgos,Soria,30,88636,7745,80891,357072,43814
2020/05/06,Burgos,Rioja,105,316798,47464,269334,357072,43814
2020/05/06,Burgos,Bizkaia,149,1152934,206258,946676,357072,43814
2020/05/06,Burgos,Burgos,32267,357072,44244,312828,357072,43814
2020/05/06,Burgos,Segovia,50,153129,18492,134637,357072,43814
2020/05/06,Burgos,Palencia,252,160866,22122,138744,357072,43814
2020/05/06,Burgos,Valladolid,85,519546,78675,440871,357072,43814
2020/05/06,Burgos,Araba,858,331549,55690,275859,357072,43814
2020/05/06,Cáceres,Valencia,22,2565124,402050,2163074,394151,39028
2020/05/06,Cáceres,Toledo,211,694844,81074,613770,394151,39028
2020/05/06,Cáceres,Badajoz,1093,673559,79321,594238,394151,39028
2020/05/06,Cáceres,Ávila,133,157640,16379,141261,394151,39028
2020/05/06,Cáceres,Cáceres,25557,394151,38876,355275,394151,39028
2020/05/06,Cádiz,Córdoba,34,782979,103118,679861,1240155,161014
2020/05/06,Cádiz,Cádiz,130983,1240155,157669,1082486,1240155,161014
2020/05/06,Cádiz,Huelva,602,521870,66843,455027,1240155,161014
2020/05/06,Cádiz,Sevilla,963,1942389,272438,1669951,1240155,161014
2020/05/06,Cádiz,Málaga,1289,1661785,205661,1456124,1240155,161014
2020/05/06,Cantabria,Cantabria,59380,580795,82480,498315,580795,78795
2020/05/06,Cantabria,Palencia,45,160866,22122,138744,580795,78795
2020/05/06,Cantabria,Bizkaia,575,1152934,206258,946676,580795,78795
2020/05/06,Cantabria,Asturias,309,1022800,137175,885625,580795,78795
2020/05/06,Castellón,Tarragona,979,804664,97955,706709,579962,79868
2020/05/06,Castellón,Castellón,56431,579962,75634,504328,579962,79868
2020/05/06,Castellón,Valencia,709,2565124,402050,2163074,579962,79868
2020/05/06,Castellón,Teruel,103,134137,10071,124066,579962,79868
2020/05/06,Ceuta,Ceuta,9668,84777,10092,74685,84777,10143
2020/05/06,Ciudad Real,Ciudad Real,25713,495761,43219,452542,495761,39839
2020/05/06,Ciudad Real,Toledo,222,694844,81074,613770,495761,39839
2020/05/06,Ciudad Real,Albacete,355,388167,37343,350824,495761,39839
2020/05/06,Ciudad Real,Córdoba,344,782979,103118,679861,495761,39839
2020/05/06,Ciudad Real,Badajoz,61,673559,79321,594238,495761,39839
2020/05/06,Córdoba,Córdoba,73467,782979,103118,679861,782979,100562
2020/05/06,Córdoba,Ciudad Real,258,495761,43219,452542,782979,100562
2020/05/06,Córdoba,Sevilla,1591,1942389,272438,1669951,782979,100562
2020/05/06,Córdoba,Jaén,672,633564,62085,571479,782979,100562
2020/05/06,Córdoba,Badajoz,130,673559,79321,594238,782979,100562
2020/05/06,Córdoba,Granada,114,914678,116021,798657,782979,100562
2020/05/06,Córdoba,Málaga,307,1661785,205661,1456124,782979,100562
2020/05/06,Coruña,Lugo,589,329587,40490,289097,1119596,164568
2020/05/06,Coruña,Coruña,123245,1119596,161729,957867,1119596,164568
2020/05/06,Coruña,Pontevedra,5062,942665,142746,799919,1119596,164568
2020/05/06,Cuenca,Guadalajara,34,257762,34273,223489,196329,20543
2020/05/06,Cuenca,Albacete,780,388167,37343,350824,196329,20543
2020/05/06,Cuenca,Cuenca,10041,196329,19338,176991,196329,20543
2020/05/06,Cuenca,Toledo,233,694844,81074,613770,196329,20543
2020/05/06,Cuenca,Ciudad Real,137,495761,43219,452542,196329,20543
2020/05/06,Cuenca,Madrid,72,6663394,915223,5748171,196329,20543
2020/05/06,Cuenca,Valencia,60,2565124,402050,2163074,196329,20543
2020/05/06,Gipuzkoa,Gipuzkoa,78806,723576,103132,620444,723576,106874
2020/05/06,Gipuzkoa,Araba,143,331549,55690,275859,723576,106874
2020/05/06,Gipuzkoa,Navarra,302,654183,97936,556247,723576,106874
2020/05/06,Gipuzkoa,Bizkaia,1510,1152934,206258,946676,723576,106874
2020/05/06,Girona,Girona,57968,771044,87172,683872,771044,92921
2020/05/06,Girona,Lleida,167,434930,59880,375050,771044,92921
2020/05/06,Girona,Barcelona,2308,5664579,858371,4806208,771044,92921
2020/05/06,Granada,Jaén,404,633564,62085,571479,914678,113681
2020/05/06,Granada,Almería,410,716820,83175,633645,914678,113681
2020/05/06,Granada,Córdoba,186,782979,103118,679861,914678,113681
2020/05/06,Granada,Málaga,169,1661785,205661,1456124,914678,113681
2020/05/06,Granada,Murcia,100,1493898,204915,1288983,914678,113681
2020/05/06,Granada,Granada,84265,914678,116021,798657,914678,113681
2020/05/06,Guadalajara,Madrid,2171,6663394,915223,5748171,257762,35752
2020/05/06,Guadalajara,Guadalajara,19349,257762,34273,223489,257762,35752
2020/05/06,Guadalajara,Cuenca,41,196329,19338,176991,257762,35752
2020/05/06,Guadalajara,Córdoba,17,782979,103118,679861,257762,35752
2020/05/06,Huelva,Badajoz,271,673559,79321,594238,521870,70223
2020/05/06,Huelva,Sevilla,1522,1942389,272438,1669951,521870,70223
2020/05/06,Huelva,Huelva,51597,521870,66843,455027,521870,70223
2020/05/06,Huelva,Cádiz,481,1240155,157669,1082486,521870,70223
2020/05/06,Huesca,Huesca,17706,220461,26271,194190,220461,29287
2020/05/06,Huesca,Lleida,1057,434930,59880,375050,220461,29287
2020/05/06,Huesca,Zaragoza,319,964724,150050,814674,220461,29287
2020/05/06,Jaén,Albacete,39,388167,37343,350824,633564,60561
2020/05/06,Jaén,Jaén,42661,633564,62085,571479,633564,60561
2020/05/06,Jaén,Granada,258,914678,116021,798657,633564,60561
2020/05/06,Jaén,Córdoba,748,782979,103118,679861,633564,60561
2020/05/06,Las Palmas de Gran Canaria,Santa Cruz de Tenerife,173,1032983,136606,896377,1120406,147590
2020/05/06,Las Palmas de Gran Canaria,Las Palmas de Gran Canaria,136220,1120406,148887,971519,1120406,147590
2020/05/06,León,León,47170,460001,63040,396961,460001,62340
2020/05/06,León,Zamora,175,172539,21228,151311,460001,62340
2020/05/06,León,Valladolid,28,519546,78675,440871,460001,62340
2020/05/06,León,Ourense,322,307651,46219,261432,460001,62340
2020/05/06,León,Palencia,63,160866,22122,138744,460001,62340
2020/05/06,León,Asturias,25,1022800,137175,885625,460001,62340
2020/05/06,Lleida,Huesca,676,220461,26271,194190,434930,57493
2020/05/06,Lleida,Lleida,38322,434930,59880,375050,434930,57493
2020/05/06,Lleida,Girona,169,771044,87172,683872,434930,57493
2020/05/06,Lleida,Tarragona,34,804664,97955,706709,434930,57493
2020/05/06,Lleida,Zaragoza,145,964724,150050,814674,434930,57493
2020/05/06,Lleida,Barcelona,213,5664579,858371,4806208,434930,57493
2020/05/06,Lugo,Lugo,28563,329587,40490,289097,329587,42144
2020/05/06,Lugo,Ourense,136,307651,46219,261432,329587,42144
2020/05/06,Lugo,Asturias,683,1022800,137175,885625,329587,42144
2020/05/06,Lugo,Coruña,601,1119596,161729,957867,329587,42144
2020/05/06,Madrid,Ciudad Real,46,495761,43219,452542,6663394,918865
2020/05/06,Madrid,Toledo,3332,694844,81074,613770,6663394,918865
2020/05/06,Madrid,Madrid,525686,6663394,915223,5748171,6663394,918865
2020/05/06,Madrid,Cuenca,87,196329,19338,176991,6663394,918865
2020/05/06,Madrid,Ávila,228,157640,16379,141261,6663394,918865
2020/05/06,Madrid,Guadalajara,2525,257762,34273,223489,6663394,918865
2020/05/06,Málaga,Cádiz,1027,1240155,157669,1082486,1661785,209837
2020/05/06,Málaga,Málaga,168218,1661785,205661,1456124,1661785,209837
2020/05/06,Málaga,Granada,272,914678,116021,798657,1661785,209837
2020/05/06,Málaga,Córdoba,324,782979,103118,679861,1661785,209837
2020/05/06,Málaga,Sevilla,428,1942389,272438,1669951,1661785,209837
2020/05/06,Melilla,Melilla,11675,86487,11826,74661,86487,11881
2020/05/06,Murcia,Alicante,2522,1858683,254142,1604541,1493898,201187
2020/05/06,Murcia,Granada,59,914678,116021,798657,1493898,201187
2020/05/06,Murcia,Almería,1163,716820,83175,633645,1493898,201187
2020/05/06,Murcia,Albacete,453,388167,37343,350824,1493898,201187
2020/05/06,Murcia,Murcia,155968,1493898,204915,1288983,1493898,201187
2020/05/06,Navarra,Gipuzkoa,328,723576,103132,620444,654183,99262
2020/05/06,Navarra,Araba,79,331549,55690,275859,654183,99262
2020/05/06,Navarra,Rioja,2642,316798,47464,269334,654183,99262
2020/05/06,Navarra,Navarra,69930,654183,97936,556247,654183,99262
2020/05/06,Navarra,Zaragoza,574,964724,150050,814674,654183,99262
2020/05/06,Ourense,Lugo,153,329587,40490,289097,307651,47098
2020/05/06,Ourense,Ourense,35793,307651,46219,261432,307651,47098
2020/05/06,Ourense,Zamora,73,172539,21228,151311,307651,47098
2020/05/06,Ourense,León,319,460001,63040,396961,307651,47098
2020/05/06,Ourense,Pontevedra,153,942665,142746,799919,307651,47098
2020/05/06,Palencia,León,29,460001,63040,396961,160866,23620
2020/05/06,Palencia,Burgos,225,357072,44244,312828,160866,23620
2020/05/06,Palencia,Palencia,16093,160866,22122,138744,160866,23620
2020/05/06,Palencia,Valladolid,302,519546,78675,440871,160866,23620
2020/05/06,Palencia,Cantabria,158,580795,82480,498315,160866,23620
2020/05/06,Pontevedra,Pontevedra,109596,942665,142746,799919,942665,142229
2020/05/06,Pontevedra,Coruña,3709,1119596,161729,957867,942665,142229
2020/05/06,Pontevedra,Ourense,172,307651,46219,261432,942665,142229
2020/05/06,Rioja,Rioja,33927,316798,47464,269334,316798,44988
2020/05/06,Rioja,Navarra,2083,654183,97936,556247,316798,44988
2020/05/06,Rioja,Burgos,72,357072,44244,312828,316798,44988
2020/05/06,Rioja,Araba,826,331549,55690,275859,316798,44988
2020/05/06,Salamanca,Salamanca,33634,330119,43421,286698,330119,42533
2020/05/06,Salamanca,Zamora,33,172539,21228,151311,330119,42533
2020/05/06,Salamanca,Valladolid,26,519546,78675,440871,330119,42533
2020/05/06,Salamanca,Ávila,176,157640,16379,141261,330119,42533
2020/05/06,Santa Cruz de Tenerife,Las Palmas de Gran Canaria,22,1120406,148887,971519,1032983,135005
2020/05/06,Santa Cruz de Tenerife,Santa Cruz de Tenerife,121113,1032983,136606,896377,1032983,135005
2020/05/06,Segovia,Valladolid,299,519546,78675,440871,153129,19998
2020/05/06,Segovia,Soria,27,88636,7745,80891,153129,19998
2020/05/06,Segovia,Ávila,84,157640,16379,141261,153129,19998
2020/05/06,Segovia,Segovia,12182,153129,18492,134637,153129,19998
2020/05/06,Segovia,Burgos,110,357072,44244,312828,153129,19998
2020/05/06,Sevilla,Badajoz,48,673559,79321,594238,1942389,266993
2020/05/06,Sevilla,Sevilla,191345,1942389,272438,1669951,1942389,266993
2020/05/06,Sevilla,Cádiz,786,1240155,157669,1082486,1942389,266993
2020/05/06,Sevilla,Huelva,500,521870,66843,455027,1942389,266993
2020/05/06,Sevilla,Córdoba,2102,782979,103118,679861,1942389,266993
2020/05/06,Sevilla,Málaga,167,1661785,205661,1456124,1942389,266993
2020/05/06,Soria,Burgos,83,357072,44244,312828,88636,8636
2020/05/06,Soria,Soria,5667,88636,7745,80891,88636,8636
2020/05/06,Soria,Rioja,27,316798,47464,269334,88636,8636
2020/05/06,Soria,Valladolid,26,519546,78675,440871,88636,8636
2020/05/06,Soria,Segovia,24,153129,18492,134637,88636,8636
2020/05/06,Soria,Zaragoza,140,964724,150050,814674,88636,8636
2020/05/06,Tarragona,Teruel,54,134137,10071,124066,804664,97841
2020/05/06,Tarragona,Barcelona,939,5664579,858371,4806208,804664,97841
2020/05/06,Tarragona,Lleida,20,434930,59880,375050,804664,97841
2020/05/06,Tarragona,Castellón,690,579962,75634,504328,804664,97841
2020/05/06,Tarragona,Tarragona,63517,804664,97955,706709,804664,97841
2020/05/06,Teruel,Valencia,29,2565124,402050,2163074,134137,11699
2020/05/06,Teruel,Zaragoza,191,964724,150050,814674,134137,11699
2020/05/06,Teruel,Teruel,5650,134137,10071,124066,134137,11699
2020/05/06,Teruel,Guadalajara,66,257762,34273,223489,134137,11699
2020/05/06,Teruel,Castellón,88,579962,75634,504328,134137,11699
2020/05/06,Teruel,Tarragona,95,804664,97955,706709,134137,11699
2020/05/06,Toledo,Toledo,37828,694844,81074,613770,694844,77506
2020/05/06,Toledo,Cáceres,308,394151,38876,355275,694844,77506
2020/05/06,Toledo,Madrid,3154,6663394,915223,5748171,694844,77506
2020/05/06,Toledo,Ávila,231,157640,16379,141261,694844,77506
2020/05/06,Toledo,Cuenca,188,196329,19338,176991,694844,77506
2020/05/06,Toledo,Ciudad Real,276,495761,43219,452542,694844,77506
2020/05/06,Valencia,Albacete,347,388167,37343,350824,2565124,391906
2020/05/06,Valencia,Valencia,278369,2565124,402050,2163074,2565124,391906
2020/05/06,Valencia,Castellón,668,579962,75634,504328,2565124,391906
2020/05/06,Valencia,Alicante,991,1858683,254142,1604541,2565124,391906
2020/05/06,Valencia,Cuenca,118,196329,19338,176991,2565124,391906
2020/05/06,Valladolid,Salamanca,30,330119,43421,286698,519546,74720
2020/05/06,Valladolid,Palencia,72,160866,22122,138744,519546,74720
2020/05/06,Valladolid,León,33,460001,63040,396961,519546,74720
2020/05/06,Valladolid,Ávila,28,157640,16379,141261,519546,74720
2020/05/06,Valladolid,Burgos,90,357072,44244,312828,519546,74720
2020/05/06,Valladolid,Zamora,157,172539,21228,151311,519546,74720
2020/05/06,Valladolid,Segovia,308,153129,18492,134637,519546,74720
2020/05/06,Valladolid,Valladolid,56289,519546,78675,440871,519546,74720
2020/05/06,Zamora,León,35,460001,63040,396961,172539,21006
2020/05/06,Zamora,Valladolid,112,519546,78675,440871,172539,21006
2020/05/06,Zamora,Ourense,87,307651,46219,261432,172539,21006
2020/05/06,Zamora,Salamanca,42,330119,43421,286698,172539,21006
2020/05/06,Zamora,Zamora,14307,172539,21228,151311,172539,21006
2020/05/06,Zaragoza,Navarra,549,654183,97936,556247,964724,144842
2020/05/06,Zaragoza,Huesca,317,220461,26271,194190,964724,144842
2020/05/06,Zaragoza,Zaragoza,113703,964724,150050,814674,964724,144842
2020/05/06,Zaragoza,Teruel,320,134137,10071,124066,964724,144842
2020/05/06,Zaragoza,Soria,83,88636,7745,80891,964724,144842
2020/05/06,Zaragoza,Lleida,140,434930,59880,375050,964724,144842
2020/05/07,Albacete,Albacete,22232,388167,35174,352993,388167,35822
2020/05/07,Albacete,Alicante,239,1858683,252192,1606491,388167,35822
2020/05/07,Albacete,Ciudad Real,512,495761,42481,453280,388167,35822
2020/05/07,Albacete,Jaén,46,633564,61207,572357,388167,35822
2020/05/07,Albacete,Valencia,350,2565124,400018,2165106,388167,35822
2020/05/07,Albacete,Cuenca,600,196329,18950,177379,388167,35822
2020/05/07,Albacete,Murcia,428,1493898,205068,1288830,388167,35822
2020/05/07,Alicante,Albacete,288,388167,35174,352993,1858683,256671
2020/05/07,Alicante,Alicante,195544,1858683,252192,1606491,1858683,256671
2020/05/07,Alicante,Valencia,1066,2565124,400018,2165106,1858683,256671
2020/05/07,Alicante,Almería,34,716820,83701,633119,1858683,256671
2020/05/07,Alicante,Murcia,3016,1493898,205068,1288830,1858683,256671
2020/05/07,Almería,Almería,68061,716820,83701,633119,716820,85698
2020/05/07,Almería,Granada,529,914678,115416,799262,716820,85698
2020/05/07,Almería,Murcia,1881,1493898,205068,1288830,716820,85698
2020/05/07,Araba,Rioja,2071,316798,44968,271830,331549,62046
2020/05/07,Araba,Burgos,1828,357072,43626,313446,331549,62046
2020/05/07,Araba,Gipuzkoa,165,723576,98443,625133,331549,62046
2020/05/07,Araba,Araba,45447,331549,55408,276141,331549,62046
2020/05/07,Araba,Navarra,142,654183,96841,557342,331549,62046
2020/05/07,Araba,Bizkaia,1167,1152934,199506,953428,331549,62046
2020/05/07,Asturias,Lugo,888,329587,41377,288210,1022800,136482
2020/05/07,Asturias,Cantabria,237,580795,82165,498630,1022800,136482
2020/05/07,Asturias,Asturias,108738,1022800,137180,885620,1022800,136482
2020/05/07,Asturias,León,35,460001,62811,397190,1022800,136482
2020/05/07,Ávila,Madrid,140,6663394,919288,5744106,157640,17339
2020/05/07,Ávila,Toledo,211,694844,81636,613208,157640,17339
2020/05/07,Ávila,Cáceres,83,394151,40129,354022,157640,17339
2020/05/07,Ávila,Salamanca,227,330119,43214,286905,157640,17339
2020/05/07,Ávila,Ávila,10938,157640,16673,140967,157640,17339
2020/05/07,Ávila,Segovia,111,153129,18805,134324,157640,17339
2020/05/07,Ávila,Valladolid,59,519546,77542,442004,157640,17339
2020/05/07,Badajoz,Sevilla,97,1942389,274802,1667587,673559,78655
2020/05/07,Badajoz,Córdoba,127,782979,101401,681578,673559,78655
2020/05/07,Badajoz,Cáceres,1100,394151,40129,354022,673559,78655
2020/05/07,Badajoz,Ciudad Real,54,495761,42481,453280,673559,78655
2020/05/07,Badajoz,Badajoz,58235,673559,79468,594091,673559,78655
2020/05/07,Badajoz,Huelva,248,521870,67413,454457,673559,78655
2020/05/07,Balears,Valencia,32,2565124,400018,2165106,1149460,139736
2020/05/07,Balears,Balears,120849,1149460,139181,1010279,1149460,139736
2020/05/07,Balears,Barcelona,16,5664579,860061,4804518,1149460,139736
2020/05/07,Barcelona,Lleida,174,434930,59775,375155,5664579,860006
2020/05/07,Barcelona,Girona,2361,771044,88061,682983,5664579,860006
2020/05/07,Barcelona,Tarragona,1569,804664,97819,706845,5664579,860006
2020/05/07,Barcelona,Barcelona,537805,5664579,860061,4804518,5664579,860006
2020/05/07,Bizkaia,Cantabria,2257,580795,82165,498630,1152934,195673
2020/05/07,Bizkaia,Gipuzkoa,983,723576,98443,625133,1152934,195673
2020/05/07,Bizkaia,Bizkaia,151355,1152934,199506,953428,1152934,195673
2020/05/07,Bizkaia,Araba,663,331549,55408,276141,1152934,195673
2020/05/07,Bizkaia,Burgos,78,357072,43626,313446,1152934,195673
2020/05/07,Burgos,Burgos,32093,357072,43626,313446,357072,43865
2020/05/07,Burgos,Araba,1042,331549,55408,276141,357072,43865
2020/05/07,Burgos,Bizkaia,98,1152934,199506,953428,357072,43865
2020/05/07,Burgos,Segovia,33,153129,18805,134324,357072,43865
2020/05/07,Burgos,Soria,34,88636,7767,80869,357072,43865
2020/05/07,Burgos,Valladolid,102,519546,77542,442004,357072,43865
2020/05/07,Burgos,Rioja,76,316798,44968,271830,357072,43865
2020/05/07,Burgos,Cantabria,27,580795,82165,498630,357072,43865
2020/05/07,Burgos,Palencia,224,160866,21491,139375,357072,43865
2020/05/07,Cáceres,Badajoz,1165,673559,79468,594091,394151,40550
2020/05/07,Cáceres,Cáceres,27196,394151,40129,354022,394151,40550
2020/05/07,Cáceres,Ávila,122,157640,16673,140967,394151,40550
2020/05/07,Cáceres,Toledo,189,694844,81636,613208,394151,40550
2020/05/07,Cáceres,Valencia,22,2565124,400018,2165106,394151,40550
2020/05/07,Cádiz,Málaga,1208,1661785,202541,1459244,1240155,162061
2020/05/07,Cádiz,Cádiz,131098,1240155,158120,1082035,1240155,162061
2020/05/07,Cádiz,Almería,27,716820,83701,633119,1240155,162061
2020/05/07,Cádiz,Sevilla,2130,1942389,274802,1667587,1240155,162061
2020/05/07,Cádiz,Huelva,708,521870,67413,454457,1240155,162061
2020/05/07,Cádiz,Ceuta,17,84777,9580,75197,1240155,162061
2020/05/07,Cantabria,Asturias,365,1022800,137180,885620,580795,78461
2020/05/07,Cantabria,Bizkaia,665,1152934,199506,953428,580795,78461
2020/05/07,Cantabria,Cantabria,59352,580795,82165,498630,580795,78461
2020/05/07,Cantabria,Palencia,35,160866,21491,139375,580795,78461
2020/05/07,Castellón,Teruel,75,134137,10060,124077,579962,79483
2020/05/07,Castellón,Castellón,56255,579962,75208,504754,579962,79483
2020/05/07,Castellón,Tarragona,843,804664,97819,706845,579962,79483
2020/05/07,Castellón,Valencia,661,2565124,400018,2165106,579962,79483
2020/05/07,Ceuta,Ceuta,9179,84777,9580,75197,84777,9602
2020/05/07,Ceuta,Cádiz,21,1240155,158120,1082035,84777,9602
2020/05/07,Ciudad Real,Albacete,456,388167,35174,352993,495761,39628
2020/05/07,Ciudad Real,Badajoz,62,673559,79468,594091,495761,39628
2020/05/07,Ciudad Real,Córdoba,389,782979,101401,681578,495761,39628
2020/05/07,Ciudad Real,Cuenca,32,196329,18950,177379,495761,39628
2020/05/07,Ciudad Real,Jaén,18,633564,61207,572357,495761,39628
2020/05/07,Ciudad Real,Ciudad Real,25222,495761,42481,453280,495761,39628
2020/05/07,Ciudad Real,Toledo,333,694844,81636,613208,495761,39628
2020/05/07,Córdoba,Córdoba,71702,782979,101401,681578,782979,99114
2020/05/07,Córdoba,Badajoz,95,673559,79468,594091,782979,99114
2020/05/07,Córdoba,Málaga,246,1661785,202541,1459244,782979,99114
2020/05/07,Córdoba,Ciudad Real,234,495761,42481,453280,782979,99114
2020/05/07,Córdoba,Sevilla,1612,1942389,274802,1667587,782979,99114
2020/05/07,Córdoba,Jaén,618,633564,61207,572357,782979,99114
2020/05/07,Córdoba,Granada,84,914678,115416,799262,782979,99114
2020/05/07,Coruña,Lugo,747,329587,41377,288210,1119596,165200
2020/05/07,Coruña,Pontevedra,4557,942665,142949,799716,1119596,165200
2020/05/07,Coruña,Coruña,124366,1119596,164358,955238,1119596,165200
2020/05/07,Cuenca,Toledo,182,694844,81636,613208,196329,19982
2020/05/07,Cuenca,Valencia,94,2565124,400018,2165106,196329,19982
2020/05/07,Cuenca,Albacete,762,388167,35174,352993,196329,19982
2020/05/07,Cuenca,Ciudad Real,78,495761,42481,453280,196329,19982
2020/05/07,Cuenca,Cuenca,9805,196329,18950,177379,196329,19982
2020/05/07,Cuenca,Guadalajara,22,257762,34284,223478,196329,19982
2020/05/07,Cuenca,Madrid,53,6663394,919288,5744106,196329,19982
2020/05/07,Gipuzkoa,Araba,195,331549,55408,276141,723576,102392
2020/05/07,Gipuzkoa,Gipuzkoa,75038,723576,98443,625133,723576,102392
2020/05/07,Gipuzkoa,Navarra,291,654183,96841,557342,723576,102392
2020/05/07,Gipuzkoa,Bizkaia,1354,1152934,199506,953428,723576,102392
2020/05/07,Girona,Barcelona,2376,5664579,860061,4804518,771044,93234
2020/05/07,Girona,Lleida,172,434930,59775,375155,771044,93234
2020/05/07,Girona,Girona,58650,771044,88061,682983,771044,93234
2020/05/07,Granada,Málaga,109,1661785,202541,1459244,914678,112263
2020/05/07,Granada,Córdoba,243,782979,101401,681578,914678,112263
2020/05/07,Granada,Murcia,65,1493898,205068,1288830,914678,112263
2020/05/07,Granada,Jaén,409,633564,61207,572357,914678,112263
2020/05/07,Granada,Granada,83345,914678,115416,799262,914678,112263
2020/05/07,Granada,Almería,446,716820,83701,633119,914678,112263
2020/05/07,Guadalajara,Madrid,2075,6663394,919288,5744106,257762,35585
2020/05/07,Guadalajara,Guadalajara,19420,257762,34284,223478,257762,35585
2020/05/07,Guadalajara,Teruel,23,134137,10060,124077,257762,35585
2020/05/07,Guadalajara,Cuenca,38,196329,18950,177379,257762,35585
2020/05/07,Huelva,Cádiz,509,1240155,158120,1082035,521870,70653
2020/05/07,Huelva,Badajoz,332,673559,79468,594091,521870,70653
2020/05/07,Huelva,Sevilla,1567,1942389,274802,1667587,521870,70653
2020/05/07,Huelva,Huelva,52300,521870,67413,454457,521870,70653
2020/05/07,Huesca,Lleida,1034,434930,59775,375155,220461,29763
2020/05/07,Huesca,Zaragoza,255,964724,149653,815071,220461,29763
2020/05/07,Huesca,Huesca,18205,220461,26567,193894,220461,29763
2020/05/07,Jaén,Jaén,41663,633564,61207,572357,633564,60193
2020/05/07,Jaén,Granada,343,914678,115416,799262,633564,60193
2020/05/07,Jaén,Córdoba,746,782979,101401,681578,633564,60193
2020/05/07,Las Palmas de Gran Canaria,Las Palmas de Gran Canaria,133224,1120406,146544,973862,1120406,145508
2020/05/07,Las Palmas de Gran Canaria,Sevilla,40,1942389,274802,1667587,1120406,145508
2020/05/07,León,Palencia,41,160866,21491,139375,460001,62952
2020/05/07,León,Asturias,32,1022800,137180,885620,460001,62952
2020/05/07,León,Zamora,161,172539,21018,151521,460001,62952
2020/05/07,León,Valladolid,24,519546,77542,442004,460001,62952
2020/05/07,León,León,47271,460001,62811,397190,460001,62952
2020/05/07,León,Ourense,327,307651,46786,260865,460001,62952
2020/05/07,Lleida,Barcelona,304,5664579,860061,4804518,434930,57487
2020/05/07,Lleida,Huesca,620,220461,26567,193894,434930,57487
2020/05/07,Lleida,Lleida,38157,434930,59775,375155,434930,57487
2020/05/07,Lleida,Zaragoza,139,964724,149653,815071,434930,57487
2020/05/07,Lleida,Girona,185,771044,88061,682983,434930,57487
2020/05/07,Lleida,Tarragona,52,804664,97819,706845,434930,57487
2020/05/07,Lugo,Lugo,29387,329587,41377,288210,329587,42854
2020/05/07,Lugo,Coruña,603,1119596,164358,955238,329587,42854
2020/05/07,Lugo,Ourense,191,307651,46786,260865,329587,42854
2020/05/07,Lugo,Pontevedra,27,942665,142949,799716,329587,42854
2020/05/07,Lugo,Asturias,708,1022800,137180,885620,329587,42854
2020/05/07,Madrid,Toledo,3425,694844,81636,613208,6663394,921476
2020/05/07,Madrid,Madrid,524305,6663394,919288,5744106,6663394,921476
2020/05/07,Madrid,Cuenca,96,196329,18950,177379,6663394,921476
2020/05/07,Madrid,Guadalajara,2638,257762,34284,223478,6663394,921476
2020/05/07,Madrid,Ávila,241,157640,16673,140967,6663394,921476
2020/05/07,Málaga,Granada,248,914678,115416,799262,1661785,207276
2020/05/07,Málaga,Cádiz,1024,1240155,158120,1082035,1661785,207276
2020/05/07,Málaga,Córdoba,301,782979,101401,681578,1661785,207276
2020/05/07,Málaga,Sevilla,285,1942389,274802,1667587,1661785,207276
2020/05/07,Málaga,Málaga,164373,1661785,202541,1459244,1661785,207276
2020/05/07,Melilla,Melilla,11517,86487,11742,74745,86487,11643
2020/05/07,Murcia,Alicante,2468,1858683,252192,1606491,1493898,201656
2020/05/07,Murcia,Granada,18,914678,115416,799262,1493898,201656
2020/05/07,Murcia,Albacete,524,388167,35174,352993,1493898,201656
2020/05/07,Murcia,Almería,1230,716820,83701,633119,1493898,201656
2020/05/07,Murcia,Murcia,156134,1493898,205068,1288830,1493898,201656
2020/05/07,Navarra,Gipuzkoa,356,723576,98443,625133,654183,97791
2020/05/07,Navarra,Rioja,2474,316798,44968,271830,654183,97791
2020/05/07,Navarra,Araba,47,331549,55408,276141,654183,97791
2020/05/07,Navarra,Navarra,69386,654183,96841,557342,654183,97791
2020/05/07,Navarra,Zaragoza,487,964724,149653,815071,654183,97791
2020/05/07,Ourense,León,263,460001,62811,397190,307651,47070
2020/05/07,Ourense,Pontevedra,178,942665,142949,799716,307651,47070
2020/05/07,Ourense,Lugo,137,329587,41377,288210,307651,47070
2020/05/07,Ourense,Zamora,68,172539,21018,151521,307651,47070
2020/05/07,Ourense,Ourense,36010,307651,46786,260865,307651,47070
2020/05/07,Palencia,Valladolid,292,519546,77542,442004,160866,22915
2020/05/07,Palencia,Cantabria,142,580795,82165,498630,160866,22915
2020/05/07,Palencia,Burgos,191,357072,43626,313446,160866,22915
2020/05/07,Palencia,León,27,460001,62811,397190,160866,22915
2020/05/07,Palencia,Palencia,15396,160866,21491,139375,160866,22915
2020/05/07,Pontevedra,Pontevedra,110000,942665,142949,799716,942665,142938
2020/05/07,Pontevedra,Lugo,25,329587,41377,288210,942665,142938
2020/05/07,Pontevedra,Ourense,210,307651,46786,260865,942665,142938
2020/05/07,Pontevedra,Coruña,4329,1119596,164358,955238,942665,142938
2020/05/07,Rioja,Navarra,1843,654183,96841,557342,316798,42726
2020/05/07,Rioja,Rioja,32097,316798,44968,271830,316798,42726
2020/05/07,Rioja,Araba,716,331549,55408,276141,316798,42726
2020/05/07,Rioja,Burgos,56,357072,43626,313446,316798,42726
2020/05/07,Salamanca,Zamora,53,172539,21018,151521,330119,42565
2020/05/07,Salamanca,Valladolid,33,519546,77542,442004,330119,42565
2020/05/07,Salamanca,Ávila,173,157640,16673,140967,330119,42565
2020/05/07,Salamanca,Salamanca,33639,330119,43214,286905,330119,42565
2020/05/07,Santa Cruz de Tenerife,Santa Cruz de Tenerife,118579,1032983,132809,900174,1032983,132666
2020/05/07,Segovia,Ávila,194,157640,16673,140967,153129,20496
2020/05/07,Segovia,Valladolid,305,519546,77542,442004,153129,20496
2020/05/07,Segovia,Segovia,12434,153129,18805,134324,153129,20496
2020/05/07,Segovia,Burgos,167,357072,43626,313446,153129,20496
2020/05/07,Sevilla,Cádiz,893,1240155,158120,1082035,1942389,267499
2020/05/07,Sevilla,Córdoba,1875,782979,101401,681578,1942389,267499
2020/05/07,Sevilla,Huelva,636,521870,67413,454457,1942389,267499
2020/05/07,Sevilla,Sevilla,191848,1942389,274802,1667587,1942389,267499
2020/05/07,Sevilla,Badajoz,26,673559,79468,594091,1942389,267499
2020/05/07,Sevilla,Málaga,194,1661785,202541,1459244,1942389,267499
2020/05/07,Soria,Burgos,57,357072,43626,313446,88636,8644
2020/05/07,Soria,Soria,5661,88636,7767,80869,88636,8644
2020/05/07,Soria,Segovia,24,153129,18805,134324,88636,8644
2020/05/07,Soria,Valladolid,22,519546,77542,442004,88636,8644
2020/05/07,Soria,Zaragoza,159,964724,149653,815071,88636,8644
2020/05/07,Tarragona,Teruel,58,134137,10060,124077,804664,97304
2020/05/07,Tarragona,Lleida,22,434930,59775,375155,804664,97304
2020/05/07,Tarragona,Barcelona,836,5664579,860061,4804518,804664,97304
2020/05/07,Tarragona,Castellón,735,579962,75208,504754,804664,97304
2020/05/07,Tarragona,Tarragona,64432,804664,97819,706845,804664,97304
2020/05/07,Teruel,Teruel,5712,134137,10060,124077,134137,11493
2020/05/07,Teruel,Castellón,101,579962,75208,504754,134137,11493
2020/05/07,Teruel,Zaragoza,244,964724,149653,815071,134137,11493
2020/05/07,Teruel,Tarragona,87,804664,97819,706845,134137,11493
2020/05/07,Toledo,Cáceres,248,394151,40129,354022,694844,77931
2020/05/07,Toledo,Madrid,3103,6663394,919288,5744106,694844,77931
2020/05/07,Toledo,Toledo,38360,694844,81636,613208,694844,77931
2020/05/07,Toledo,Ávila,268,157640,16673,140967,694844,77931
2020/05/07,Toledo,Cuenca,107,196329,18950,177379,694844,77931
2020/05/07,Toledo,Ciudad Real,251,495761,42481,453280,694844,77931
2020/05/07,Valencia,Valencia,275974,2565124,400018,2165106,2565124,390902
2020/05/07,Valencia,Alicante,1008,1858683,252192,1606491,2565124,390902
2020/05/07,Valencia,Cuenca,87,196329,18950,177379,2565124,390902
2020/05/07,Valencia,Castellón,696,579962,75208,504754,2565124,390902
2020/05/07,Valencia,Albacete,304,388167,35174,352993,2565124,390902
2020/05/07,Valladolid,Soria,32,88636,7767,80869,519546,74485
2020/05/07,Valladolid,León,40,460001,62811,397190,519546,74485
2020/05/07,Valladolid,Valladolid,55735,519546,77542,442004,519546,74485
2020/05/07,Valladolid,Zamora,206,172539,21018,151521,519546,74485
2020/05/07,Valladolid,Segovia,339,153129,18805,134324,519546,74485
2020/05/07,Valladolid,Palencia,58,160866,21491,139375,519546,74485
2020/05/07,Valladolid,Burgos,106,357072,43626,313446,519546,74485
2020/05/07,Valladolid,Ávila,23,157640,16673,140967,519546,74485
2020/05/07,Zamora,León,23,460001,62811,397190,172539,20666
2020/05/07,Zamora,Zamora,14149,172539,21018,151521,172539,20666
2020/05/07,Zamora,Valladolid,96,519546,77542,442004,172539,20666
2020/05/07,Zamora,Ourense,48,307651,46786,260865,172539,20666
2020/05/07,Zaragoza,Teruel,278,134137,10060,124077,964724,144178
2020/05/07,Zaragoza,Zaragoza,114022,964724,149653,815071,964724,144178
2020/05/07,Zaragoza,Huesca,286,220461,26567,193894,964724,144178
2020/05/07,Zaragoza,Soria,68,88636,7767,80869,964724,144178
2020/05/07,Zaragoza,Lleida,128,434930,59775,375155,964724,144178
2020/05/07,Zaragoza,Navarra,526,654183,96841,557342,964724,144178
2020/05/08,Albacete,Alicante,219,1858683,257755,1600928,388167,35890
2020/05/08,Albacete,Valencia,448,2565124,405732,2159392,388167,35890
2020/05/08,Albacete,Ciudad Real,582,495761,42076,453685,388167,35890
2020/05/08,Albacete,Cuenca,576,196329,18961,177368,388167,35890
2020/05/08,Albacete,Murcia,555,1493898,207125,1286773,388167,35890
2020/05/08,Albacete,Jaén,67,633564,61903,571661,388167,35890
2020/05/08,Albacete,Albacete,22527,388167,35164,353003,388167,35890
2020/05/08,Alicante,Valencia,1130,2565124,405732,2159392,1858683,261946
2020/05/08,Alicante,Albacete,356,388167,35164,353003,1858683,261946
2020/05/08,Alicante,Murcia,3253,1493898,207125,1286773,1858683,261946
2020/05/08,Alicante,Alicante,202821,1858683,257755,1600928,1858683,261946
2020/05/08,Almería,Granada,482,914678,116544,798134,716820,88163
2020/05/08,Almería,Murcia,2114,1493898,207125,1286773,716820,88163
2020/05/08,Almería,Almería,71377,716820,86271,630549,716820,88163
2020/05/08,Almería,Córdoba,16,782979,102334,680645,716820,88163
2020/05/08,Araba,Araba,46061,331549,55772,275777,331549,62121
2020/05/08,Araba,Rioja,2004,316798,44861,271937,331549,62121
2020/05/08,Araba,Gipuzkoa,142,723576,101397,622179,331549,62121
2020/05/08,Araba,Bizkaia,1086,1152934,202895,950039,331549,62121
2020/05/08,Araba,Burgos,1828,357072,42637,314435,331549,62121
2020/05/08,Araba,Navarra,113,654183,97128,557055,331549,62121
2020/05/08,Asturias,León,30,460001,62821,397180,1022800,135576
2020/05/08,Asturias,Lugo,888,329587,41198,288389,1022800,135576
2020/05/08,Asturias,Cantabria,219,580795,83816,496979,1022800,135576
2020/05/08,Asturias,Asturias,108342,1022800,135548,887252,1022800,135576
2020/05/08,Ávila,Madrid,125,6663394,931923,5731471,157640,16641
2020/05/08,Ávila,Toledo,191,694844,81138,613706,157640,16641
2020/05/08,Ávila,Ávila,10596,157640,16156,141484,157640,16641
2020/05/08,Ávila,Segovia,140,153129,18770,134359,157640,16641
2020/05/08,Ávila,Valladolid,26,519546,77405,442141,157640,16641
2020/05/08,Ávila,Cáceres,115,394151,40335,353816,157640,16641
2020/05/08,Ávila,Salamanca,216,330119,44218,285901,157640,16641
2020/05/08,Badajoz,Badajoz,58866,673559,79943,593616,673559,78423
2020/05/08,Badajoz,Huelva,215,521870,67328,454542,673559,78423
2020/05/08,Badajoz,Almería,18,716820,86271,630549,673559,78423
2020/05/08,Badajoz,Cáceres,1104,394151,40335,353816,673559,78423
2020/05/08,Badajoz,Ciudad Real,46,495761,42076,453685,673559,78423
2020/05/08,Badajoz,Córdoba,135,782979,102334,680645,673559,78423
2020/05/08,Badajoz,Sevilla,55,1942389,276144,1666245,673559,78423
2020/05/08,Balears,Valencia,37,2565124,405732,2159392,1149460,139553
2020/05/08,Balears,Barcelona,18,5664579,865076,4799503,1149460,139553
2020/05/08,Balears,Balears,119932,1149460,138749,1010711,1149460,139553
2020/05/08,Barcelona,Lleida,172,434930,61230,373700,5664579,866078
2020/05/08,Barcelona,Barcelona,546710,5664579,865076,4799503,5664579,866078
2020/05/08,Barcelona,Tarragona,1569,804664,99984,704680,5664579,866078
2020/05/08,Barcelona,Girona,2753,771044,88905,682139,5664579,866078
2020/05/08,Bizkaia,Gipuzkoa,1001,723576,101397,622179,1152934,199221
2020/05/08,Bizkaia,Araba,723,331549,55772,275777,1152934,199221
2020/05/08,Bizkaia,Burgos,71,357072,42637,314435,1152934,199221
2020/05/08,Bizkaia,Bizkaia,155599,1152934,202895,950039,1152934,199221
2020/05/08,Bizkaia,Cantabria,2101,580795,83816,496979,1152934,199221
2020/05/08,Burgos,Bizkaia,135,1152934,202895,950039,357072,42654
2020/05/08,Burgos,Segovia,57,153129,18770,134359,357072,42654
2020/05/08,Burgos,Valladolid,58,519546,77405,442141,357072,42654
2020/05/08,Burgos,Cantabria,17,580795,83816,496979,357072,42654
2020/05/08,Burgos,Soria,25,88636,7598,81038,357072,42654
2020/05/08,Burgos,Burgos,31472,357072,42637,314435,357072,42654
2020/05/08,Burgos,Araba,918,331549,55772,275777,357072,42654
2020/05/08,Burgos,Rioja,72,316798,44861,271937,357072,42654
2020/05/08,Burgos,Palencia,186,160866,21439,139427,357072,42654
2020/05/08,Cáceres,Cáceres,27867,394151,40335,353816,394151,40830
2020/05/08,Cáceres,Valencia,20,2565124,405732,2159392,394151,40830
2020/05/08,Cáceres,Badajoz,1153,673559,79943,593616,394151,40830
2020/05/08,Cáceres,Ávila,150,157640,16156,141484,394151,40830
2020/05/08,Cáceres,Toledo,177,694844,81138,613706,394151,40830
2020/05/08,Cádiz,Huelva,633,521870,67328,454542,1240155,160351
2020/05/08,Cádiz,Málaga,1192,1661785,206656,1455129,1240155,160351
2020/05/08,Cádiz,Sevilla,955,1942389,276144,1666245,1240155,160351
2020/05/08,Cádiz,Cádiz,132151,1240155,159051,1081104,1240155,160351
2020/05/08,Cantabria,Bizkaia,581,1152934,202895,950039,580795,80027
2020/05/08,Cantabria,Asturias,208,1022800,135548,887252,580795,80027
2020/05/08,Cantabria,Palencia,56,160866,21439,139427,580795,80027
2020/05/08,Cantabria,Cantabria,61110,580795,83816,496979,580795,80027
2020/05/08,Castellón,Alicante,16,1858683,257755,1600928,579962,78370
2020/05/08,Castellón,Valencia,670,2565124,405732,2159392,579962,78370
2020/05/08,Castellón,Tarragona,747,804664,99984,704680,579962,78370
2020/05/08,Castellón,Castellón,55705,579962,74853,505109,579962,78370
2020/05/08,Castellón,Teruel,59,134137,10025,124112,579962,78370
2020/05/08,Ceuta,Cádiz,40,1240155,159051,1081104,84777,9902
2020/05/08,Ceuta,Ceuta,9482,84777,9890,74887,84777,9902
2020/05/08,Ciudad Real,Córdoba,354,782979,102334,680645,495761,38964
2020/05/08,Ciudad Real,Ciudad Real,25429,495761,42076,453685,495761,38964
2020/05/08,Ciudad Real,Cuenca,32,196329,18961,177368,495761,38964
2020/05/08,Ciudad Real,Albacete,398,388167,35164,353003,495761,38964
2020/05/08,Ciudad Real,Badajoz,62,673559,79943,593616,495761,38964
2020/05/08,Ciudad Real,Toledo,195,694844,81138,613706,495761,38964
2020/05/08,Córdoba,Sevilla,1652,1942389,276144,1666245,782979,100120
2020/05/08,Córdoba,Badajoz,174,673559,79943,593616,782979,100120
2020/05/08,Córdoba,Ciudad Real,260,495761,42076,453685,782979,100120
2020/05/08,Córdoba,Granada,201,914678,116544,798134,782979,100120
2020/05/08,Córdoba,Málaga,249,1661785,206656,1455129,782979,100120
2020/05/08,Córdoba,Jaén,681,633564,61903,571661,782979,100120
2020/05/08,Córdoba,Córdoba,73897,782979,102334,680645,782979,100120
2020/05/08,Coruña,Lugo,656,329587,41198,288389,1119596,167485
2020/05/08,Coruña,Coruña,126793,1119596,165569,954027,1119596,167485
2020/05/08,Coruña,Pontevedra,4790,942665,146535,796130,1119596,167485
2020/05/08,Cuenca,Albacete,653,388167,35164,353003,196329,19566
2020/05/08,Cuenca,Guadalajara,61,257762,34056,223706,196329,19566
2020/05/08,Cuenca,Cuenca,10035,196329,18961,177368,196329,19566
2020/05/08,Cuenca,Toledo,156,694844,81138,613706,196329,19566
2020/05/08,Cuenca,Valencia,70,2565124,405732,2159392,196329,19566
2020/05/08,Cuenca,Ciudad Real,83,495761,42076,453685,196329,19566
2020/05/08,Cuenca,Madrid,67,6663394,931923,5731471,196329,19566
2020/05/08,Gipuzkoa,Araba,152,331549,55772,275777,723576,104150
2020/05/08,Gipuzkoa,Navarra,364,654183,97128,557055,723576,104150
2020/05/08,Gipuzkoa,Bizkaia,1335,1152934,202895,950039,723576,104150
2020/05/08,Gipuzkoa,Gipuzkoa,77392,723576,101397,622179,723576,104150
2020/05/08,Girona,Girona,59842,771044,88905,682139,771044,92202
2020/05/08,Girona,Barcelona,2330,5664579,865076,4799503,771044,92202
2020/05/08,Girona,Lleida,172,434930,61230,373700,771044,92202
2020/05/08,Granada,Granada,85504,914678,116544,798134,914678,114663
2020/05/08,Granada,Málaga,165,1661785,206656,1455129,914678,114663
2020/05/08,Granada,Almería,441,716820,86271,630549,914678,114663
2020/05/08,Granada,Murcia,38,1493898,207125,1286773,914678,114663
2020/05/08,Granada,Córdoba,197,782979,102334,680645,914678,114663
2020/05/08,Granada,Jaén,357,633564,61903,571661,914678,114663
2020/05/08,Guadalajara,Cuenca,49,196329,18961,177368,257762,35561
2020/05/08,Guadalajara,Teruel,30,134137,10025,124112,257762,35561
2020/05/08,Guadalajara,Guadalajara,19725,257762,34056,223706,257762,35561
2020/05/08,Guadalajara,Madrid,2087,6663394,931923,5731471,257762,35561
2020/05/08,Huelva,Huelva,52709,521870,67328,454542,521870,71327
2020/05/08,Huelva,Sevilla,1616,1942389,276144,1666245,521870,71327
2020/05/08,Huelva,Cádiz,546,1240155,159051,1081104,521870,71327
2020/05/08,Huelva,Badajoz,435,673559,79943,593616,521870,71327
2020/05/08,Huelva,Córdoba,16,782979,102334,680645,521870,71327
2020/05/08,Huesca,Huesca,18665,220461,26779,193682,220461,29501
2020/05/08,Huesca,Zaragoza,262,964724,152367,812357,220461,29501
2020/05/08,Huesca,Lleida,1125,434930,61230,373700,220461,29501
2020/05/08,Jaén,Granada,250,914678,116544,798134,633564,60519
2020/05/08,Jaén,Jaén,42688,633564,61903,571661,633564,60519
2020/05/08,Jaén,Córdoba,765,782979,102334,680645,633564,60519
2020/05/08,Jaén,Albacete,16,388167,35164,353003,633564,60519
2020/05/08,Las Palmas de Gran Canaria,Las Palmas de Gran Canaria,135255,1120406,148152,972254,1120406,147359
2020/05/08,León,Asturias,47,1022800,135548,887252,460001,62779
2020/05/08,León,León,47621,460001,62821,397180,460001,62779
2020/05/08,León,Zamora,245,172539,21077,151462,460001,62779
2020/05/08,León,Palencia,121,160866,21439,139427,460001,62779
2020/05/08,León,Ourense,333,307651,46547,261104,460001,62779
2020/05/08,León,Valladolid,180,519546,77405,442141,460001,62779
2020/05/08,Lleida,Barcelona,161,5664579,865076,4799503,434930,58342
2020/05/08,Lleida,Zaragoza,146,964724,152367,812357,434930,58342
2020/05/08,Lleida,Lleida,39813,434930,61230,373700,434930,58342
2020/05/08,Lleida,Girona,177,771044,88905,682139,434930,58342
2020/05/08,Lleida,Huesca,651,220461,26779,193682,434930,58342
2020/05/08,Lugo,Lugo,29362,329587,41198,288389,329587,42526
2020/05/08,Lugo,Coruña,528,1119596,165569,954027,329587,42526
2020/05/08,Lugo,Asturias,694,1022800,135548,887252,329587,42526
2020/05/08,Lugo,Ourense,184,307651,46547,261104,329587,42526
2020/05/08,Lugo,Córdoba,16,782979,102334,680645,329587,42526
2020/05/08,Madrid,Cuenca,90,196329,18961,177368,6663394,935306
2020/05/08,Madrid,Guadalajara,2607,257762,34056,223706,6663394,935306
2020/05/08,Madrid,Madrid,539588,6663394,931923,5731471,6663394,935306
2020/05/08,Madrid,Ciudad Real,16,495761,42076,453685,6663394,935306
2020/05/08,Madrid,Segovia,17,153129,18770,134359,6663394,935306
2020/05/08,Madrid,Toledo,3642,694844,81138,613706,6663394,935306
2020/05/08,Madrid,Ávila,189,157640,16156,141484,6663394,935306
2020/05/08,Málaga,Granada,284,914678,116544,798134,1661785,210291
2020/05/08,Málaga,Córdoba,333,782979,102334,680645,1661785,210291
2020/05/08,Málaga,Málaga,169071,1661785,206656,1455129,1661785,210291
2020/05/08,Málaga,Cádiz,1119,1240155,159051,1081104,1661785,210291
2020/05/08,Málaga,Sevilla,332,1942389,276144,1666245,1661785,210291
2020/05/08,Melilla,Melilla,12059,86487,12244,74243,86487,12223
2020/05/08,Murcia,Murcia,159771,1493898,207125,1286773,1493898,204224
2020/05/08,Murcia,Granada,83,914678,116544,798134,1493898,204224
2020/05/08,Murcia,Alicante,2494,1858683,257755,1600928,1493898,204224
2020/05/08,Murcia,Almería,1331,716820,86271,630549,1493898,204224
2020/05/08,Murcia,Albacete,459,388167,35164,353003,1493898,204224
2020/05/08,Navarra,Zaragoza,614,964724,152367,812357,654183,97781
2020/05/08,Navarra,Araba,84,331549,55772,275777,654183,97781
2020/05/08,Navarra,Rioja,2489,316798,44861,271937,654183,97781
2020/05/08,Navarra,Gipuzkoa,349,723576,101397,622179,654183,97781
2020/05/08,Navarra,Navarra,69925,654183,97128,557055,654183,97781
2020/05/08,Ourense,Ourense,35966,307651,46547,261104,307651,46646
2020/05/08,Ourense,Zamora,62,172539,21077,151462,307651,46646
2020/05/08,Ourense,Lugo,177,329587,41198,288389,307651,46646
2020/05/08,Ourense,Pontevedra,194,942665,146535,796130,307651,46646
2020/05/08,Ourense,León,309,460001,62821,397180,307651,46646
2020/05/08,Palencia,Valladolid,189,519546,77405,442141,160866,22820
2020/05/08,Palencia,Cantabria,152,580795,83816,496979,160866,22820
2020/05/08,Palencia,Palencia,15647,160866,21439,139427,160866,22820
2020/05/08,Palencia,Burgos,228,357072,42637,314435,160866,22820
2020/05/08,Palencia,León,24,460001,62821,397180,160866,22820
2020/05/08,Pontevedra,Lugo,58,329587,41198,288389,942665,145618
2020/05/08,Pontevedra,Pontevedra,113668,942665,146535,796130,942665,145618
2020/05/08,Pontevedra,Coruña,3938,1119596,165569,954027,942665,145618
2020/05/08,Pontevedra,Ourense,169,307651,46547,261104,942665,145618
2020/05/08,Rioja,Navarra,1902,654183,97128,557055,316798,42428
2020/05/08,Rioja,Araba,683,331549,55772,275777,316798,42428
2020/05/08,Rioja,Burgos,48,357072,42637,314435,316798,42428
2020/05/08,Rioja,Rioja,32238,316798,44861,271937,316798,42428
2020/05/08,Salamanca,Salamanca,34826,330119,44218,285901,330119,43550
2020/05/08,Salamanca,Zamora,87,172539,21077,151462,330119,43550
2020/05/08,Salamanca,Ávila,190,157640,16156,141484,330119,43550
2020/05/08,Santa Cruz de Tenerife,Santa Cruz de Tenerife,121412,1032983,135621,897362,1032983,135436
2020/05/08,Santa Cruz de Tenerife,Las Palmas de Gran Canaria,68,1120406,148152,972254,1032983,135436
2020/05/08,Santa Cruz de Tenerife,Barcelona,18,5664579,865076,4799503,1032983,135436
2020/05/08,Segovia,Ávila,88,157640,16156,141484,153129,19958
2020/05/08,Segovia,Valladolid,352,519546,77405,442141,153129,19958
2020/05/08,Segovia,Burgos,77,357072,42637,314435,153129,19958
2020/05/08,Segovia,Segovia,12541,153129,18770,134359,153129,19958
2020/05/08,Sevilla,Badajoz,80,673559,79943,593616,1942389,272134
2020/05/08,Sevilla,Sevilla,196867,1942389,276144,1666245,1942389,272134
2020/05/08,Sevilla,Huelva,620,521870,67328,454542,1942389,272134
2020/05/08,Sevilla,Málaga,122,1661785,206656,1455129,1942389,272134
2020/05/08,Sevilla,Cádiz,1285,1240155,159051,1081104,1942389,272134
2020/05/08,Sevilla,Córdoba,2128,782979,102334,680645,1942389,272134
2020/05/08,Soria,Valladolid,47,519546,77405,442141,88636,8324
2020/05/08,Soria,Soria,5668,88636,7598,81038,88636,8324
2020/05/08,Soria,Burgos,28,357072,42637,314435,88636,8324
2020/05/08,Soria,Segovia,23,153129,18770,134359,88636,8324
2020/05/08,Soria,Zaragoza,121,964724,152367,812357,88636,8324
2020/05/08,Tarragona,Teruel,74,134137,10025,124112,804664,99656
2020/05/08,Tarragona,Castellón,747,579962,74853,505109,804664,99656
2020/05/08,Tarragona,Tarragona,67086,804664,99984,704680,804664,99656
2020/05/08,Tarragona,Lleida,20,434930,61230,373700,804664,99656
2020/05/08,Tarragona,Barcelona,949,5664579,865076,4799503,804664,99656
2020/05/08,Teruel,Valencia,26,2565124,405732,2159392,134137,11232
2020/05/08,Teruel,Teruel,5707,134137,10025,124112,134137,11232
2020/05/08,Teruel,Castellón,75,579962,74853,505109,134137,11232
2020/05/08,Teruel,Zaragoza,205,964724,152367,812357,134137,11232
2020/05/08,Teruel,Tarragona,103,804664,99984,704680,134137,11232
2020/05/08,Toledo,Cáceres,129,394151,40335,353816,694844,78694
2020/05/08,Toledo,Madrid,3587,6663394,931923,5731471,694844,78694
2020/05/08,Toledo,Ávila,204,157640,16156,141484,694844,78694
2020/05/08,Toledo,Toledo,38930,694844,81138,613706,694844,78694
2020/05/08,Toledo,Cuenca,122,196329,18961,177368,694844,78694
2020/05/08,Toledo,Córdoba,16,782979,102334,680645,694844,78694
2020/05/08,Toledo,Ciudad Real,304,495761,42076,453685,694844,78694
2020/05/08,Valencia,Alicante,972,1858683,257755,1600928,2565124,397716
2020/05/08,Valencia,Cuenca,91,196329,18961,177368,2565124,397716
2020/05/08,Valencia,Murcia,28,1493898,207125,1286773,2565124,397716
2020/05/08,Valencia,Valencia,284115,2565124,405732,2159392,2565124,397716
2020/05/08,Valencia,Albacete,390,388167,35164,353003,2565124,397716
2020/05/08,Valencia,Castellón,650,579962,74853,505109,2565124,397716
2020/05/08,Valladolid,León,29,460001,62821,397180,519546,74873
2020/05/08,Valladolid,Salamanca,54,330119,44218,285901,519546,74873
2020/05/08,Valladolid,Zamora,137,172539,21077,151462,519546,74873
2020/05/08,Valladolid,Valladolid,56415,519546,77405,442141,519546,74873
2020/05/08,Valladolid,Burgos,73,357072,42637,314435,519546,74873
2020/05/08,Valladolid,Palencia,22,160866,21439,139427,519546,74873
2020/05/08,Valladolid,Soria,28,88636,7598,81038,519546,74873
2020/05/08,Valladolid,Segovia,269,153129,18770,134359,519546,74873
2020/05/08,Zamora,Salamanca,105,330119,44218,285901,172539,20773
2020/05/08,Zamora,Valladolid,88,519546,77405,442141,172539,20773
2020/05/08,Zamora,Ourense,34,307651,46547,261104,172539,20773
2020/05/08,Zamora,León,138,460001,62821,397180,172539,20773
2020/05/08,Zamora,Zamora,14425,172539,21077,151462,172539,20773
2020/05/08,Zaragoza,Lleida,108,434930,61230,373700,964724,147189
2020/05/08,Zaragoza,Teruel,217,134137,10025,124112,964724,147189
2020/05/08,Zaragoza,Soria,93,88636,7598,81038,964724,147189
2020/05/08,Zaragoza,Navarra,495,654183,97128,557055,964724,147189
2020/05/08,Zaragoza,Huesca,321,220461,26779,193682,964724,147189
2020/05/08,Zaragoza,Zaragoza,117541,964724,152367,812357,964724,147189
2020/05/09,Albacete,Albacete,12980,388167,20164,368003,388167,20501
2020/05/09,Albacete,Ciudad Real,292,495761,23401,472360,388167,20501
2020/05/09,Albacete,Cuenca,241,196329,10700,185629,388167,20501
2020/05/09,Albacete,Valencia,111,2565124,216289,2348835,388167,20501
2020/05/09,Albacete,Murcia,394,1493898,121186,1372712,388167,20501
2020/05/09,Albacete,Jaén,62,633564,37889,595675,388167,20501
2020/05/09,Albacete,Alicante,111,1858683,138137,1720546,388167,20501
2020/05/09,Alicante,Albacete,102,388167,20164,368003,1858683,139295
2020/05/09,Alicante,Murcia,1486,1493898,121186,1372712,1858683,139295
2020/05/09,Alicante,Alicante,108830,1858683,138137,1720546,1858683,139295
2020/05/09,Alicante,Valencia,395,2565124,216289,2348835,1858683,139295
2020/05/09,Almería,Valencia,16,2565124,216289,2348835,716820,51861
2020/05/09,Almería,Murcia,949,1493898,121186,1372712,716820,51861
2020/05/09,Almería,Granada,227,914678,69197,845481,716820,51861
2020/05/09,Almería,Almería,40104,716820,51205,665615,716820,51861
2020/05/09,Araba,Araba,21371,331549,26539,305010,331549,27731
2020/05/09,Araba,Bizkaia,318,1152934,96933,1056001,331549,27731
2020/05/09,Araba,Burgos,672,357072,21643,335429,331549,27731
2020/05/09,Araba,Navarra,65,654183,52739,601444,331549,27731
2020/05/09,Araba,Rioja,753,316798,24378,292420,331549,27731
2020/05/09,Araba,Gipuzkoa,19,723576,47326,676250,331549,27731
2020/05/09,Asturias,Lugo,429,329587,23739,305848,1022800,75341
2020/05/09,Asturias,Asturias,57889,1022800,74687,948113,1022800,75341
2020/05/09,Asturias,Cantabria,135,580795,47561,533234,1022800,75341
2020/05/09,Ávila,Ávila,6518,157640,9686,147954,157640,10071
2020/05/09,Ávila,Segovia,33,153129,10474,142655,157640,10071
2020/05/09,Ávila,Toledo,125,694844,41878,652966,157640,10071
2020/05/09,Ávila,Cáceres,117,394151,23491,370660,157640,10071
2020/05/09,Ávila,Madrid,59,6663394,526302,6137092,157640,10071
2020/05/09,Ávila,Salamanca,167,330119,25279,304840,157640,10071
2020/05/09,Badajoz,Huelva,148,521870,39536,482334,673559,45500
2020/05/09,Badajoz,Ciudad Real,54,495761,23401,472360,673559,45500
2020/05/09,Badajoz,Badajoz,33404,673559,45978,627581,673559,45500
2020/05/09,Badajoz,Córdoba,136,782979,62727,720252,673559,45500
2020/05/09,Badajoz,Sevilla,32,1942389,155739,1786650,673559,45500
2020/05/09,Badajoz,Cáceres,738,394151,23491,370660,673559,45500
2020/05/09,Balears,Balears,63101,1149460,76942,1072518,1149460,77831
2020/05/09,Balears,Valencia,46,2565124,216289,2348835,1149460,77831
2020/05/09,Balears,Córdoba,16,782979,62727,720252,1149460,77831
2020/05/09,Barcelona,Girona,1284,771044,49473,721571,5664579,499756
2020/05/09,Barcelona,Lleida,151,434930,36172,398758,5664579,499756
2020/05/09,Barcelona,Tarragona,377,804664,58309,746355,5664579,499756
2020/05/09,Barcelona,Barcelona,332216,5664579,499101,5165478,5664579,499756
2020/05/09,Bizkaia,Cantabria,366,580795,47561,533234,1152934,95897
2020/05/09,Bizkaia,Araba,231,331549,26539,305010,1152934,95897
2020/05/09,Bizkaia,Burgos,27,357072,21643,335429,1152934,95897
2020/05/09,Bizkaia,Bizkaia,71474,1152934,96933,1056001,1152934,95897
2020/05/09,Bizkaia,Gipuzkoa,259,723576,47326,676250,1152934,95897
2020/05/09,Burgos,Bizkaia,32,1152934,96933,1056001,357072,21954
2020/05/09,Burgos,Soria,26,88636,3933,84703,357072,21954
2020/05/09,Burgos,Araba,507,331549,26539,305010,357072,21954
2020/05/09,Burgos,Burgos,15828,357072,21643,335429,357072,21954
2020/05/09,Burgos,Palencia,60,160866,12369,148497,357072,21954
2020/05/09,Burgos,Segovia,20,153129,10474,142655,357072,21954
2020/05/09,Cáceres,Cáceres,15439,394151,23491,370660,394151,23089
2020/05/09,Cáceres,Badajoz,648,673559,45978,627581,394151,23089
2020/05/09,Cáceres,Toledo,65,694844,41878,652966,394151,23089
2020/05/09,Cáceres,Ávila,106,157640,9686,147954,394151,23089
2020/05/09,Cádiz,Cádiz,84691,1240155,100082,1140073,1240155,101379
2020/05/09,Cádiz,Huelva,320,521870,39536,482334,1240155,101379
2020/05/09,Cádiz,Sevilla,537,1942389,155739,1786650,1240155,101379
2020/05/09,Cádiz,Málaga,571,1661785,109022,1552763,1240155,101379
2020/05/09,Cantabria,Asturias,119,1022800,74687,948113,580795,47440
2020/05/09,Cantabria,Cantabria,35499,580795,47561,533234,580795,47440
2020/05/09,Cantabria,Palencia,35,160866,12369,148497,580795,47440
2020/05/09,Cantabria,Bizkaia,171,1152934,96933,1056001,580795,47440
2020/05/09,Castellón,Castellón,28213,579962,39734,540228,579962,39705
2020/05/09,Castellón,Teruel,45,134137,4952,129185,579962,39705
2020/05/09,Castellón,Tarragona,443,804664,58309,746355,579962,39705
2020/05/09,Castellón,Valencia,445,2565124,216289,2348835,579962,39705
2020/05/09,Ceuta,Cádiz,20,1240155,100082,1140073,84777,6925
2020/05/09,Ceuta,Ceuta,6604,84777,6913,77864,84777,6925
2020/05/09,Ciudad Real,Badajoz,73,673559,45978,627581,495761,22839
2020/05/09,Ciudad Real,Toledo,42,694844,41878,652966,495761,22839
2020/05/09,Ciudad Real,Jaén,30,633564,37889,595675,495761,22839
2020/05/09,Ciudad Real,Ciudad Real,14132,495761,23401,472360,495761,22839
2020/05/09,Ciudad Real,Cuenca,32,196329,10700,185629,495761,22839
2020/05/09,Ciudad Real,Albacete,174,388167,20164,368003,495761,22839
2020/05/09,Ciudad Real,Córdoba,264,782979,62727,720252,495761,22839
2020/05/09,Córdoba,Córdoba,45301,782979,62727,720252,782979,61975
2020/05/09,Córdoba,Badajoz,116,673559,45978,627581,782979,61975
2020/05/09,Córdoba,Málaga,188,1661785,109022,1552763,782979,61975
2020/05/09,Córdoba,Granada,74,914678,69197,845481,782979,61975
2020/05/09,Córdoba,Sevilla,853,1942389,155739,1786650,782979,61975
2020/05/09,Córdoba,Ciudad Real,157,495761,23401,472360,782979,61975
2020/05/09,Córdoba,Jaén,428,633564,37889,595675,782979,61975
2020/05/09,Coruña,Coruña,69793,1119596,92616,1026980,1119596,94281
2020/05/09,Coruña,Lugo,336,329587,23739,305848,1119596,94281
2020/05/09,Coruña,Pontevedra,2949,942665,78461,864204,1119596,94281
2020/05/09,Cuenca,Guadalajara,26,257762,18805,238957,196329,10793
2020/05/09,Cuenca,Ciudad Real,34,495761,23401,472360,196329,10793
2020/05/09,Cuenca,Toledo,24,694844,41878,652966,196329,10793
2020/05/09,Cuenca,Cuenca,5679,196329,10700,185629,196329,10793
2020/05/09,Cuenca,Albacete,390,388167,20164,368003,196329,10793
2020/05/09,Cuenca,Madrid,22,6663394,526302,6137092,196329,10793
2020/05/09,Gipuzkoa,Gipuzkoa,35565,723576,47326,676250,723576,48262
2020/05/09,Gipuzkoa,Navarra,99,654183,52739,601444,723576,48262
2020/05/09,Gipuzkoa,Bizkaia,419,1152934,96933,1056001,723576,48262
2020/05/09,Gipuzkoa,Araba,38,331549,26539,305010,723576,48262
2020/05/09,Girona,Murcia,19,1493898,121186,1372712,771044,52339
2020/05/09,Girona,Lleida,73,434930,36172,398758,771044,52339
2020/05/09,Girona,Barcelona,1192,5664579,499101,5165478,771044,52339
2020/05/09,Girona,Girona,33487,771044,49473,721571,771044,52339
2020/05/09,Girona,Tarragona,24,804664,58309,746355,771044,52339
2020/05/09,Granada,Córdoba,189,782979,62727,720252,914678,68969
2020/05/09,Granada,Almería,204,716820,51205,665615,914678,68969
2020/05/09,Granada,Granada,48761,914678,69197,845481,914678,68969
2020/05/09,Granada,Jaén,347,633564,37889,595675,914678,68969
2020/05/09,Granada,Málaga,85,1661785,109022,1552763,914678,68969
2020/05/09,Granada,Murcia,17,1493898,121186,1372712,914678,68969
2020/05/09,Guadalajara,Guadalajara,11526,257762,18805,238957,257762,18443
2020/05/09,Guadalajara,Madrid,998,6663394,526302,6137092,257762,18443
2020/05/09,Huelva,Badajoz,218,673559,45978,627581,521870,40520
2020/05/09,Huelva,Huelva,29520,521870,39536,482334,521870,40520
2020/05/09,Huelva,Cádiz,253,1240155,100082,1140073,521870,40520
2020/05/09,Huelva,Sevilla,1152,1942389,155739,1786650,521870,40520
2020/05/09,Huesca,Zaragoza,167,964724,84478,880246,220461,15779
2020/05/09,Huesca,Lleida,573,434930,36172,398758,220461,15779
2020/05/09,Huesca,Huesca,10186,220461,15137,205324,220461,15779
2020/05/09,Jaén,Córdoba,450,782979,62727,720252,633564,37219
2020/05/09,Jaén,Albacete,17,388167,20164,368003,633564,37219
2020/05/09,Jaén,Jaén,26202,633564,37889,595675,633564,37219
2020/05/09,Jaén,Ciudad Real,34,495761,23401,472360,633564,37219
2020/05/09,Jaén,Granada,180,914678,69197,845481,633564,37219
2020/05/09,Las Palmas de Gran Canaria,Las Palmas de Gran Canaria,77178,1120406,90510,1029896,1120406,89666
2020/05/09,Las Palmas de Gran Canaria,Santa Cruz de Tenerife,42,1032983,83843,949140,1120406,89666
2020/05/09,León,Lugo,27,329587,23739,305848,460001,37428
2020/05/09,León,León,27520,460001,37641,422360,460001,37428
2020/05/09,León,Ourense,92,307651,29078,278573,460001,37428
2020/05/09,León,Valladolid,26,519546,39702,479844,460001,37428
2020/05/09,León,Zamora,162,172539,12371,160168,460001,37428
2020/05/09,León,Palencia,22,160866,12369,148497,460001,37428
2020/05/09,Lleida,Tarragona,30,804664,58309,746355,434930,34875
2020/05/09,Lleida,Lleida,23291,434930,36172,398758,434930,34875
2020/05/09,Lleida,Huesca,466,220461,15137,205324,434930,34875
2020/05/09,Lleida,Zaragoza,44,964724,84478,880246,434930,34875
2020/05/09,Lleida,Girona,106,771044,49473,721571,434930,34875
2020/05/09,Lleida,Barcelona,71,5664579,499101,5165478,434930,34875
2020/05/09,Lugo,Asturias,411,1022800,74687,948113,329587,24445
2020/05/09,Lugo,Lugo,16780,329587,23739,305848,329587,24445
2020/05/09,Lugo,Coruña,306,1119596,92616,1026980,329587,24445
2020/05/09,Lugo,Ourense,106,307651,29078,278573,329587,24445
2020/05/09,Madrid,Cuenca,39,196329,10700,185629,6663394,525390
2020/05/09,Madrid,Toledo,1645,694844,41878,652966,6663394,525390
2020/05/09,Madrid,Madrid,336266,6663394,526302,6137092,6663394,525390
2020/05/09,Madrid,Guadalajara,1109,257762,18805,238957,6663394,525390
2020/05/09,Madrid,Ávila,166,157640,9686,147954,6663394,525390
2020/05/09,Málaga,Málaga,85387,1661785,109022,1552763,1661785,109396
2020/05/09,Málaga,Sevilla,146,1942389,155739,1786650,1661785,109396
2020/05/09,Málaga,Granada,79,914678,69197,845481,1661785,109396
2020/05/09,Málaga,Córdoba,291,782979,62727,720252,1661785,109396
2020/05/09,Málaga,Cádiz,414,1240155,100082,1140073,1661785,109396
2020/05/09,Melilla,Melilla,9309,86487,9488,76999,86487,9439
2020/05/09,Murcia,Almería,630,716820,51205,665615,1493898,119971
2020/05/09,Murcia,Granada,95,914678,69197,845481,1493898,119971
2020/05/09,Murcia,Alicante,1136,1858683,138137,1720546,1493898,119971
2020/05/09,Murcia,Albacete,243,388167,20164,368003,1493898,119971
2020/05/09,Murcia,Murcia,90446,1493898,121186,1372712,1493898,119971
2020/05/09,Navarra,Gipuzkoa,47,723576,47326,676250,654183,52855
2020/05/09,Navarra,Rioja,851,316798,24378,292420,654183,52855
2020/05/09,Navarra,Navarra,37262,654183,52739,601444,654183,52855
2020/05/09,Navarra,Alicante,27,1858683,138137,1720546,654183,52855
2020/05/09,Navarra,Zaragoza,251,964724,84478,880246,654183,52855
2020/05/09,Navarra,Araba,22,331549,26539,305010,654183,52855
2020/05/09,Ourense,Ourense,22451,307651,29078,278573,307651,28941
2020/05/09,Ourense,Pontevedra,120,942665,78461,864204,307651,28941
2020/05/09,Ourense,León,32,460001,37641,422360,307651,28941
2020/05/09,Ourense,Zamora,16,172539,12371,160168,307651,28941
2020/05/09,Ourense,Lugo,148,329587,23739,305848,307651,28941
2020/05/09,Palencia,Palencia,8811,160866,12369,148497,160866,12381
2020/05/09,Palencia,Burgos,63,357072,21643,335429,160866,12381
2020/05/09,Palencia,Cantabria,31,580795,47561,533234,160866,12381
2020/05/09,Palencia,Valladolid,25,519546,39702,479844,160866,12381
2020/05/09,Palencia,León,23,460001,37641,422360,160866,12381
2020/05/09,Pontevedra,Coruña,2531,1119596,92616,1026980,942665,78828
2020/05/09,Pontevedra,Ourense,131,307651,29078,278573,942665,78828
2020/05/09,Pontevedra,Pontevedra,59490,942665,78461,864204,942665,78828
2020/05/09,Rioja,Navarra,1174,654183,52739,601444,316798,24232
2020/05/09,Rioja,Araba,482,331549,26539,305010,316798,24232
2020/05/09,Rioja,Rioja,17856,316798,24378,292420,316798,24232
2020/05/09,Salamanca,Valladolid,131,519546,39702,479844,330119,25249
2020/05/09,Salamanca,Ávila,61,157640,9686,147954,330119,25249
2020/05/09,Salamanca,Zamora,37,172539,12371,160168,330119,25249
2020/05/09,Salamanca,Salamanca,19306,330119,25279,304840,330119,25249
2020/05/09,Santa Cruz de Tenerife,Las Palmas de Gran Canaria,25,1120406,90510,1029896,1032983,83803
2020/05/09,Santa Cruz de Tenerife,Santa Cruz de Tenerife,71177,1032983,83843,949140,1032983,83803
2020/05/09,Segovia,Valladolid,57,519546,39702,479844,153129,10813
2020/05/09,Segovia,Burgos,76,357072,21643,335429,153129,10813
2020/05/09,Segovia,Ávila,51,157640,9686,147954,153129,10813
2020/05/09,Segovia,Segovia,6957,153129,10474,142655,153129,10813
2020/05/09,Sevilla,Badajoz,27,673559,45978,627581,1942389,154310
2020/05/09,Sevilla,Huelva,259,521870,39536,482334,1942389,154310
2020/05/09,Sevilla,Cádiz,592,1240155,100082,1140073,1942389,154310
2020/05/09,Sevilla,Córdoba,1130,782979,62727,720252,1942389,154310
2020/05/09,Sevilla,Sevilla,107354,1942389,155739,1786650,1942389,154310
2020/05/09,Sevilla,Málaga,66,1661785,109022,1552763,1942389,154310
2020/05/09,Soria,Zaragoza,25,964724,84478,880246,88636,3835
2020/05/09,Soria,Soria,2585,88636,3933,84703,88636,3835
2020/05/09,Tarragona,Teruel,44,134137,4952,129185,804664,57899
2020/05/09,Tarragona,Zaragoza,64,964724,84478,880246,804664,57899
2020/05/09,Tarragona,Castellón,230,579962,39734,540228,804664,57899
2020/05/09,Tarragona,Barcelona,477,5664579,499101,5165478,804664,57899
2020/05/09,Tarragona,Tarragona,38629,804664,58309,746355,804664,57899
2020/05/09,Teruel,Castellón,34,579962,39734,540228,134137,5147
2020/05/09,Teruel,Tarragona,59,804664,58309,746355,134137,5147
2020/05/09,Teruel,Teruel,2371,134137,4952,129185,134137,5147
2020/05/09,Teruel,Zaragoza,50,964724,84478,880246,134137,5147
2020/05/09,Toledo,Cáceres,104,394151,23491,370660,694844,41818
2020/05/09,Toledo,Ávila,159,157640,9686,147954,694844,41818
2020/05/09,Toledo,Ciudad Real,91,495761,23401,472360,694844,41818
2020/05/09,Toledo,Madrid,1649,6663394,526302,6137092,694844,41818
2020/05/09,Toledo,Cuenca,59,196329,10700,185629,694844,41818
2020/05/09,Toledo,Toledo,21328,694844,41878,652966,694844,41818
2020/05/09,Valencia,Albacete,146,388167,20164,368003,2565124,214554
2020/05/09,Valencia,Castellón,324,579962,39734,540228,2565124,214554
2020/05/09,Valencia,Cuenca,50,196329,10700,185629,2565124,214554
2020/05/09,Valencia,Valencia,149201,2565124,216289,2348835,2565124,214554
2020/05/09,Valencia,Alicante,362,1858683,138137,1720546,2565124,214554
2020/05/09,Valladolid,Valladolid,27005,519546,39702,479844,519546,38703
2020/05/09,Valladolid,Segovia,100,153129,10474,142655,519546,38703
2020/05/09,Valladolid,Zamora,95,172539,12371,160168,519546,38703
2020/05/09,Valladolid,Palencia,37,160866,12369,148497,519546,38703
2020/05/09,Zamora,Salamanca,42,330119,25279,304840,172539,12227
2020/05/09,Zamora,Zamora,8402,172539,12371,160168,172539,12227
2020/05/09,Zamora,León,35,460001,37641,422360,172539,12227
2020/05/09,Zamora,Valladolid,78,519546,39702,479844,172539,12227
2020/05/09,Zaragoza,Soria,28,88636,3933,84703,964724,82015
2020/05/09,Zaragoza,Lleida,37,434930,36172,398758,964724,82015
2020/05/09,Zaragoza,Teruel,45,134137,4952,129185,964724,82015
2020/05/09,Zaragoza,Navarra,281,654183,52739,601444,964724,82015
2020/05/09,Zaragoza,Zaragoza,61717,964724,84478,880246,964724,82015
2020/05/09,Zaragoza,Huesca,74,220461,15137,205324,964724,82015
2020/05/10,Albacete,Jaén,20,633564,30791,602773,388167,16868
2020/05/10,Albacete,Cuenca,170,196329,7858,188471,388167,16868
2020/05/10,Albacete,Alicante,118,1858683,126687,1731996,388167,16868
2020/05/10,Albacete,Albacete,11527,388167,16821,371346,388167,16868
2020/05/10,Albacete,Valencia,223,2565124,189563,2375561,388167,16868
2020/05/10,Albacete,Ciudad Real,278,495761,19414,476347,388167,16868
2020/05/10,Albacete,Murcia,198,1493898,101469,1392429,388167,16868
2020/05/10,Alicante,Alicante,104961,1858683,126687,1731996,1858683,126531
2020/05/10,Alicante,Albacete,156,388167,16821,371346,1858683,126531
2020/05/10,Alicante,Murcia,1485,1493898,101469,1392429,1858683,126531
2020/05/10,Alicante,Valencia,423,2565124,189563,2375561,1858683,126531
2020/05/10,Almería,Granada,316,914678,61370,853308,716820,37155
2020/05/10,Almería,Murcia,516,1493898,101469,1392429,716820,37155
2020/05/10,Almería,Almería,29330,716820,37968,678852,716820,37155
2020/05/10,Araba,Araba,22783,331549,27137,304412,331549,27925
2020/05/10,Araba,Burgos,573,357072,19119,337953,331549,27925
2020/05/10,Araba,Navarra,23,654183,44007,610176,331549,27925
2020/05/10,Araba,Bizkaia,466,1152934,103071,1049863,331549,27925
2020/05/10,Araba,Rioja,560,316798,20786,296012,331549,27925
2020/05/10,Asturias,Asturias,50293,1022800,63429,959371,1022800,63464
2020/05/10,Asturias,Cantabria,149,580795,40029,540766,1022800,63464
2020/05/10,Asturias,Lugo,477,329587,21327,308260,1022800,63464
2020/05/10,Ávila,Madrid,90,6663394,494646,6168748,157640,9242
2020/05/10,Ávila,Toledo,151,694844,34984,659860,157640,9242
2020/05/10,Ávila,Segovia,54,153129,9004,144125,157640,9242
2020/05/10,Ávila,Cáceres,83,394151,20852,373299,157640,9242
2020/05/10,Ávila,Ávila,6518,157640,9173,148467,157640,9242
2020/05/10,Ávila,Salamanca,188,330119,23609,306510,157640,9242
2020/05/10,Badajoz,Huelva,188,521870,36432,485438,673559,38892
2020/05/10,Badajoz,Cáceres,607,394151,20852,373299,673559,38892
2020/05/10,Badajoz,Córdoba,52,782979,54774,728205,673559,38892
2020/05/10,Badajoz,Ciudad Real,39,495761,19414,476347,673559,38892
2020/05/10,Badajoz,Badajoz,30010,673559,39351,634208,673559,38892
2020/05/10,Balears,Balears,50218,1149460,61509,1087951,1149460,61629
2020/05/10,Barcelona,Barcelona,319536,5664579,438158,5226421,5664579,439657
2020/05/10,Barcelona,Lleida,33,434930,29523,405407,5664579,439657
2020/05/10,Barcelona,Girona,1149,771044,39453,731591,5664579,439657
2020/05/10,Barcelona,Tarragona,548,804664,51840,752824,5664579,439657
2020/05/10,Bizkaia,Gipuzkoa,284,723576,42463,681113,1152934,102264
2020/05/10,Bizkaia,Araba,310,331549,27137,304412,1152934,102264
2020/05/10,Bizkaia,Cantabria,373,580795,40029,540766,1152934,102264
2020/05/10,Bizkaia,Bizkaia,83271,1152934,103071,1049863,1152934,102264
2020/05/10,Burgos,Palencia,143,160866,10940,149926,357072,19582
2020/05/10,Burgos,Araba,545,331549,27137,304412,357072,19582
2020/05/10,Burgos,Bizkaia,45,1152934,103071,1049863,357072,19582
2020/05/10,Burgos,Burgos,14395,357072,19119,337953,357072,19582
2020/05/10,Burgos,Valladolid,79,519546,36634,482912,357072,19582
2020/05/10,Cáceres,Ávila,103,157640,9173,148467,394151,20563
2020/05/10,Cáceres,Toledo,67,694844,34984,659860,394151,20563
2020/05/10,Cáceres,Cáceres,14072,394151,20852,373299,394151,20563
2020/05/10,Cáceres,Badajoz,503,673559,39351,634208,394151,20563
2020/05/10,Cádiz,Sevilla,510,1942389,134885,1807504,1240155,86403
2020/05/10,Cádiz,Málaga,402,1661785,98793,1562992,1240155,86403
2020/05/10,Cádiz,Granada,16,914678,61370,853308,1240155,86403
2020/05/10,Cádiz,Huelva,494,521870,36432,485438,1240155,86403
2020/05/10,Cádiz,Cádiz,73506,1240155,85936,1154219,1240155,86403
2020/05/10,Cantabria,Cantabria,30908,580795,40029,540766,580795,40148
2020/05/10,Cantabria,Bizkaia,504,1152934,103071,1049863,580795,40148
2020/05/10,Cantabria,Palencia,34,160866,10940,149926,580795,40148
2020/05/10,Cantabria,Asturias,99,1022800,63429,959371,580795,40148
2020/05/10,Castellón,Teruel,25,134137,3605,130532,579962,33495
2020/05/10,Castellón,Castellón,24004,579962,33033,546929,579962,33495
2020/05/10,Castellón,Tarragona,703,804664,51840,752824,579962,33495
2020/05/10,Castellón,Valencia,540,2565124,189563,2375561,579962,33495
2020/05/10,Ceuta,Ceuta,5552,84777,5835,78942,84777,5854
2020/05/10,Ciudad Real,Badajoz,52,673559,39351,634208,495761,19136
2020/05/10,Ciudad Real,Córdoba,302,782979,54774,728205,495761,19136
2020/05/10,Ciudad Real,Toledo,34,694844,34984,659860,495761,19136
2020/05/10,Ciudad Real,Jaén,20,633564,30791,602773,495761,19136
2020/05/10,Ciudad Real,Ciudad Real,12168,495761,19414,476347,495761,19136
2020/05/10,Ciudad Real,Albacete,326,388167,16821,371346,495761,19136
2020/05/10,Córdoba,Córdoba,41251,782979,54774,728205,782979,53737
2020/05/10,Córdoba,Jaén,388,633564,30791,602773,782979,53737
2020/05/10,Córdoba,Sevilla,790,1942389,134885,1807504,782979,53737
2020/05/10,Córdoba,Málaga,47,1661785,98793,1562992,782979,53737
2020/05/10,Córdoba,Ciudad Real,189,495761,19414,476347,782979,53737
2020/05/10,Córdoba,Granada,94,914678,61370,853308,782979,53737
2020/05/10,Córdoba,Badajoz,89,673559,39351,634208,782979,53737
2020/05/10,Coruña,Coruña,64615,1119596,83509,1036087,1119596,84304
2020/05/10,Coruña,Lugo,315,329587,21327,308260,1119596,84304
2020/05/10,Coruña,Pontevedra,2820,942665,71691,870974,1119596,84304
2020/05/10,Cuenca,Madrid,21,6663394,494646,6168748,196329,7820
2020/05/10,Cuenca,Cuenca,3984,196329,7858,188471,196329,7820
2020/05/10,Cuenca,Valencia,60,2565124,189563,2375561,196329,7820
2020/05/10,Cuenca,Ciudad Real,56,495761,19414,476347,196329,7820
2020/05/10,Cuenca,Albacete,271,388167,16821,371346,196329,7820
2020/05/10,Gipuzkoa,Bizkaia,441,1152934,103071,1049863,723576,43546
2020/05/10,Gipuzkoa,Gipuzkoa,33570,723576,42463,681113,723576,43546
2020/05/10,Gipuzkoa,Navarra,69,654183,44007,610176,723576,43546
2020/05/10,Girona,Gipuzkoa,18,723576,42463,681113,771044,40946
2020/05/10,Girona,Barcelona,1186,5664579,438158,5226421,771044,40946
2020/05/10,Girona,Lleida,66,434930,29523,405407,771044,40946
2020/05/10,Girona,Girona,26949,771044,39453,731591,771044,40946
2020/05/10,Granada,Córdoba,133,782979,54774,728205,914678,60582
2020/05/10,Granada,Granada,45913,914678,61370,853308,914678,60582
2020/05/10,Granada,Málaga,60,1661785,98793,1562992,914678,60582
2020/05/10,Granada,Almería,200,716820,37968,678852,914678,60582
2020/05/10,Granada,Jaén,70,633564,30791,602773,914678,60582
2020/05/10,Guadalajara,Guadalajara,9816,257762,15269,242493,257762,15318
2020/05/10,Guadalajara,Madrid,978,6663394,494646,6168748,257762,15318
2020/05/10,Guadalajara,Cuenca,22,196329,7858,188471,257762,15318
2020/05/10,Huelva,Cádiz,424,1240155,85936,1154219,521870,36309
2020/05/10,Huelva,Badajoz,200,673559,39351,634208,521870,36309
2020/05/10,Huelva,Sevilla,593,1942389,134885,1807504,521870,36309
2020/05/10,Huelva,Huelva,28093,521870,36432,485438,521870,36309
2020/05/10,Huesca,Lleida,387,434930,29523,405407,220461,11854
2020/05/10,Huesca,Huesca,7967,220461,11613,208848,220461,11854
2020/05/10,Huesca,Zaragoza,33,964724,75266,889458,220461,11854
2020/05/10,Jaén,Granada,141,914678,61370,853308,633564,30558
2020/05/10,Jaén,Albacete,18,388167,16821,371346,633564,30558
2020/05/10,Jaén,Jaén,22145,633564,30791,602773,633564,30558
2020/05/10,Jaén,Córdoba,390,782979,54774,728205,633564,30558
2020/05/10,Las Palmas de Gran Canaria,Las Palmas de Gran Canaria,62044,1120406,74527,1045879,1120406,74063
2020/05/10,Las Palmas de Gran Canaria,Santa Cruz de Tenerife,20,1032983,68200,964783,1120406,74063
2020/05/10,León,Asturias,25,1022800,63429,959371,460001,32966
2020/05/10,León,León,25243,460001,32888,427113,460001,32966
2020/05/10,León,Ourense,82,307651,24825,282826,460001,32966
2020/05/10,León,Zamora,51,172539,10752,161787,460001,32966
2020/05/10,Lleida,Girona,93,771044,39453,731591,434930,28951
2020/05/10,Lleida,Huesca,218,220461,11613,208848,434930,28951
2020/05/10,Lleida,Barcelona,47,5664579,438158,5226421,434930,28951
2020/05/10,Lleida,Lleida,20458,434930,29523,405407,434930,28951
2020/05/10,Lleida,Zaragoza,92,964724,75266,889458,434930,28951
2020/05/10,Lugo,Coruña,341,1119596,83509,1036087,329587,21334
2020/05/10,Lugo,Lugo,15139,329587,21327,308260,329587,21334
2020/05/10,Lugo,Asturias,307,1022800,63429,959371,329587,21334
2020/05/10,Lugo,Ourense,47,307651,24825,282826,329587,21334
2020/05/10,Madrid,Toledo,1536,694844,34984,659860,6663394,496821
2020/05/10,Madrid,Ávila,120,157640,9173,148467,6663394,496821
2020/05/10,Madrid,Guadalajara,924,257762,15269,242493,6663394,496821
2020/05/10,Madrid,Madrid,352804,6663394,494646,6168748,6663394,496821
2020/05/10,Madrid,Cuenca,38,196329,7858,188471,6663394,496821
2020/05/10,Málaga,Córdoba,99,782979,54774,728205,1661785,98285
2020/05/10,Málaga,Sevilla,42,1942389,134885,1807504,1661785,98285
2020/05/10,Málaga,Málaga,80062,1661785,98793,1562992,1661785,98285
2020/05/10,Málaga,Granada,80,914678,61370,853308,1661785,98285
2020/05/10,Málaga,Cádiz,390,1240155,85936,1154219,1661785,98285
2020/05/10,Melilla,Melilla,7919,86487,8061,78426,86487,8116
2020/05/10,Murcia,Murcia,79414,1493898,101469,1392429,1493898,100313
2020/05/10,Murcia,Albacete,121,388167,16821,371346,1493898,100313
2020/05/10,Murcia,Almería,523,716820,37968,678852,1493898,100313
2020/05/10,Murcia,Alicante,1286,1858683,126687,1731996,1493898,100313
2020/05/10,Navarra,Huelva,16,521870,36432,485438,654183,44467
2020/05/10,Navarra,Araba,165,331549,27137,304412,654183,44467
2020/05/10,Navarra,Rioja,705,316798,20786,296012,654183,44467
2020/05/10,Navarra,Navarra,32482,654183,44007,610176,654183,44467
2020/05/10,Navarra,Gipuzkoa,144,723576,42463,681113,654183,44467
2020/05/10,Navarra,Zaragoza,260,964724,75266,889458,654183,44467
2020/05/10,Ourense,Pontevedra,152,942665,71691,870974,307651,25014
2020/05/10,Ourense,Ourense,19835,307651,24825,282826,307651,25014
2020/05/10,Ourense,Lugo,128,329587,21327,308260,307651,25014
2020/05/10,Ourense,León,112,460001,32888,427113,307651,25014
2020/05/10,Palencia,Cantabria,35,580795,40029,540766,160866,11078
2020/05/10,Palencia,Palencia,8214,160866,10940,149926,160866,11078
2020/05/10,Palencia,Burgos,107,357072,19119,337953,160866,11078
2020/05/10,Palencia,Valladolid,28,519546,36634,482912,160866,11078
2020/05/10,Pontevedra,Coruña,2729,1119596,83509,1036087,942665,71749
2020/05/10,Pontevedra,Ourense,79,307651,24825,282826,942665,71749
2020/05/10,Pontevedra,Pontevedra,55770,942665,71691,870974,942665,71749
2020/05/10,Rioja,Rioja,15722,316798,20786,296012,316798,20421
2020/05/10,Rioja,Navarra,767,654183,44007,610176,316798,20421
2020/05/10,Rioja,Araba,355,331549,27137,304412,316798,20421
2020/05/10,Salamanca,Valladolid,32,519546,36634,482912,330119,23651
2020/05/10,Salamanca,Zamora,28,172539,10752,161787,330119,23651
2020/05/10,Salamanca,Salamanca,18682,330119,23609,306510,330119,23651
2020/05/10,Salamanca,Ávila,92,157640,9173,148467,330119,23651
2020/05/10,Santa Cruz de Tenerife,Las Palmas de Gran Canaria,20,1120406,74527,1045879,1032983,68189
2020/05/10,Santa Cruz de Tenerife,Santa Cruz de Tenerife,57150,1032983,68200,964783,1032983,68189
2020/05/10,Segovia,Segovia,6339,153129,9004,144125,153129,9054
2020/05/10,Segovia,Ávila,67,157640,9173,148467,153129,9054
2020/05/10,Segovia,Valladolid,64,519546,36634,482912,153129,9054
2020/05/10,Sevilla,Huelva,311,521870,36432,485438,1942389,134599
2020/05/10,Sevilla,Sevilla,100698,1942389,134885,1807504,1942389,134599
2020/05/10,Sevilla,Cádiz,573,1240155,85936,1154219,1942389,134599
2020/05/10,Sevilla,Badajoz,25,673559,39351,634208,1942389,134599
2020/05/10,Sevilla,Córdoba,956,782979,54774,728205,1942389,134599
2020/05/10,Sevilla,Málaga,18,1661785,98793,1562992,1942389,134599
2020/05/10,Soria,Soria,2482,88636,3469,85167,88636,3433
2020/05/10,Soria,Valladolid,35,519546,36634,482912,88636,3433
2020/05/10,Tarragona,Castellón,385,579962,33033,546929,804664,50920
2020/05/10,Tarragona,Barcelona,506,5664579,438158,5226421,804664,50920
2020/05/10,Tarragona,Lleida,34,434930,29523,405407,804664,50920
2020/05/10,Tarragona,Teruel,56,134137,3605,130532,804664,50920
2020/05/10,Tarragona,Tarragona,36095,804664,51840,752824,804664,50920
2020/05/10,Teruel,Teruel,1883,134137,3605,130532,134137,3738
2020/05/10,Teruel,Castellón,34,579962,33033,546929,134137,3738
2020/05/10,Teruel,Tarragona,19,804664,51840,752824,134137,3738
2020/05/10,Toledo,Toledo,19330,694844,34984,659860,694844,34791
2020/05/10,Toledo,Madrid,1535,6663394,494646,6168748,694844,34791
2020/05/10,Toledo,Ciudad Real,34,495761,19414,476347,694844,34791
2020/05/10,Toledo,Cáceres,135,394151,20852,373299,694844,34791
2020/05/10,Toledo,Ávila,125,157640,9173,148467,694844,34791
2020/05/10,Valencia,Albacete,179,388167,16821,371346,2565124,189197
2020/05/10,Valencia,Valencia,144283,2565124,189563,2375561,2565124,189197
2020/05/10,Valencia,Castellón,404,579962,33033,546929,2565124,189197
2020/05/10,Valencia,Cuenca,64,196329,7858,188471,2565124,189197
2020/05/10,Valencia,Alicante,404,1858683,126687,1731996,2565124,189197
2020/05/10,Valladolid,Palencia,25,160866,10940,149926,519546,36364
2020/05/10,Valladolid,Zamora,55,172539,10752,161787,519546,36364
2020/05/10,Valladolid,Segovia,95,153129,9004,144125,519546,36364
2020/05/10,Valladolid,Burgos,85,357072,19119,337953,519546,36364
2020/05/10,Valladolid,Valladolid,27098,519546,36634,482912,519546,36364
2020/05/10,Valladolid,Soria,31,88636,3469,85167,519546,36364
2020/05/10,Zamora,Salamanca,21,330119,23609,306510,172539,10771
2020/05/10,Zamora,Valladolid,36,519546,36634,482912,172539,10771
2020/05/10,Zamora,León,36,460001,32888,427113,172539,10771
2020/05/10,Zamora,Zamora,8008,172539,10752,161787,172539,10771
2020/05/10,Zaragoza,Zaragoza,58146,964724,75266,889458,964724,74269
2020/05/10,Zaragoza,Navarra,180,654183,44007,610176,964724,74269
2020/05/10,Zaragoza,Huesca,79,220461,11613,208848,964724,74269
2020/05/10,Zaragoza,Lleida,103,434930,29523,405407,964724,74269
2020/05/11,Albacete,Albacete,19579,388167,34077,354090,388167,33520
2020/05/11,Albacete,Cuenca,488,196329,19471,176858,388167,33520
2020/05/11,Albacete,Murcia,467,1493898,220597,1273301,388167,33520
2020/05/11,Albacete,Alicante,197,1858683,262591,1596092,388167,33520
2020/05/11,Albacete,Ciudad Real,520,495761,43067,452694,388167,33520
2020/05/11,Albacete,Valencia,327,2565124,409763,2155361,388167,33520
2020/05/11,Alicante,Valencia,1242,2565124,409763,2155361,1858683,266331
2020/05/11,Alicante,Alicante,202212,1858683,262591,1596092,1858683,266331
2020/05/11,Alicante,Murcia,3102,1493898,220597,1273301,1858683,266331
2020/05/11,Alicante,Albacete,348,388167,34077,354090,1858683,266331
2020/05/11,Almería,Murcia,1930,1493898,220597,1273301,716820,95969
2020/05/11,Almería,Almería,76928,716820,93147,623673,716820,95969
2020/05/11,Almería,Granada,472,914678,113383,801295,716820,95969
2020/05/11,Araba,Burgos,1853,357072,41517,315555,331549,63789
2020/05/11,Araba,Araba,46015,331549,55789,275760,331549,63789
2020/05/11,Araba,Rioja,2099,316798,47933,268865,331549,63789
2020/05/11,Araba,Gipuzkoa,165,723576,98471,625105,331549,63789
2020/05/11,Araba,Bizkaia,1220,1152934,200556,952378,331549,63789
2020/05/11,Araba,Navarra,216,654183,99037,555146,331549,63789
2020/05/11,Asturias,Cantabria,190,580795,87744,493051,1022800,154304
2020/05/11,Asturias,Asturias,123807,1022800,155919,866881,1022800,154304
2020/05/11,Asturias,León,36,460001,60714,399287,1022800,154304
2020/05/11,Asturias,Lugo,940,329587,46644,282943,1022800,154304
2020/05/11,Ávila,Segovia,68,153129,18149,134980,157640,16575
2020/05/11,Ávila,Toledo,214,694844,80591,614253,157640,16575
2020/05/11,Ávila,Ávila,10285,157640,16354,141286,157640,16575
2020/05/11,Ávila,Madrid,92,6663394,924603,5738791,157640,16575
2020/05/11,Ávila,Cáceres,106,394151,42467,351684,157640,16575
2020/05/11,Ávila,Salamanca,317,330119,42316,287803,157640,16575
2020/05/11,Badajoz,Cáceres,857,394151,42467,351684,673559,79342
2020/05/11,Badajoz,Córdoba,96,782979,105335,677644,673559,79342
2020/05/11,Badajoz,Badajoz,57876,673559,81422,592137,673559,79342
2020/05/11,Badajoz,Huelva,229,521870,70877,450993,673559,79342
2020/05/11,Badajoz,Sevilla,70,1942389,288711,1653678,673559,79342
2020/05/11,Badajoz,Ciudad Real,43,495761,43067,452694,673559,79342
2020/05/11,Balears,Valencia,49,2565124,409763,2155361,1149460,164536
2020/05/11,Balears,Balears,144332,1149460,163709,985751,1149460,164536
2020/05/11,Barcelona,Tarragona,1517,804664,104948,699716,5664579,830570
2020/05/11,Barcelona,Barcelona,499410,5664579,825513,4839066,5664579,830570
2020/05/11,Barcelona,Girona,2371,771044,85836,685208,5664579,830570
2020/05/11,Barcelona,Lleida,166,434930,48801,386129,5664579,830570
2020/05/11,Bizkaia,Bizkaia,149928,1152934,200556,952378,1152934,196392
2020/05/11,Bizkaia,Gipuzkoa,942,723576,98471,625105,1152934,196392
2020/05/11,Bizkaia,Araba,709,331549,55789,275760,1152934,196392
2020/05/11,Bizkaia,Burgos,73,357072,41517,315555,1152934,196392
2020/05/11,Bizkaia,Cantabria,2281,580795,87744,493051,1152934,196392
2020/05/11,Burgos,Segovia,40,153129,18149,134980,357072,42318
2020/05/11,Burgos,Bizkaia,141,1152934,200556,952378,357072,42318
2020/05/11,Burgos,Burgos,29732,357072,41517,315555,357072,42318
2020/05/11,Burgos,Valladolid,78,519546,76383,443163,357072,42318
2020/05/11,Burgos,Soria,33,88636,7046,81590,357072,42318
2020/05/11,Burgos,Palencia,187,160866,20975,139891,357072,42318
2020/05/11,Burgos,Cantabria,26,580795,87744,493051,357072,42318
2020/05/11,Burgos,Araba,871,331549,55789,275760,357072,42318
2020/05/11,Burgos,Rioja,69,316798,47933,268865,357072,42318
2020/05/11,Cáceres,Toledo,149,694844,80591,614253,394151,42877
2020/05/11,Cáceres,Badajoz,1134,673559,81422,592137,394151,42877
2020/05/11,Cáceres,Ávila,135,157640,16354,141286,394151,42877
2020/05/11,Cáceres,Cáceres,28639,394151,42467,351684,394151,42877
2020/05/11,Cádiz,Huelva,710,521870,70877,450993,1240155,175438
2020/05/11,Cádiz,Cádiz,143217,1240155,173824,1066331,1240155,175438
2020/05/11,Cádiz,Málaga,1163,1661785,203614,1458171,1240155,175438
2020/05/11,Cádiz,Sevilla,827,1942389,288711,1653678,1240155,175438
2020/05/11,Cantabria,Palencia,56,160866,20975,139891,580795,82923
2020/05/11,Cantabria,Asturias,203,1022800,155919,866881,580795,82923
2020/05/11,Cantabria,Cantabria,61847,580795,87744,493051,580795,82923
2020/05/11,Cantabria,Bizkaia,541,1152934,200556,952378,580795,82923
2020/05/11,Castellón,Tarragona,841,804664,104948,699716,579962,78104
2020/05/11,Castellón,Valencia,611,2565124,409763,2155361,579962,78104
2020/05/11,Castellón,Castellón,54796,579962,74236,505726,579962,78104
2020/05/11,Castellón,Teruel,56,134137,10454,123683,579962,78104
2020/05/11,Ceuta,Cádiz,41,1240155,173824,1066331,84777,10494
2020/05/11,Ceuta,Ceuta,9993,84777,10487,74290,84777,10494
2020/05/11,Ciudad Real,Ciudad Real,23883,495761,43067,452694,495761,38103
2020/05/11,Ciudad Real,Albacete,296,388167,34077,354090,495761,38103
2020/05/11,Ciudad Real,Badajoz,115,673559,81422,592137,495761,38103
2020/05/11,Ciudad Real,Córdoba,332,782979,105335,677644,495761,38103
2020/05/11,Ciudad Real,Toledo,186,694844,80591,614253,495761,38103
2020/05/11,Córdoba,Jaén,546,633564,65709,567855,782979,100898
2020/05/11,Córdoba,Sevilla,1497,1942389,288711,1653678,782979,100898
2020/05/11,Córdoba,Badajoz,131,673559,81422,592137,782979,100898
2020/05/11,Córdoba,Córdoba,72852,782979,105335,677644,782979,100898
2020/05/11,Córdoba,Ciudad Real,299,495761,43067,452694,782979,100898
2020/05/11,Córdoba,Málaga,167,1661785,203614,1458171,782979,100898
2020/05/11,Córdoba,Granada,115,914678,113383,801295,782979,100898
2020/05/11,Coruña,Lugo,685,329587,46644,282943,1119596,183702
2020/05/11,Coruña,Pontevedra,4955,942665,158660,784005,1119596,183702
2020/05/11,Coruña,Coruña,139189,1119596,185055,934541,1119596,183702
2020/05/11,Coruña,Asturias,17,1022800,155919,866881,1119596,183702
2020/05/11,Cuenca,Albacete,602,388167,34077,354090,196329,20997
2020/05/11,Cuenca,Valencia,35,2565124,409763,2155361,196329,20997
2020/05/11,Cuenca,Toledo,209,694844,80591,614253,196329,20997
2020/05/11,Cuenca,Cuenca,10442,196329,19471,176858,196329,20997
2020/05/11,Cuenca,Guadalajara,24,257762,36392,221370,196329,20997
2020/05/11,Cuenca,Ciudad Real,111,495761,43067,452694,196329,20997
2020/05/11,Cuenca,Madrid,67,6663394,924603,5738791,196329,20997
2020/05/11,Gipuzkoa,Bizkaia,1394,1152934,200556,952378,723576,104230
2020/05/11,Gipuzkoa,Gipuzkoa,74150,723576,98471,625105,723576,104230
2020/05/11,Gipuzkoa,Navarra,381,654183,99037,555146,723576,104230
2020/05/11,Gipuzkoa,Araba,230,331549,55789,275760,723576,104230
2020/05/11,Girona,Lleida,152,434930,48801,386129,771044,90528
2020/05/11,Girona,Barcelona,2335,5664579,825513,4839066,771044,90528
2020/05/11,Girona,Girona,55785,771044,85836,685208,771044,90528
2020/05/11,Granada,Murcia,44,1493898,220597,1273301,914678,109982
2020/05/11,Granada,Málaga,139,1661785,203614,1458171,914678,109982
2020/05/11,Granada,Granada,79589,914678,113383,801295,914678,109982
2020/05/11,Granada,Jaén,203,633564,65709,567855,914678,109982
2020/05/11,Granada,Córdoba,189,782979,105335,677644,914678,109982
2020/05/11,Granada,Almería,535,716820,93147,623673,914678,109982
2020/05/11,Guadalajara,Madrid,2126,6663394,924603,5738791,257762,38771
2020/05/11,Guadalajara,Guadalajara,21243,257762,36392,221370,257762,38771
2020/05/11,Guadalajara,Cuenca,40,196329,19471,176858,257762,38771
2020/05/11,Guadalajara,Teruel,31,134137,10454,123683,257762,38771
2020/05/11,Huelva,Cádiz,526,1240155,173824,1066331,521870,74366
2020/05/11,Huelva,Sevilla,1375,1942389,288711,1653678,521870,74366
2020/05/11,Huelva,Huelva,54583,521870,70877,450993,521870,74366
2020/05/11,Huelva,Córdoba,17,782979,105335,677644,521870,74366
2020/05/11,Huelva,Badajoz,344,673559,81422,592137,521870,74366
2020/05/11,Huesca,Lleida,803,434930,48801,386129,220461,30125
2020/05/11,Huesca,Huesca,18105,220461,26261,194200,220461,30125
2020/05/11,Huesca,Zaragoza,294,964724,157108,807616,220461,30125
2020/05/11,Jaén,Granada,273,914678,113383,801295,633564,62246
2020/05/11,Jaén,Córdoba,653,782979,105335,677644,633564,62246
2020/05/11,Jaén,Jaén,42943,633564,65709,567855,633564,62246
2020/05/11,Las Palmas de Gran Canaria,Las Palmas de Gran Canaria,155451,1120406,168103,952303,1120406,167147
2020/05/11,Las Palmas de Gran Canaria,Santa Cruz de Tenerife,16,1032983,155129,877854,1120406,167147
2020/05/11,León,Palencia,35,160866,20975,139891,460001,60112
2020/05/11,León,Lugo,31,329587,46644,282943,460001,60112
2020/05/11,León,Valladolid,26,519546,76383,443163,460001,60112
2020/05/11,León,Ourense,346,307651,52842,254809,460001,60112
2020/05/11,León,León,44084,460001,60714,399287,460001,60112
2020/05/11,León,Asturias,59,1022800,155919,866881,460001,60112
2020/05/11,León,Zamora,120,172539,20409,152130,460001,60112
2020/05/11,Lleida,Zaragoza,155,964724,157108,807616,434930,46353
2020/05/11,Lleida,Barcelona,157,5664579,825513,4839066,434930,46353
2020/05/11,Lleida,Girona,168,771044,85836,685208,434930,46353
2020/05/11,Lleida,Lleida,28341,434930,48801,386129,434930,46353
2020/05/11,Lleida,Huesca,466,220461,26261,194200,434930,46353
2020/05/11,Lugo,Asturias,686,1022800,155919,866881,329587,47352
2020/05/11,Lugo,Coruña,721,1119596,185055,934541,329587,47352
2020/05/11,Lugo,Ourense,199,307651,52842,254809,329587,47352
2020/05/11,Lugo,Lugo,32758,329587,46644,282943,329587,47352
2020/05/11,Madrid,Cuenca,77,196329,19471,176858,6663394,930872
2020/05/11,Madrid,Toledo,3408,694844,80591,614253,6663394,930872
2020/05/11,Madrid,Guadalajara,2657,257762,36392,221370,6663394,930872
2020/05/11,Madrid,Melilla,16,86487,12852,73635,6663394,930872
2020/05/11,Madrid,Madrid,517752,6663394,924603,5738791,6663394,930872
2020/05/11,Madrid,Ávila,225,157640,16354,141286,6663394,930872
2020/05/11,Madrid,Segovia,32,153129,18149,134980,6663394,930872
2020/05/11,Málaga,Sevilla,316,1942389,288711,1653678,1661785,211924
2020/05/11,Málaga,Córdoba,287,782979,105335,677644,1661785,211924
2020/05/11,Málaga,Granada,228,914678,113383,801295,1661785,211924
2020/05/11,Málaga,Cádiz,1076,1240155,173824,1066331,1661785,211924
2020/05/11,Málaga,Málaga,164246,1661785,203614,1458171,1661785,211924
2020/05/11,Melilla,Melilla,12752,86487,12852,73635,86487,12953
2020/05/11,Murcia,Murcia,169628,1493898,220597,1273301,1493898,218256
2020/05/11,Murcia,Almería,1285,716820,93147,623673,1493898,218256
2020/05/11,Murcia,Alicante,2275,1858683,262591,1596092,1493898,218256
2020/05/11,Murcia,Albacete,452,388167,34077,354090,1493898,218256
2020/05/11,Murcia,Granada,62,914678,113383,801295,1493898,218256
2020/05/11,Navarra,Navarra,70594,654183,99037,555146,654183,101386
2020/05/11,Navarra,Araba,51,331549,55789,275760,654183,101386
2020/05/11,Navarra,Gipuzkoa,254,723576,98471,625105,654183,101386
2020/05/11,Navarra,Rioja,2343,316798,47933,268865,654183,101386
2020/05/11,Navarra,Zaragoza,572,964724,157108,807616,654183,101386
2020/05/11,Ourense,Zamora,44,172539,20409,152130,307651,52827
2020/05/11,Ourense,León,271,460001,60714,399287,307651,52827
2020/05/11,Ourense,Pontevedra,150,942665,158660,784005,307651,52827
2020/05/11,Ourense,Lugo,313,329587,46644,282943,307651,52827
2020/05/11,Ourense,Ourense,40411,307651,52842,254809,307651,52827
2020/05/11,Palencia,Cantabria,177,580795,87744,493051,160866,22925
2020/05/11,Palencia,Valladolid,231,519546,76383,443163,160866,22925
2020/05/11,Palencia,Burgos,258,357072,41517,315555,160866,22925
2020/05/11,Palencia,León,26,460001,60714,399287,160866,22925
2020/05/11,Palencia,Palencia,15056,160866,20975,139891,160866,22925
2020/05/11,Pontevedra,Pontevedra,122031,942665,158660,784005,942665,155797
2020/05/11,Pontevedra,Ourense,249,307651,52842,254809,942665,155797
2020/05/11,Pontevedra,Coruña,3926,1119596,185055,934541,942665,155797
2020/05/11,Rioja,Burgos,41,357072,41517,315555,316798,45578
2020/05/11,Rioja,Rioja,34775,316798,47933,268865,316798,45578
2020/05/11,Rioja,Araba,692,331549,55789,275760,316798,45578
2020/05/11,Rioja,Navarra,1652,654183,99037,555146,316798,45578
2020/05/11,Salamanca,Zamora,24,172539,20409,152130,330119,41670
2020/05/11,Salamanca,Salamanca,32317,330119,42316,287803,330119,41670
2020/05/11,Salamanca,Ávila,196,157640,16354,141286,330119,41670
2020/05/11,Santa Cruz de Tenerife,Santa Cruz de Tenerife,140302,1032983,155129,877854,1032983,154803
2020/05/11,Santa Cruz de Tenerife,Las Palmas de Gran Canaria,78,1120406,168103,952303,1032983,154803
2020/05/11,Segovia,Burgos,127,357072,41517,315555,153129,19754
2020/05/11,Segovia,Ávila,109,157640,16354,141286,153129,19754
2020/05/11,Segovia,Valladolid,264,519546,76383,443163,153129,19754
2020/05/11,Segovia,Segovia,11633,153129,18149,134980,153129,19754
2020/05/11,Sevilla,Sevilla,199001,1942389,288711,1653678,1942389,281060
2020/05/11,Sevilla,Cádiz,604,1240155,173824,1066331,1942389,281060
2020/05/11,Sevilla,Málaga,129,1661785,203614,1458171,1942389,281060
2020/05/11,Sevilla,Córdoba,1722,782979,105335,677644,1942389,281060
2020/05/11,Sevilla,Badajoz,33,673559,81422,592137,1942389,281060
2020/05/11,Sevilla,Melilla,19,86487,12852,73635,1942389,281060
2020/05/11,Sevilla,Huelva,496,521870,70877,450993,1942389,281060
2020/05/11,Soria,Soria,5269,88636,7046,81590,88636,8708
2020/05/11,Soria,Valladolid,38,519546,76383,443163,88636,8708
2020/05/11,Soria,Guadalajara,18,257762,36392,221370,88636,8708
2020/05/11,Soria,Segovia,21,153129,18149,134980,88636,8708
2020/05/11,Soria,Burgos,36,357072,41517,315555,88636,8708
2020/05/11,Soria,Zaragoza,106,964724,157108,807616,88636,8708
2020/05/11,Tarragona,Castellón,757,579962,74236,505726,804664,104741
2020/05/11,Tarragona,Lleida,61,434930,48801,386129,804664,104741
2020/05/11,Tarragona,Teruel,70,134137,10454,123683,804664,104741
2020/05/11,Tarragona,Tarragona,69348,804664,104948,699716,804664,104741
2020/05/11,Tarragona,Barcelona,874,5664579,825513,4839066,804664,104741
2020/05/11,Teruel,Zaragoza,195,964724,157108,807616,134137,12297
2020/05/11,Teruel,Teruel,6124,134137,10454,123683,134137,12297
2020/05/11,Teruel,Tarragona,85,804664,104948,699716,134137,12297
2020/05/11,Teruel,Castellón,75,579962,74236,505726,134137,12297
2020/05/11,Toledo,Cáceres,148,394151,42467,351684,694844,75521
2020/05/11,Toledo,Toledo,35908,694844,80591,614253,694844,75521
2020/05/11,Toledo,Ávila,143,157640,16354,141286,694844,75521
2020/05/11,Toledo,Cuenca,79,196329,19471,176858,694844,75521
2020/05/11,Toledo,Madrid,3015,6663394,924603,5738791,694844,75521
2020/05/11,Toledo,Ciudad Real,311,495761,43067,452694,694844,75521
2020/05/11,Valencia,Albacete,385,388167,34077,354090,2565124,398390
2020/05/11,Valencia,Castellón,735,579962,74236,505726,2565124,398390
2020/05/11,Valencia,Valencia,280314,2565124,409763,2155361,2565124,398390
2020/05/11,Valencia,Alicante,1045,1858683,262591,1596092,2565124,398390
2020/05/11,Valencia,Murcia,27,1493898,220597,1273301,2565124,398390
2020/05/11,Valencia,Cuenca,124,196329,19471,176858,2565124,398390
2020/05/11,Valladolid,Salamanca,28,330119,42316,287803,519546,73882
2020/05/11,Valladolid,Soria,31,88636,7046,81590,519546,73882
2020/05/11,Valladolid,Segovia,222,153129,18149,134980,519546,73882
2020/05/11,Valladolid,Burgos,50,357072,41517,315555,519546,73882
2020/05/11,Valladolid,León,26,460001,60714,399287,519546,73882
2020/05/11,Valladolid,Valladolid,53940,519546,76383,443163,519546,73882
2020/05/11,Valladolid,Palencia,41,160866,20975,139891,519546,73882
2020/05/11,Valladolid,Zamora,212,172539,20409,152130,519546,73882
2020/05/11,Zamora,Valladolid,63,519546,76383,443163,172539,20502
2020/05/11,Zamora,Salamanca,35,330119,42316,287803,172539,20502
2020/05/11,Zamora,Zamora,13494,172539,20409,152130,172539,20502
2020/05/11,Zamora,Ourense,43,307651,52842,254809,172539,20502
2020/05/11,Zamora,León,140,460001,60714,399287,172539,20502
2020/05/11,Zaragoza,Zaragoza,119183,964724,157108,807616,964724,153298
2020/05/11,Zaragoza,Soria,39,88636,7046,81590,964724,153298
2020/05/11,Zaragoza,Huesca,348,220461,26261,194200,964724,153298
2020/05/11,Zaragoza,Teruel,251,134137,10454,123683,964724,153298
2020/05/11,Zaragoza,Navarra,342,654183,99037,555146,964724,153298
2020/05/11,Zaragoza,Lleida,111,434930,48801,386129,964724,153298
2020/05/12,Albacete,Cuenca,602,196329,19995,176334,388167,35292
2020/05/12,Albacete,Alicante,242,1858683,283045,1575638,388167,35292
2020/05/12,Albacete,Murcia,625,1493898,246154,1247744,388167,35292
2020/05/12,Albacete,Ciudad Real,504,495761,41837,453924,388167,35292
2020/05/12,Albacete,Valencia,446,2565124,433353,2131771,388167,35292
2020/05/12,Albacete,Albacete,21765,388167,34831,353336,388167,35292
2020/05/12,Alicante,Albacete,335,388167,34831,353336,1858683,287944
2020/05/12,Alicante,Valencia,1377,2565124,433353,2131771,1858683,287944
2020/05/12,Alicante,Alicante,223014,1858683,283045,1575638,1858683,287944
2020/05/12,Alicante,Murcia,3458,1493898,246154,1247744,1858683,287944
2020/05/12,Almería,Granada,635,914678,113422,801256,716820,103304
2020/05/12,Almería,Melilla,21,86487,13386,73101,716820,103304
2020/05/12,Almería,Murcia,2311,1493898,246154,1247744,716820,103304
2020/05/12,Almería,Córdoba,17,782979,108910,674069,716820,103304
2020/05/12,Almería,Almería,83863,716820,100303,616517,716820,103304
2020/05/12,Araba,Burgos,1910,357072,44938,312134,331549,68726
2020/05/12,Araba,Bizkaia,1556,1152934,219098,933836,331549,68726
2020/05/12,Araba,Gipuzkoa,168,723576,107410,616166,331549,68726
2020/05/12,Araba,Araba,50498,331549,61040,270509,331549,68726
2020/05/12,Araba,Rioja,2270,316798,53033,263765,331549,68726
2020/05/12,Araba,Navarra,197,654183,111508,542675,331549,68726
2020/05/12,Asturias,Cantabria,266,580795,96959,483836,1022800,161062
2020/05/12,Asturias,León,62,460001,65078,394923,1022800,161062
2020/05/12,Asturias,Lugo,960,329587,47128,282459,1022800,161062
2020/05/12,Asturias,Asturias,130924,1022800,161644,861156,1022800,161062
2020/05/12,Ávila,Salamanca,283,330119,44921,285198,157640,17603
2020/05/12,Ávila,Toledo,250,694844,84687,610157,157640,17603
2020/05/12,Ávila,Segovia,140,153129,19811,133318,157640,17603
2020/05/12,Ávila,Madrid,120,6663394,981586,5681808,157640,17603
2020/05/12,Ávila,Ávila,10888,157640,17023,140617,157640,17603
2020/05/12,Ávila,Cáceres,95,394151,45603,348548,157640,17603
2020/05/12,Badajoz,Ciudad Real,36,495761,41837,453924,673559,86561
2020/05/12,Badajoz,Córdoba,43,782979,108910,674069,673559,86561
2020/05/12,Badajoz,Huelva,210,521870,73773,448097,673559,86561
2020/05/12,Badajoz,Sevilla,64,1942389,306794,1635595,673559,86561
2020/05/12,Badajoz,Badajoz,64985,673559,87065,586494,673559,86561
2020/05/12,Badajoz,Cáceres,1132,394151,45603,348548,673559,86561
2020/05/12,Balears,Balears,157437,1149460,177197,972263,1149460,177711
2020/05/12,Balears,Valencia,29,2565124,433353,2131771,1149460,177711
2020/05/12,Barcelona,Tarragona,1698,804664,117591,687073,5664579,943970
2020/05/12,Barcelona,Barcelona,598424,5664579,944492,4720087,5664579,943970
2020/05/12,Barcelona,Lleida,210,434930,64754,370176,5664579,943970
2020/05/12,Barcelona,Girona,2755,771044,93827,677217,5664579,943970
2020/05/12,Bizkaia,Gipuzkoa,1124,723576,107410,616166,1152934,215063
2020/05/12,Bizkaia,Araba,845,331549,61040,270509,1152934,215063
2020/05/12,Bizkaia,Bizkaia,168339,1152934,219098,933836,1152934,215063
2020/05/12,Bizkaia,Cantabria,2549,580795,96959,483836,1152934,215063
2020/05/12,Bizkaia,Burgos,64,357072,44938,312134,1152934,215063
2020/05/12,Burgos,Burgos,32980,357072,44938,312134,357072,45482
2020/05/12,Burgos,Valladolid,63,519546,82871,436675,357072,45482
2020/05/12,Burgos,Segovia,43,153129,19811,133318,357072,45482
2020/05/12,Burgos,Soria,34,88636,7811,80825,357072,45482
2020/05/12,Burgos,Bizkaia,118,1152934,219098,933836,357072,45482
2020/05/12,Burgos,Rioja,29,316798,53033,263765,357072,45482
2020/05/12,Burgos,Araba,1014,331549,61040,270509,357072,45482
2020/05/12,Burgos,Palencia,198,160866,22013,138853,357072,45482
2020/05/12,Cáceres,Badajoz,1184,673559,87065,586494,394151,45688
2020/05/12,Cáceres,Ávila,148,157640,17023,140617,394151,45688
2020/05/12,Cáceres,Toledo,185,694844,84687,610157,394151,45688
2020/05/12,Cáceres,Cáceres,31446,394151,45603,348548,394151,45688
2020/05/12,Cádiz,Málaga,1177,1661785,203532,1458253,1240155,180771
2020/05/12,Cádiz,Cádiz,149384,1240155,177959,1062196,1240155,180771
2020/05/12,Cádiz,Sevilla,934,1942389,306794,1635595,1240155,180771
2020/05/12,Cádiz,Huelva,711,521870,73773,448097,1240155,180771
2020/05/12,Cantabria,Palencia,101,160866,22013,138853,580795,92390
2020/05/12,Cantabria,Cantabria,71445,580795,96959,483836,580795,92390
2020/05/12,Cantabria,Asturias,240,1022800,161644,861156,580795,92390
2020/05/12,Cantabria,Bizkaia,603,1152934,219098,933836,580795,92390
2020/05/12,Castellón,Valencia,802,2565124,433353,2131771,579962,82894
2020/05/12,Castellón,Teruel,104,134137,11242,122895,579962,82894
2020/05/12,Castellón,Tarragona,1019,804664,117591,687073,579962,82894
2020/05/12,Castellón,Castellón,58485,579962,78530,501432,579962,82894
2020/05/12,Ceuta,Ceuta,10429,84777,10833,73944,84777,10836
2020/05/12,Ciudad Real,Ciudad Real,24578,495761,41837,453924,495761,38802
2020/05/12,Ciudad Real,Albacete,418,388167,34831,353336,495761,38802
2020/05/12,Ciudad Real,Toledo,289,694844,84687,610157,495761,38802
2020/05/12,Ciudad Real,Córdoba,357,782979,108910,674069,495761,38802
2020/05/12,Ciudad Real,Badajoz,41,673559,87065,586494,495761,38802
2020/05/12,Córdoba,Málaga,130,1661785,203532,1458253,782979,106895
2020/05/12,Córdoba,Sevilla,1602,1942389,306794,1635595,782979,106895
2020/05/12,Córdoba,Granada,103,914678,113422,801256,782979,106895
2020/05/12,Córdoba,Jaén,616,633564,64120,569444,782979,106895
2020/05/12,Córdoba,Córdoba,78317,782979,108910,674069,782979,106895
2020/05/12,Córdoba,Ciudad Real,263,495761,41837,453924,782979,106895
2020/05/12,Córdoba,Badajoz,97,673559,87065,586494,782979,106895
2020/05/12,Coruña,Pontevedra,5280,942665,167717,774948,1119596,192385
2020/05/12,Coruña,Coruña,147521,1119596,190688,928908,1119596,192385
2020/05/12,Coruña,Lugo,641,329587,47128,282459,1119596,192385
2020/05/12,Cuenca,Cuenca,10725,196329,19995,176334,196329,20745
2020/05/12,Cuenca,Toledo,155,694844,84687,610157,196329,20745
2020/05/12,Cuenca,Albacete,588,388167,34831,353336,196329,20745
2020/05/12,Cuenca,Valencia,57,2565124,433353,2131771,196329,20745
2020/05/12,Cuenca,Madrid,49,6663394,981586,5681808,196329,20745
2020/05/12,Cuenca,Ciudad Real,74,495761,41837,453924,196329,20745
2020/05/12,Cuenca,Guadalajara,78,257762,38985,218777,196329,20745
2020/05/12,Gipuzkoa,Gipuzkoa,82434,723576,107410,616166,723576,112646
2020/05/12,Gipuzkoa,Araba,188,331549,61040,270509,723576,112646
2020/05/12,Gipuzkoa,Navarra,404,654183,111508,542675,723576,112646
2020/05/12,Gipuzkoa,Bizkaia,1594,1152934,219098,933836,723576,112646
2020/05/12,Girona,Girona,63388,771044,93827,677217,771044,100217
2020/05/12,Girona,Lleida,166,434930,64754,370176,771044,100217
2020/05/12,Girona,Tarragona,22,804664,117591,687073,771044,100217
2020/05/12,Girona,Barcelona,2311,5664579,944492,4720087,771044,100217
2020/05/12,Girona,Castellón,16,579962,78530,501432,771044,100217
2020/05/12,Granada,Córdoba,178,782979,108910,674069,914678,110096
2020/05/12,Granada,Jaén,140,633564,64120,569444,914678,110096
2020/05/12,Granada,Almería,363,716820,100303,616517,914678,110096
2020/05/12,Granada,Málaga,116,1661785,203532,1458253,914678,110096
2020/05/12,Granada,Murcia,17,1493898,246154,1247744,914678,110096
2020/05/12,Granada,Granada,82101,914678,113422,801256,914678,110096
2020/05/12,Guadalajara,Guadalajara,23038,257762,38985,218777,257762,40440
2020/05/12,Guadalajara,Madrid,2548,6663394,981586,5681808,257762,40440
2020/05/12,Guadalajara,Cuenca,22,196329,19995,176334,257762,40440
2020/05/12,Huelva,Badajoz,357,673559,87065,586494,521870,77715
2020/05/12,Huelva,Sevilla,1551,1942389,306794,1635595,521870,77715
2020/05/12,Huelva,Cádiz,613,1240155,177959,1062196,521870,77715
2020/05/12,Huelva,Huelva,58585,521870,73773,448097,521870,77715
2020/05/12,Huesca,Huesca,22524,220461,31529,188932,220461,34713
2020/05/12,Huesca,Lleida,1165,434930,64754,370176,220461,34713
2020/05/12,Huesca,Zaragoza,297,964724,176093,788631,220461,34713
2020/05/12,Jaén,Jaén,44240,633564,64120,569444,633564,62370
2020/05/12,Jaén,Granada,141,914678,113422,801256,633564,62370
2020/05/12,Jaén,Córdoba,615,782979,108910,674069,633564,62370
2020/05/12,Las Palmas de Gran Canaria,Las Palmas de Gran Canaria,167909,1120406,180376,940030,1120406,179998
2020/05/12,León,Palencia,28,160866,22013,138853,460001,64885
2020/05/12,León,Ourense,343,307651,52338,255313,460001,64885
2020/05/12,León,Zamora,243,172539,21762,150777,460001,64885
2020/05/12,León,Valladolid,43,519546,82871,436675,460001,64885
2020/05/12,León,León,49133,460001,65078,394923,460001,64885
2020/05/12,León,Asturias,44,1022800,161644,861156,460001,64885
2020/05/12,León,Lugo,26,329587,47128,282459,460001,64885
2020/05/12,Lleida,Tarragona,76,804664,117591,687073,434930,62660
2020/05/12,Lleida,Barcelona,214,5664579,944492,4720087,434930,62660
2020/05/12,Lleida,Zaragoza,184,964724,176093,788631,434930,62660
2020/05/12,Lleida,Lleida,42662,434930,64754,370176,434930,62660
2020/05/12,Lleida,Girona,210,771044,93827,677217,434930,62660
2020/05/12,Lleida,Huesca,760,220461,31529,188932,434930,62660
2020/05/12,Lugo,Coruña,657,1119596,190688,928908,329587,48670
2020/05/12,Lugo,Asturias,791,1022800,161644,861156,329587,48670
2020/05/12,Lugo,Ourense,238,307651,52338,255313,329587,48670
2020/05/12,Lugo,Lugo,34143,329587,47128,282459,329587,48670
2020/05/12,Madrid,Guadalajara,3017,257762,38985,218777,6663394,982787
2020/05/12,Madrid,Segovia,24,153129,19811,133318,6663394,982787
2020/05/12,Madrid,Cuenca,85,196329,19995,176334,6663394,982787
2020/05/12,Madrid,Madrid,565823,6663394,981586,5681808,6663394,982787
2020/05/12,Madrid,Ávila,190,157640,17023,140617,6663394,982787
2020/05/12,Madrid,Toledo,3810,694844,84687,610157,6663394,982787
2020/05/12,Málaga,Málaga,166434,1661785,203532,1458253,1661785,207238
2020/05/12,Málaga,Granada,210,914678,113422,801256,1661785,207238
2020/05/12,Málaga,Cádiz,970,1240155,177959,1062196,1661785,207238
2020/05/12,Málaga,Córdoba,246,782979,108910,674069,1661785,207238
2020/05/12,Málaga,Sevilla,207,1942389,306794,1635595,1661785,207238
2020/05/12,Melilla,Melilla,13197,86487,13386,73101,86487,13389
2020/05/12,Murcia,Murcia,193525,1493898,246154,1247744,1493898,240483
2020/05/12,Murcia,Albacete,553,388167,34831,353336,1493898,240483
2020/05/12,Murcia,Almería,1335,716820,100303,616517,1493898,240483
2020/05/12,Murcia,Alicante,2856,1858683,283045,1575638,1493898,240483
2020/05/12,Navarra,Rioja,2628,316798,53033,263765,654183,113373
2020/05/12,Navarra,Navarra,82368,654183,111508,542675,654183,113373
2020/05/12,Navarra,Gipuzkoa,338,723576,107410,616166,654183,113373
2020/05/12,Navarra,Zaragoza,677,964724,176093,788631,654183,113373
2020/05/12,Navarra,Araba,102,331549,61040,270509,654183,113373
2020/05/12,Ourense,Ourense,40868,307651,52338,255313,307651,53245
2020/05/12,Ourense,Lugo,163,329587,47128,282459,307651,53245
2020/05/12,Ourense,León,354,460001,65078,394923,307651,53245
2020/05/12,Ourense,Pontevedra,209,942665,167717,774948,307651,53245
2020/05/12,Ourense,Zamora,69,172539,21762,150777,307651,53245
2020/05/12,Palencia,Valladolid,222,519546,82871,436675,160866,23490
2020/05/12,Palencia,Cantabria,176,580795,96959,483836,160866,23490
2020/05/12,Palencia,León,26,460001,65078,394923,160866,23490
2020/05/12,Palencia,Burgos,236,357072,44938,312134,160866,23490
2020/05/12,Palencia,Palencia,15736,160866,22013,138853,160866,23490
2020/05/12,Pontevedra,Ourense,194,307651,52338,255313,942665,166818
2020/05/12,Pontevedra,Lugo,26,329587,47128,282459,942665,166818
2020/05/12,Pontevedra,Pontevedra,132080,942665,167717,774948,942665,166818
2020/05/12,Pontevedra,Coruña,4214,1119596,190688,928908,942665,166818
2020/05/12,Rioja,Rioja,39461,316798,53033,263765,316798,51095
2020/05/12,Rioja,Araba,913,331549,61040,270509,316798,51095
2020/05/12,Rioja,Navarra,2141,654183,111508,542675,316798,51095
2020/05/12,Rioja,Burgos,73,357072,44938,312134,316798,51095
2020/05/12,Salamanca,Salamanca,35303,330119,44921,285198,330119,44671
2020/05/12,Salamanca,Ávila,220,157640,17023,140617,330119,44671
2020/05/12,Santa Cruz de Tenerife,Las Palmas de Gran Canaria,47,1120406,180376,940030,1032983,164021
2020/05/12,Santa Cruz de Tenerife,Santa Cruz de Tenerife,150176,1032983,164414,868569,1032983,164021
2020/05/12,Segovia,Ávila,136,157640,17023,140617,153129,21364
2020/05/12,Segovia,Valladolid,314,519546,82871,436675,153129,21364
2020/05/12,Segovia,Segovia,13070,153129,19811,133318,153129,21364
2020/05/12,Segovia,Burgos,104,357072,44938,312134,153129,21364
2020/05/12,Sevilla,Cádiz,762,1240155,177959,1062196,1942389,300229
2020/05/12,Sevilla,Sevilla,220699,1942389,306794,1635595,1942389,300229
2020/05/12,Sevilla,Málaga,84,1661785,203532,1458253,1942389,300229
2020/05/12,Sevilla,Córdoba,1791,782979,108910,674069,1942389,300229
2020/05/12,Sevilla,Huelva,360,521870,73773,448097,1942389,300229
2020/05/12,Soria,Valladolid,40,519546,82871,436675,88636,8894
2020/05/12,Soria,Segovia,25,153129,19811,133318,88636,8894
2020/05/12,Soria,Zaragoza,105,964724,176093,788631,88636,8894
2020/05/12,Soria,Soria,5774,88636,7811,80825,88636,8894
2020/05/12,Soria,Burgos,62,357072,44938,312134,88636,8894
2020/05/12,Tarragona,Tarragona,81204,804664,117591,687073,804664,116939
2020/05/12,Tarragona,Castellón,873,579962,78530,501432,804664,116939
2020/05/12,Tarragona,Teruel,75,134137,11242,122895,804664,116939
2020/05/12,Tarragona,Barcelona,1005,5664579,944492,4720087,804664,116939
2020/05/12,Tarragona,Lleida,27,434930,64754,370176,804664,116939
2020/05/12,Tarragona,Zaragoza,37,964724,176093,788631,804664,116939
2020/05/12,Teruel,Zaragoza,180,964724,176093,788631,134137,13098
2020/05/12,Teruel,Castellón,114,579962,78530,501432,134137,13098
2020/05/12,Teruel,Valencia,16,2565124,433353,2131771,134137,13098
2020/05/12,Teruel,Teruel,6859,134137,11242,122895,134137,13098
2020/05/12,Teruel,Tarragona,113,804664,117591,687073,134137,13098
2020/05/12,Toledo,Cáceres,167,394151,45603,348548,694844,80305
2020/05/12,Toledo,Cuenca,131,196329,19995,176334,694844,80305
2020/05/12,Toledo,Toledo,39172,694844,84687,610157,694844,80305
2020/05/12,Toledo,Madrid,3405,6663394,981586,5681808,694844,80305
2020/05/12,Toledo,Ciudad Real,268,495761,41837,453924,694844,80305
2020/05/12,Toledo,Ávila,278,157640,17023,140617,694844,80305
2020/05/12,Valencia,Murcia,35,1493898,246154,1247744,2565124,422595
2020/05/12,Valencia,Valencia,305734,2565124,433353,2131771,2565124,422595
2020/05/12,Valencia,Castellón,783,579962,78530,501432,2565124,422595
2020/05/12,Valencia,Alicante,1149,1858683,283045,1575638,2565124,422595
2020/05/12,Valencia,Albacete,344,388167,34831,353336,2565124,422595
2020/05/12,Valencia,Cuenca,101,196329,19995,176334,2565124,422595
2020/05/12,Valladolid,Segovia,279,153129,19811,133318,519546,80198
2020/05/12,Valladolid,Burgos,84,357072,44938,312134,519546,80198
2020/05/12,Valladolid,Palencia,74,160866,22013,138853,519546,80198
2020/05/12,Valladolid,Soria,24,88636,7811,80825,519546,80198
2020/05/12,Valladolid,Ávila,21,157640,17023,140617,519546,80198
2020/05/12,Valladolid,León,31,460001,65078,394923,519546,80198
2020/05/12,Valladolid,Valladolid,60839,519546,82871,436675,519546,80198
2020/05/12,Valladolid,Zamora,132,172539,21762,150777,519546,80198
2020/05/12,Zamora,Ourense,92,307651,52338,255313,172539,21523
2020/05/12,Zamora,León,95,460001,65078,394923,172539,21523
2020/05/12,Zamora,Zamora,14865,172539,21762,150777,172539,21523
2020/05/12,Zamora,Valladolid,94,519546,82871,436675,172539,21523
2020/05/12,Zaragoza,Huesca,326,220461,31529,188932,964724,170763
2020/05/12,Zaragoza,Lleida,160,434930,64754,370176,964724,170763
2020/05/12,Zaragoza,Navarra,542,654183,111508,542675,964724,170763
2020/05/12,Zaragoza,Soria,81,88636,7811,80825,964724,170763
2020/05/12,Zaragoza,Teruel,259,134137,11242,122895,964724,170763
2020/05/12,Zaragoza,Zaragoza,137573,964724,176093,788631,964724,170763
2020/05/13,Albacete,Ciudad Real,551,495761,42879,452882,388167,35021
2020/05/13,Albacete,Albacete,21192,388167,34235,353932,388167,35021
2020/05/13,Albacete,Cuenca,588,196329,19420,176909,388167,35021
2020/05/13,Albacete,Alicante,236,1858683,281239,1577444,388167,35021
2020/05/13,Albacete,Murcia,582,1493898,243314,1250584,388167,35021
2020/05/13,Albacete,Valencia,406,2565124,421462,2143662,388167,35021
2020/05/13,Alicante,Valencia,1405,2565124,421462,2143662,1858683,286513
2020/05/13,Alicante,Albacete,383,388167,34235,353932,1858683,286513
2020/05/13,Alicante,Murcia,3470,1493898,243314,1250584,1858683,286513
2020/05/13,Alicante,Alicante,220718,1858683,281239,1577444,1858683,286513
2020/05/13,Almería,Almería,83024,716820,99454,617366,716820,102219
2020/05/13,Almería,Murcia,2226,1493898,243314,1250584,716820,102219
2020/05/13,Almería,Granada,483,914678,119688,794990,716820,102219
2020/05/13,Araba,Gipuzkoa,145,723576,108802,614774,331549,67706
2020/05/13,Araba,Navarra,167,654183,107186,546997,331549,67706
2020/05/13,Araba,Araba,49874,331549,60306,271243,331549,67706
2020/05/13,Araba,Bizkaia,1559,1152934,222539,930395,331549,67706
2020/05/13,Araba,Rioja,1994,316798,49921,266877,331549,67706
2020/05/13,Araba,Burgos,1880,357072,43575,313497,331549,67706
2020/05/13,Asturias,Cantabria,249,580795,95606,485189,1022800,158510
2020/05/13,Asturias,León,38,460001,64114,395887,1022800,158510
2020/05/13,Asturias,Asturias,128634,1022800,158701,864099,1022800,158510
2020/05/13,Asturias,Lugo,990,329587,46578,283009,1022800,158510
2020/05/13,Ávila,Madrid,75,6663394,960073,5703321,157640,17428
2020/05/13,Ávila,Cáceres,98,394151,42244,351907,157640,17428
2020/05/13,Ávila,Salamanca,297,330119,44408,285711,157640,17428
2020/05/13,Ávila,Ávila,10940,157640,17062,140578,157640,17428
2020/05/13,Ávila,Segovia,77,153129,19066,134063,157640,17428
2020/05/13,Ávila,Toledo,252,694844,83717,611127,157640,17428
2020/05/13,Badajoz,Cáceres,1151,394151,42244,351907,673559,87342
2020/05/13,Badajoz,Huelva,236,521870,74268,447602,673559,87342
2020/05/13,Badajoz,Córdoba,94,782979,112242,670737,673559,87342
2020/05/13,Badajoz,Sevilla,56,1942389,310425,1631964,673559,87342
2020/05/13,Badajoz,Badajoz,65597,673559,88632,584927,673559,87342
2020/05/13,Badajoz,Ciudad Real,43,495761,42879,452882,673559,87342
2020/05/13,Balears,Barcelona,16,5664579,943272,4721307,1149460,174610
2020/05/13,Balears,Balears,155059,1149460,173666,975794,1149460,174610
2020/05/13,Balears,Valencia,36,2565124,421462,2143662,1149460,174610
2020/05/13,Barcelona,Barcelona,596586,5664579,943272,4721307,5664579,939718
2020/05/13,Barcelona,Tarragona,1852,804664,115500,689164,5664579,939718
2020/05/13,Barcelona,Lleida,195,434930,63644,371286,5664579,939718
2020/05/13,Barcelona,Girona,2907,771044,94089,676955,5664579,939718
2020/05/13,Bizkaia,Cantabria,2627,580795,95606,485189,1152934,217762
2020/05/13,Bizkaia,Araba,865,331549,60306,271243,1152934,217762
2020/05/13,Bizkaia,Gipuzkoa,1001,723576,108802,614774,1152934,217762
2020/05/13,Bizkaia,Bizkaia,171883,1152934,222539,930395,1152934,217762
2020/05/13,Bizkaia,Burgos,86,357072,43575,313497,1152934,217762
2020/05/13,Burgos,Cantabria,24,580795,95606,485189,357072,43918
2020/05/13,Burgos,Soria,31,88636,7800,80836,357072,43918
2020/05/13,Burgos,Bizkaia,169,1152934,222539,930395,357072,43918
2020/05/13,Burgos,Valladolid,153,519546,56505,463041,357072,43918
2020/05/13,Burgos,Palencia,181,160866,21105,139761,357072,43918
2020/05/13,Burgos,Burgos,31675,357072,43575,313497,357072,43918
2020/05/13,Burgos,Rioja,50,316798,49921,266877,357072,43918
2020/05/13,Burgos,Segovia,45,153129,19066,134063,357072,43918
2020/05/13,Burgos,Araba,1053,331549,60306,271243,357072,43918
2020/05/13,Cáceres,Badajoz,1295,673559,88632,584927,394151,42762
2020/05/13,Cáceres,Ávila,116,157640,17062,140578,394151,42762
2020/05/13,Cáceres,Cáceres,28621,394151,42244,351907,394151,42762
2020/05/13,Cáceres,Toledo,183,694844,83717,611127,394151,42762
2020/05/13,Cádiz,Málaga,1514,1661785,219338,1442447,1240155,185971
2020/05/13,Cádiz,Ceuta,26,84777,11401,73376,1240155,185971
2020/05/13,Cádiz,Cádiz,154284,1240155,184977,1055178,1240155,185971
2020/05/13,Cádiz,Huelva,760,521870,74268,447602,1240155,185971
2020/05/13,Cádiz,Sevilla,748,1942389,310425,1631964,1240155,185971
2020/05/13,Cantabria,Palencia,71,160866,21105,139761,580795,91041
2020/05/13,Cantabria,Cantabria,69955,580795,95606,485189,580795,91041
2020/05/13,Cantabria,Bizkaia,642,1152934,222539,930395,580795,91041
2020/05/13,Cantabria,Asturias,248,1022800,158701,864099,580795,91041
2020/05/13,Castellón,Teruel,90,134137,11020,123117,579962,79459
2020/05/13,Castellón,Castellón,55570,579962,75184,504778,579962,79459
2020/05/13,Castellón,Tarragona,1109,804664,115500,689164,579962,79459
2020/05/13,Castellón,Valencia,646,2565124,421462,2143662,579962,79459
2020/05/13,Ceuta,Ceuta,10970,84777,11401,73376,84777,11448
2020/05/13,Ciudad Real,Jaén,16,633564,67645,565919,495761,39770
2020/05/13,Ciudad Real,Badajoz,54,673559,88632,584927,495761,39770
2020/05/13,Ciudad Real,Albacete,417,388167,34235,353932,495761,39770
2020/05/13,Ciudad Real,Toledo,241,694844,83717,611127,495761,39770
2020/05/13,Ciudad Real,Córdoba,447,782979,112242,670737,495761,39770
2020/05/13,Ciudad Real,Ciudad Real,25033,495761,42879,452882,495761,39770
2020/05/13,Córdoba,Córdoba,80614,782979,112242,670737,782979,109509
2020/05/13,Córdoba,Ciudad Real,288,495761,42879,452882,782979,109509
2020/05/13,Córdoba,Sevilla,1548,1942389,310425,1631964,782979,109509
2020/05/13,Córdoba,Málaga,127,1661785,219338,1442447,782979,109509
2020/05/13,Córdoba,Jaén,613,633564,67645,565919,782979,109509
2020/05/13,Córdoba,Granada,117,914678,119688,794990,782979,109509
2020/05/13,Córdoba,Badajoz,89,673559,88632,584927,782979,109509
2020/05/13,Coruña,Coruña,146727,1119596,189989,929607,1119596,191716
2020/05/13,Coruña,Lugo,684,329587,46578,283009,1119596,191716
2020/05/13,Coruña,Pontevedra,5154,942665,168644,774021,1119596,191716
2020/05/13,Cuenca,Valencia,70,2565124,421462,2143662,196329,20334
2020/05/13,Cuenca,Albacete,680,388167,34235,353932,196329,20334
2020/05/13,Cuenca,Toledo,203,694844,83717,611127,196329,20334
2020/05/13,Cuenca,Ciudad Real,43,495761,42879,452882,196329,20334
2020/05/13,Cuenca,Guadalajara,48,257762,37273,220489,196329,20334
2020/05/13,Cuenca,Cuenca,10412,196329,19420,176909,196329,20334
2020/05/13,Cuenca,Madrid,79,6663394,960073,5703321,196329,20334
2020/05/13,Gipuzkoa,Navarra,395,654183,107186,546997,723576,113769
2020/05/13,Gipuzkoa,Araba,244,331549,60306,271243,723576,113769
2020/05/13,Gipuzkoa,Bizkaia,1880,1152934,222539,930395,723576,113769
2020/05/13,Gipuzkoa,Gipuzkoa,83601,723576,108802,614774,723576,113769
2020/05/13,Girona,Girona,62907,771044,94089,676955,771044,99270
2020/05/13,Girona,Lleida,201,434930,63644,371286,771044,99270
2020/05/13,Girona,Barcelona,2540,5664579,943272,4721307,771044,99270
2020/05/13,Girona,Murcia,22,1493898,243314,1250584,771044,99270
2020/05/13,Granada,Murcia,32,1493898,243314,1250584,914678,117053
2020/05/13,Granada,Almería,491,716820,99454,617366,914678,117053
2020/05/13,Granada,Córdoba,154,782979,112242,670737,914678,117053
2020/05/13,Granada,Granada,87184,914678,119688,794990,914678,117053
2020/05/13,Granada,Jaén,307,633564,67645,565919,914678,117053
2020/05/13,Granada,Málaga,149,1661785,219338,1442447,914678,117053
2020/05/13,Guadalajara,Madrid,2259,6663394,960073,5703321,257762,38968
2020/05/13,Guadalajara,Cuenca,77,196329,19420,176909,257762,38968
2020/05/13,Guadalajara,Guadalajara,21506,257762,37273,220489,257762,38968
2020/05/13,Huelva,Badajoz,342,673559,88632,584927,521870,78150
2020/05/13,Huelva,Huelva,58362,521870,74268,447602,521870,78150
2020/05/13,Huelva,Sevilla,1546,1942389,310425,1631964,521870,78150
2020/05/13,Huelva,Cádiz,548,1240155,184977,1055178,521870,78150
2020/05/13,Huesca,Huesca,20374,220461,29006,191455,220461,32633
2020/05/13,Huesca,Zaragoza,317,964724,172837,791887,220461,32633
2020/05/13,Huesca,Lleida,1143,434930,63644,371286,220461,32633
2020/05/13,Jaén,Albacete,16,388167,34235,353932,633564,66438
2020/05/13,Jaén,Málaga,19,1661785,219338,1442447,633564,66438
2020/05/13,Jaén,Córdoba,639,782979,112242,670737,633564,66438
2020/05/13,Jaén,Jaén,47054,633564,67645,565919,633564,66438
2020/05/13,Jaén,Granada,187,914678,119688,794990,633564,66438
2020/05/13,Las Palmas de Gran Canaria,Santa Cruz de Tenerife,33,1032983,162791,870192,1120406,179068
2020/05/13,Las Palmas de Gran Canaria,Las Palmas de Gran Canaria,167698,1120406,179554,940852,1120406,179068
2020/05/13,León,León,47929,460001,64114,395887,460001,63789
2020/05/13,León,Asturias,70,1022800,158701,864099,460001,63789
2020/05/13,León,Ourense,388,307651,52397,255254,460001,63789
2020/05/13,León,Zamora,155,172539,21205,151334,460001,63789
2020/05/13,Lleida,Girona,202,771044,94089,676955,434930,60948
2020/05/13,Lleida,Barcelona,288,5664579,943272,4721307,434930,60948
2020/05/13,Lleida,Lleida,41059,434930,63644,371286,434930,60948
2020/05/13,Lleida,Zaragoza,166,964724,172837,791887,434930,60948
2020/05/13,Lleida,Huesca,660,220461,29006,191455,434930,60948
2020/05/13,Lugo,Coruña,722,1119596,189989,929607,329587,48105
2020/05/13,Lugo,Ourense,220,307651,52397,255254,329587,48105
2020/05/13,Lugo,Asturias,791,1022800,158701,864099,329587,48105
2020/05/13,Lugo,Lugo,33502,329587,46578,283009,329587,48105
2020/05/13,Lugo,Pontevedra,30,942665,168644,774021,329587,48105
2020/05/13,Madrid,Cuenca,82,196329,19420,176909,6663394,965119
2020/05/13,Madrid,Madrid,546274,6663394,960073,5703321,6663394,965119
2020/05/13,Madrid,Toledo,3681,694844,83717,611127,6663394,965119
2020/05/13,Madrid,Guadalajara,2768,257762,37273,220489,6663394,965119
2020/05/13,Madrid,Ávila,215,157640,17062,140578,6663394,965119
2020/05/13,Madrid,Ciudad Real,32,495761,42879,452882,6663394,965119
2020/05/13,Madrid,Alicante,19,1858683,281239,1577444,6663394,965119
2020/05/13,Madrid,Segovia,53,153129,19066,134063,6663394,965119
2020/05/13,Málaga,Sevilla,341,1942389,310425,1631964,1661785,223367
2020/05/13,Málaga,Granada,263,914678,119688,794990,1661785,223367
2020/05/13,Málaga,Málaga,180356,1661785,219338,1442447,1661785,223367
2020/05/13,Málaga,Córdoba,218,782979,112242,670737,1661785,223367
2020/05/13,Málaga,Cádiz,1128,1240155,184977,1055178,1661785,223367
2020/05/13,Melilla,Melilla,13156,86487,13279,73208,86487,13340
2020/05/13,Murcia,Albacete,560,388167,34235,353932,1493898,237248
2020/05/13,Murcia,Almería,1352,716820,99454,617366,1493898,237248
2020/05/13,Murcia,Murcia,190222,1493898,243314,1250584,1493898,237248
2020/05/13,Murcia,Alicante,2836,1858683,281239,1577444,1493898,237248
2020/05/13,Murcia,Granada,47,914678,119688,794990,1493898,237248
2020/05/13,Navarra,Rioja,2571,316798,49921,266877,654183,109087
2020/05/13,Navarra,Araba,86,331549,60306,271243,654183,109087
2020/05/13,Navarra,Alicante,19,1858683,281239,1577444,654183,109087
2020/05/13,Navarra,Gipuzkoa,437,723576,108802,614774,654183,109087
2020/05/13,Navarra,Navarra,78393,654183,107186,546997,654183,109087
2020/05/13,Navarra,Zaragoza,603,964724,172837,791887,654183,109087
2020/05/13,Ourense,Lugo,152,329587,46578,283009,307651,52786
2020/05/13,Ourense,Ourense,41234,307651,52397,255254,307651,52786
2020/05/13,Ourense,Zamora,68,172539,21205,151334,307651,52786
2020/05/13,Ourense,León,332,460001,64114,395887,307651,52786
2020/05/13,Ourense,Pontevedra,164,942665,168644,774021,307651,52786
2020/05/13,Palencia,Valladolid,183,519546,56505,463041,160866,23110
2020/05/13,Palencia,Cantabria,209,580795,95606,485189,160866,23110
2020/05/13,Palencia,Burgos,219,357072,43575,313497,160866,23110
2020/05/13,Palencia,León,25,460001,64114,395887,160866,23110
2020/05/13,Palencia,Palencia,15640,160866,21105,139761,160866,23110
2020/05/13,Pontevedra,Coruña,4481,1119596,189989,929607,942665,167930
2020/05/13,Pontevedra,Ourense,216,307651,52397,255254,942665,167930
2020/05/13,Pontevedra,Lugo,61,329587,46578,283009,942665,167930
2020/05/13,Pontevedra,Pontevedra,133119,942665,168644,774021,942665,167930
2020/05/13,Rioja,Burgos,21,357072,43575,313497,316798,47623
2020/05/13,Rioja,Araba,737,331549,60306,271243,316798,47623
2020/05/13,Rioja,Navarra,1932,654183,107186,546997,316798,47623
2020/05/13,Rioja,Rioja,36689,316798,49921,266877,316798,47623
2020/05/13,Salamanca,Zamora,29,172539,21205,151334,330119,44231
2020/05/13,Salamanca,Salamanca,35029,330119,44408,285711,330119,44231
2020/05/13,Salamanca,Ávila,235,157640,17062,140578,330119,44231
2020/05/13,Santa Cruz de Tenerife,Santa Cruz de Tenerife,147835,1032983,162791,870192,1032983,162610
2020/05/13,Santa Cruz de Tenerife,Las Palmas de Gran Canaria,29,1120406,179554,940852,1032983,162610
2020/05/13,Segovia,Valladolid,338,519546,56505,463041,153129,20768
2020/05/13,Segovia,Ávila,150,157640,17062,140578,153129,20768
2020/05/13,Segovia,Madrid,21,6663394,960073,5703321,153129,20768
2020/05/13,Segovia,Burgos,98,357072,43575,313497,153129,20768
2020/05/13,Segovia,Segovia,12535,153129,19066,134063,153129,20768
2020/05/13,Sevilla,Badajoz,17,673559,88632,584927,1942389,306880
2020/05/13,Sevilla,Málaga,181,1661785,219338,1442447,1942389,306880
2020/05/13,Sevilla,Sevilla,224274,1942389,310425,1631964,1942389,306880
2020/05/13,Sevilla,Córdoba,2296,782979,112242,670737,1942389,306880
2020/05/13,Sevilla,Cádiz,2613,1240155,184977,1055178,1942389,306880
2020/05/13,Sevilla,Huelva,628,521870,74268,447602,1942389,306880
2020/05/13,Soria,Soria,5628,88636,7800,80836,88636,8689
2020/05/13,Soria,Burgos,93,357072,43575,313497,88636,8689
2020/05/13,Soria,Segovia,18,153129,19066,134063,88636,8689
2020/05/13,Soria,Zaragoza,125,964724,172837,791887,88636,8689
2020/05/13,Soria,Valladolid,94,519546,56505,463041,88636,8689
2020/05/13,Tarragona,Zaragoza,39,964724,172837,791887,804664,114818
2020/05/13,Tarragona,Castellón,809,579962,75184,504778,804664,114818
2020/05/13,Tarragona,Barcelona,1105,5664579,943272,4721307,804664,114818
2020/05/13,Tarragona,Teruel,119,134137,11020,123117,804664,114818
2020/05/13,Tarragona,Tarragona,79071,804664,115500,689164,804664,114818
2020/05/13,Teruel,Castellón,91,579962,75184,504778,134137,12626
2020/05/13,Teruel,Teruel,6596,134137,11020,123117,134137,12626
2020/05/13,Teruel,Zaragoza,282,964724,172837,791887,134137,12626
2020/05/13,Teruel,Tarragona,77,804664,115500,689164,134137,12626
2020/05/13,Toledo,Ávila,286,157640,17062,140578,694844,80295
2020/05/13,Toledo,Madrid,3376,6663394,960073,5703321,694844,80295
2020/05/13,Toledo,Toledo,38581,694844,83717,611127,694844,80295
2020/05/13,Toledo,Ciudad Real,273,495761,42879,452882,694844,80295
2020/05/13,Toledo,Cáceres,123,394151,42244,351907,694844,80295
2020/05/13,Toledo,Cuenca,99,196329,19420,176909,694844,80295
2020/05/13,Valencia,Murcia,38,1493898,243314,1250584,2565124,410595
2020/05/13,Valencia,Albacete,320,388167,34235,353932,2565124,410595
2020/05/13,Valencia,Alicante,1218,1858683,281239,1577444,2565124,410595
2020/05/13,Valencia,Valencia,292936,2565124,421462,2143662,2565124,410595
2020/05/13,Valencia,Cuenca,121,196329,19420,176909,2565124,410595
2020/05/13,Valencia,Castellón,641,579962,75184,504778,2565124,410595
2020/05/13,Valencia,Teruel,25,134137,11020,123117,2565124,410595
2020/05/13,Valladolid,León,25,460001,64114,395887,519546,52782
2020/05/13,Valladolid,Ávila,55,157640,17062,140578,519546,52782
2020/05/13,Valladolid,Palencia,20,160866,21105,139761,519546,52782
2020/05/13,Valladolid,Valladolid,35705,519546,56505,463041,519546,52782
2020/05/13,Valladolid,Burgos,119,357072,43575,313497,519546,52782
2020/05/13,Valladolid,Segovia,223,153129,19066,134063,519546,52782
2020/05/13,Valladolid,Zamora,203,172539,21205,151334,519546,52782
2020/05/13,Valladolid,Soria,45,88636,7800,80836,519546,52782
2020/05/13,Valladolid,Salamanca,33,330119,44408,285711,519546,52782
2020/05/13,Zamora,Zamora,14542,172539,21205,151334,172539,21366
2020/05/13,Zamora,Ourense,91,307651,52397,255254,172539,21366
2020/05/13,Zamora,Valladolid,56,519546,56505,463041,172539,21366
2020/05/13,Zaragoza,Teruel,318,134137,11020,123117,964724,167033
2020/05/13,Zaragoza,Navarra,484,654183,107186,546997,964724,167033
2020/05/13,Zaragoza,Huesca,229,220461,29006,191455,964724,167033
2020/05/13,Zaragoza,Lleida,111,434930,63644,371286,964724,167033
2020/05/13,Zaragoza,Zaragoza,134543,964724,172837,791887,964724,167033
2020/05/13,Zaragoza,Soria,58,88636,7800,80836,964724,167033
2020/05/14,Albacete,Albacete,21306,388167,34022,354145,388167,33453
2020/05/14,Albacete,Murcia,283,1493898,225734,1268164,388167,33453
2020/05/14,Albacete,Ciudad Real,504,495761,41480,454281,388167,33453
2020/05/14,Albacete,Alicante,240,1858683,266051,1592632,388167,33453
2020/05/14,Albacete,Valencia,366,2565124,415582,2149542,388167,33453
2020/05/14,Albacete,Cuenca,555,196329,18737,177592,388167,33453
2020/05/14,Albacete,Jaén,17,633564,67461,566103,388167,33453
2020/05/14,Alicante,Albacete,325,388167,34022,354145,1858683,270803
2020/05/14,Alicante,Murcia,2750,1493898,225734,1268164,1858683,270803
2020/05/14,Alicante,Alicante,208786,1858683,266051,1592632,1858683,270803
2020/05/14,Alicante,Valencia,1295,2565124,415582,2149542,1858683,270803
2020/05/14,Almería,Almería,82155,716820,98580,618240,716820,100621
2020/05/14,Almería,Granada,507,914678,119738,794940,716820,100621
2020/05/14,Almería,Murcia,1882,1493898,225734,1268164,716820,100621
2020/05/14,Araba,Navarra,240,654183,107553,546630,331549,67799
2020/05/14,Araba,Araba,49679,331549,60269,271280,331549,67799
2020/05/14,Araba,Rioja,2423,316798,51161,265637,331549,67799
2020/05/14,Araba,Burgos,1773,357072,43582,313490,331549,67799
2020/05/14,Araba,Bizkaia,1694,1152934,219952,932982,331549,67799
2020/05/14,Araba,Gipuzkoa,133,723576,109222,614354,331549,67799
2020/05/14,Asturias,Cantabria,201,580795,93437,487358,1022800,153858
2020/05/14,Asturias,Lugo,955,329587,45994,283593,1022800,153858
2020/05/14,Asturias,Asturias,123438,1022800,154093,868707,1022800,153858
2020/05/14,Asturias,León,42,460001,63387,396614,1022800,153858
2020/05/14,Ávila,Madrid,70,6663394,978957,5684437,157640,17121
2020/05/14,Ávila,Ávila,10486,157640,16418,141222,157640,17121
2020/05/14,Ávila,Toledo,204,694844,82750,612094,157640,17121
2020/05/14,Ávila,Cáceres,120,394151,43603,350548,157640,17121
2020/05/14,Ávila,Salamanca,452,330119,44238,285881,157640,17121
2020/05/14,Ávila,Segovia,76,153129,18943,134186,157640,17121
2020/05/14,Badajoz,Córdoba,67,782979,109061,673918,673559,84519
2020/05/14,Badajoz,Cáceres,952,394151,43603,350548,673559,84519
2020/05/14,Badajoz,Badajoz,62956,673559,85592,587967,673559,84519
2020/05/14,Badajoz,Ciudad Real,35,495761,41480,454281,673559,84519
2020/05/14,Badajoz,Huelva,258,521870,68477,453393,673559,84519
2020/05/14,Badajoz,Sevilla,51,1942389,286117,1656272,673559,84519
2020/05/14,Balears,Balears,140772,1149460,160413,989047,1149460,161581
2020/05/14,Balears,Valencia,61,2565124,415582,2149542,1149460,161581
2020/05/14,Barcelona,Tarragona,1592,804664,111272,693392,5664579,937959
2020/05/14,Barcelona,Girona,2600,771044,93867,677177,5664579,937959
2020/05/14,Barcelona,Barcelona,593243,5664579,938597,4725982,5664579,937959
2020/05/14,Barcelona,Lleida,164,434930,61977,372953,5664579,937959
2020/05/14,Bizkaia,Gipuzkoa,1178,723576,109222,614354,1152934,215662
2020/05/14,Bizkaia,Araba,684,331549,60269,271280,1152934,215662
2020/05/14,Bizkaia,Bizkaia,169380,1152934,219952,932982,1152934,215662
2020/05/14,Bizkaia,Burgos,77,357072,43582,313490,1152934,215662
2020/05/14,Bizkaia,Cantabria,2654,580795,93437,487358,1152934,215662
2020/05/14,Burgos,Valladolid,160,519546,77081,442465,357072,44147
2020/05/14,Burgos,Palencia,188,160866,21567,139299,357072,44147
2020/05/14,Burgos,Soria,27,88636,7837,80799,357072,44147
2020/05/14,Burgos,Burgos,31789,357072,43582,313490,357072,44147
2020/05/14,Burgos,Cantabria,27,580795,93437,487358,357072,44147
2020/05/14,Burgos,Segovia,29,153129,18943,134186,357072,44147
2020/05/14,Burgos,Rioja,60,316798,51161,265637,357072,44147
2020/05/14,Burgos,Bizkaia,134,1152934,219952,932982,357072,44147
2020/05/14,Burgos,Araba,983,331549,60269,271280,357072,44147
2020/05/14,Cáceres,Cáceres,30029,394151,43603,350548,394151,44077
2020/05/14,Cáceres,Badajoz,1108,673559,85592,587967,394151,44077
2020/05/14,Cáceres,Toledo,139,694844,82750,612094,394151,44077
2020/05/14,Cáceres,Ávila,187,157640,16418,141222,394151,44077
2020/05/14,Cáceres,Valencia,26,2565124,415582,2149542,394151,44077
2020/05/14,Cádiz,Huelva,719,521870,68477,453393,1240155,169310
2020/05/14,Cádiz,Málaga,1216,1661785,209087,1452698,1240155,169310
2020/05/14,Cádiz,Sevilla,808,1942389,286117,1656272,1240155,169310
2020/05/14,Cádiz,Cádiz,138641,1240155,166073,1074082,1240155,169310
2020/05/14,Cantabria,Palencia,79,160866,21567,139299,580795,88810
2020/05/14,Cantabria,Bizkaia,678,1152934,219952,932982,580795,88810
2020/05/14,Cantabria,Cantabria,68194,580795,93437,487358,580795,88810
2020/05/14,Cantabria,Asturias,209,1022800,154093,868707,580795,88810
2020/05/14,Castellón,Teruel,43,134137,10315,123822,579962,77191
2020/05/14,Castellón,Tarragona,885,804664,111272,693392,579962,77191
2020/05/14,Castellón,Castellón,54046,579962,73286,506676,579962,77191
2020/05/14,Castellón,Valencia,741,2565124,415582,2149542,579962,77191
2020/05/14,Ceuta,Ceuta,10248,84777,10658,74119,84777,10683
2020/05/14,Ciudad Real,Córdoba,463,782979,109061,673918,495761,38819
2020/05/14,Ciudad Real,Badajoz,49,673559,85592,587967,495761,38819
2020/05/14,Ciudad Real,Ciudad Real,24407,495761,41480,454281,495761,38819
2020/05/14,Ciudad Real,Toledo,288,694844,82750,612094,495761,38819
2020/05/14,Ciudad Real,Albacete,376,388167,34022,354145,495761,38819
2020/05/14,Córdoba,Córdoba,78236,782979,109061,673918,782979,106826
2020/05/14,Córdoba,Granada,132,914678,119738,794940,782979,106826
2020/05/14,Córdoba,Ciudad Real,344,495761,41480,454281,782979,106826
2020/05/14,Córdoba,Jaén,668,633564,67461,566103,782979,106826
2020/05/14,Córdoba,Sevilla,1499,1942389,286117,1656272,782979,106826
2020/05/14,Córdoba,Málaga,114,1661785,209087,1452698,782979,106826
2020/05/14,Córdoba,Badajoz,84,673559,85592,587967,782979,106826
2020/05/14,Coruña,Pontevedra,5276,942665,163902,778763,1119596,189193
2020/05/14,Coruña,Coruña,144795,1119596,187466,932130,1119596,189193
2020/05/14,Coruña,Lugo,638,329587,45994,283593,1119596,189193
2020/05/14,Cuenca,Valencia,48,2565124,415582,2149542,196329,19449
2020/05/14,Cuenca,Toledo,167,694844,82750,612094,196329,19449
2020/05/14,Cuenca,Albacete,578,388167,34022,354145,196329,19449
2020/05/14,Cuenca,Cuenca,9939,196329,18737,177592,196329,19449
2020/05/14,Cuenca,Guadalajara,55,257762,37225,220537,196329,19449
2020/05/14,Cuenca,Ciudad Real,80,495761,41480,454281,196329,19449
2020/05/14,Cuenca,Madrid,71,6663394,978957,5684437,196329,19449
2020/05/14,Gipuzkoa,Gipuzkoa,84205,723576,109222,614354,723576,113752
2020/05/14,Gipuzkoa,Bizkaia,1595,1152934,219952,932982,723576,113752
2020/05/14,Gipuzkoa,Araba,236,331549,60269,271280,723576,113752
2020/05/14,Gipuzkoa,Navarra,364,654183,107553,546630,723576,113752
2020/05/14,Girona,Barcelona,2531,5664579,938597,4725982,771044,98728
2020/05/14,Girona,Girona,62536,771044,93867,677177,771044,98728
2020/05/14,Girona,Lleida,221,434930,61977,372953,771044,98728
2020/05/14,Granada,Murcia,46,1493898,225734,1268164,914678,117449
2020/05/14,Granada,Granada,87209,914678,119738,794940,914678,117449
2020/05/14,Granada,Córdoba,178,782979,109061,673918,914678,117449
2020/05/14,Granada,Jaén,288,633564,67461,566103,914678,117449
2020/05/14,Granada,Málaga,160,1661785,209087,1452698,914678,117449
2020/05/14,Granada,Almería,489,716820,98580,618240,914678,117449
2020/05/14,Guadalajara,Cuenca,24,196329,18737,177592,257762,38805
2020/05/14,Guadalajara,Guadalajara,21781,257762,37225,220537,257762,38805
2020/05/14,Guadalajara,Madrid,2385,6663394,978957,5684437,257762,38805
2020/05/14,Huelva,Badajoz,318,673559,85592,587967,521870,71926
2020/05/14,Huelva,Sevilla,1401,1942389,286117,1656272,521870,71926
2020/05/14,Huelva,Huelva,53204,521870,68477,453393,521870,71926
2020/05/14,Huelva,Cádiz,471,1240155,166073,1074082,521870,71926
2020/05/14,Huesca,Zaragoza,197,964724,169785,794939,220461,31526
2020/05/14,Huesca,Huesca,19676,220461,28343,192118,220461,31526
2020/05/14,Huesca,Lleida,869,434930,61977,372953,220461,31526
2020/05/14,Jaén,Córdoba,758,782979,109061,673918,633564,66337
2020/05/14,Jaén,Granada,174,914678,119738,794940,633564,66337
2020/05/14,Jaén,Jaén,46895,633564,67461,566103,633564,66337
2020/05/14,Las Palmas de Gran Canaria,Santa Cruz de Tenerife,42,1032983,157273,875710,1120406,171442
2020/05/14,Las Palmas de Gran Canaria,Las Palmas de Gran Canaria,159668,1120406,172275,948131,1120406,171442
2020/05/14,León,Valladolid,24,519546,77081,442465,460001,62900
2020/05/14,León,Lugo,39,329587,45994,283593,460001,62900
2020/05/14,León,Palencia,57,160866,21567,139299,460001,62900
2020/05/14,León,León,47298,460001,63387,396614,460001,62900
2020/05/14,León,Asturias,105,1022800,154093,868707,460001,62900
2020/05/14,León,Zamora,159,172539,20829,151710,460001,62900
2020/05/14,León,Ourense,373,307651,52520,255131,460001,62900
2020/05/14,Lleida,Barcelona,195,5664579,938597,4725982,434930,59465
2020/05/14,Lleida,Girona,190,771044,93867,677177,434930,59465
2020/05/14,Lleida,Lleida,40153,434930,61977,372953,434930,59465
2020/05/14,Lleida,Huesca,687,220461,28343,192118,434930,59465
2020/05/14,Lleida,Zaragoza,166,964724,169785,794939,434930,59465
2020/05/14,Lugo,Asturias,777,1022800,154093,868707,329587,47193
2020/05/14,Lugo,Ourense,163,307651,52520,255131,329587,47193
2020/05/14,Lugo,Lugo,32943,329587,45994,283593,329587,47193
2020/05/14,Lugo,Coruña,695,1119596,187466,932130,329587,47193
2020/05/14,Madrid,Ávila,233,157640,16418,141222,6663394,978585
2020/05/14,Madrid,Cuenca,39,196329,18737,177592,6663394,978585
2020/05/14,Madrid,Madrid,566275,6663394,978957,5684437,6663394,978585
2020/05/14,Madrid,Toledo,3616,694844,82750,612094,6663394,978585
2020/05/14,Madrid,Segovia,44,153129,18943,134186,6663394,978585
2020/05/14,Madrid,Guadalajara,3009,257762,37225,220537,6663394,978585
2020/05/14,Málaga,Sevilla,202,1942389,286117,1656272,1661785,213256
2020/05/14,Málaga,Málaga,171614,1661785,209087,1452698,1661785,213256
2020/05/14,Málaga,Córdoba,239,782979,109061,673918,1661785,213256
2020/05/14,Málaga,Granada,243,914678,119738,794940,1661785,213256
2020/05/14,Málaga,Cádiz,1076,1240155,166073,1074082,1661785,213256
2020/05/14,Melilla,Melilla,13000,86487,13207,73280,86487,13120
2020/05/14,Murcia,Alicante,2596,1858683,266051,1592632,1493898,223588
2020/05/14,Murcia,Albacete,369,388167,34022,354145,1493898,223588
2020/05/14,Murcia,Murcia,177596,1493898,225734,1268164,1493898,223588
2020/05/14,Murcia,Almería,1234,716820,98580,618240,1493898,223588
2020/05/14,Murcia,Granada,31,914678,119738,794940,1493898,223588
2020/05/14,Navarra,Rioja,2645,316798,51161,265637,654183,108892
2020/05/14,Navarra,Araba,31,331549,60269,271280,654183,108892
2020/05/14,Navarra,Navarra,78643,654183,107553,546630,654183,108892
2020/05/14,Navarra,Zaragoza,672,964724,169785,794939,654183,108892
2020/05/14,Navarra,Gipuzkoa,461,723576,109222,614354,654183,108892
2020/05/14,Ourense,Pontevedra,162,942665,163902,778763,307651,52987
2020/05/14,Ourense,Zamora,68,172539,20829,151710,307651,52987
2020/05/14,Ourense,Lugo,223,329587,45994,283593,307651,52987
2020/05/14,Ourense,León,278,460001,63387,396614,307651,52987
2020/05/14,Ourense,Ourense,40991,307651,52520,255131,307651,52987
2020/05/14,Palencia,Cantabria,198,580795,93437,487358,160866,22878
2020/05/14,Palencia,Burgos,183,357072,43582,313490,160866,22878
2020/05/14,Palencia,León,26,460001,63387,396614,160866,22878
2020/05/14,Palencia,Palencia,15306,160866,21567,139299,160866,22878
2020/05/14,Palencia,Valladolid,185,519546,77081,442465,160866,22878
2020/05/14,Pontevedra,Ourense,261,307651,52520,255131,942665,163024
2020/05/14,Pontevedra,Coruña,4347,1119596,187466,932130,942665,163024
2020/05/14,Pontevedra,Pontevedra,128043,942665,163902,778763,942665,163024
2020/05/14,Rioja,Rioja,37326,316798,51161,265637,316798,48596
2020/05/14,Rioja,Navarra,1919,654183,107553,546630,316798,48596
2020/05/14,Rioja,Burgos,26,357072,43582,313490,316798,48596
2020/05/14,Rioja,Araba,833,331549,60269,271280,316798,48596
2020/05/14,Salamanca,Salamanca,34567,330119,44238,285881,330119,43782
2020/05/14,Salamanca,Zamora,69,172539,20829,151710,330119,43782
2020/05/14,Salamanca,Ávila,236,157640,16418,141222,330119,43782
2020/05/14,Santa Cruz de Tenerife,Santa Cruz de Tenerife,142525,1032983,157273,875710,1032983,157170
2020/05/14,Santa Cruz de Tenerife,Las Palmas de Gran Canaria,46,1120406,172275,948131,1032983,157170
2020/05/14,Segovia,Ávila,105,157640,16418,141222,153129,20505
2020/05/14,Segovia,Burgos,119,357072,43582,313490,153129,20505
2020/05/14,Segovia,Segovia,12460,153129,18943,134186,153129,20505
2020/05/14,Segovia,Valladolid,397,519546,77081,442465,153129,20505
2020/05/14,Sevilla,Málaga,61,1661785,209087,1452698,1942389,280231
2020/05/14,Sevilla,Cádiz,697,1240155,166073,1074082,1942389,280231
2020/05/14,Sevilla,Sevilla,203461,1942389,286117,1656272,1942389,280231
2020/05/14,Sevilla,Huelva,393,521870,68477,453393,1942389,280231
2020/05/14,Sevilla,Córdoba,1839,782979,109061,673918,1942389,280231
2020/05/14,Sevilla,Badajoz,72,673559,85592,587967,1942389,280231
2020/05/14,Soria,Segovia,16,153129,18943,134186,88636,8570
2020/05/14,Soria,Valladolid,117,519546,77081,442465,88636,8570
2020/05/14,Soria,Burgos,103,357072,43582,313490,88636,8570
2020/05/14,Soria,Zaragoza,98,964724,169785,794939,88636,8570
2020/05/14,Soria,Soria,5674,88636,7837,80799,88636,8570
2020/05/14,Tarragona,Barcelona,1028,5664579,938597,4725982,804664,110857
2020/05/14,Tarragona,Lleida,25,434930,61977,372953,804664,110857
2020/05/14,Tarragona,Tarragona,75864,804664,111272,693392,804664,110857
2020/05/14,Tarragona,Castellón,722,579962,73286,506676,804664,110857
2020/05/14,Tarragona,Teruel,41,134137,10315,123822,804664,110857
2020/05/14,Teruel,Teruel,6195,134137,10315,123822,134137,11826
2020/05/14,Teruel,Tarragona,98,804664,111272,693392,134137,11826
2020/05/14,Teruel,Zaragoza,249,964724,169785,794939,134137,11826
2020/05/14,Teruel,Castellón,74,579962,73286,506676,134137,11826
2020/05/14,Toledo,Cuenca,85,196329,18737,177592,694844,80493
2020/05/14,Toledo,Ciudad Real,257,495761,41480,454281,694844,80493
2020/05/14,Toledo,Toledo,39593,694844,82750,612094,694844,80493
2020/05/14,Toledo,Cáceres,168,394151,43603,350548,694844,80493
2020/05/14,Toledo,Madrid,3112,6663394,978957,5684437,694844,80493
2020/05/14,Toledo,Ávila,216,157640,16418,141222,694844,80493
2020/05/14,Valencia,Albacete,337,388167,34022,354145,2565124,406095
2020/05/14,Valencia,Castellón,631,579962,73286,506676,2565124,406095
2020/05/14,Valencia,Alicante,834,1858683,266051,1592632,2565124,406095
2020/05/14,Valencia,Valencia,292775,2565124,415582,2149542,2565124,406095
2020/05/14,Valencia,Cuenca,118,196329,18737,177592,2565124,406095
2020/05/14,Valladolid,Valladolid,55389,519546,77081,442465,519546,75153
2020/05/14,Valladolid,Burgos,103,357072,43582,313490,519546,75153
2020/05/14,Valladolid,Soria,67,88636,7837,80799,519546,75153
2020/05/14,Valladolid,Zamora,53,172539,20829,151710,519546,75153
2020/05/14,Valladolid,Segovia,224,153129,18943,134186,519546,75153
2020/05/14,Valladolid,Palencia,41,160866,21567,139299,519546,75153
2020/05/14,Valladolid,Ávila,48,157640,16418,141222,519546,75153
2020/05/14,Zamora,Valladolid,93,519546,77081,442465,172539,20529
2020/05/14,Zamora,León,51,460001,63387,396614,172539,20529
2020/05/14,Zamora,Ourense,77,307651,52520,255131,172539,20529
2020/05/14,Zamora,Zamora,14021,172539,20829,151710,172539,20529
2020/05/14,Zaragoza,Teruel,158,134137,10315,123822,964724,163525
2020/05/14,Zaragoza,Navarra,614,654183,107553,546630,964724,163525
2020/05/14,Zaragoza,Lleida,99,434930,61977,372953,964724,163525
2020/05/14,Zaragoza,Zaragoza,132237,964724,169785,794939,964724,163525
2020/05/14,Zaragoza,Huesca,262,220461,28343,192118,964724,163525
2020/05/14,Zaragoza,Soria,66,88636,7837,80799,964724,163525
2020/05/15,Albacete,Ciudad Real,459,495761,39093,456668,388167,33677
2020/05/15,Albacete,Albacete,20804,388167,32561,355606,388167,33677
2020/05/15,Albacete,Jaén,47,633564,67124,566440,388167,33677
2020/05/15,Albacete,Murcia,529,1493898,234392,1259506,388167,33677
2020/05/15,Albacete,Valencia,446,2565124,418413,2146711,388167,33677
2020/05/15,Albacete,Cuenca,522,196329,17416,178913,388167,33677
2020/05/15,Albacete,Alicante,233,1858683,276725,1581958,388167,33677
2020/05/15,Alicante,Valencia,1160,2565124,418413,2146711,1858683,281718
2020/05/15,Alicante,Murcia,3528,1493898,234392,1259506,1858683,281718
2020/05/15,Alicante,Albacete,327,388167,32561,355606,1858683,281718
2020/05/15,Alicante,Alicante,218070,1858683,276725,1581958,1858683,281718
2020/05/15,Almería,Murcia,2000,1493898,234392,1259506,716820,99593
2020/05/15,Almería,Jaén,17,633564,67124,566440,716820,99593
2020/05/15,Almería,Granada,602,914678,116598,798080,716820,99593
2020/05/15,Almería,Almería,81881,716820,97481,619339,716820,99593
2020/05/15,Araba,Rioja,2068,316798,48117,268681,331549,64149
2020/05/15,Araba,Gipuzkoa,257,723576,105756,617820,331549,64149
2020/05/15,Araba,Araba,47236,331549,57073,274476,331549,64149
2020/05/15,Araba,Navarra,211,654183,101502,552681,331549,64149
2020/05/15,Araba,Bizkaia,1365,1152934,210659,942275,331549,64149
2020/05/15,Araba,Burgos,1720,357072,40984,316088,331549,64149
2020/05/15,Asturias,León,34,460001,58212,401789,1022800,147413
2020/05/15,Asturias,Asturias,118486,1022800,147137,875663,1022800,147413
2020/05/15,Asturias,Lugo,946,329587,45713,283874,1022800,147413
2020/05/15,Asturias,Cantabria,221,580795,88297,492498,1022800,147413
2020/05/15,Ávila,Salamanca,359,330119,42827,287292,157640,16110
2020/05/15,Ávila,Segovia,107,153129,18186,134943,157640,16110
2020/05/15,Ávila,Madrid,130,6663394,708701,5954693,157640,16110
2020/05/15,Ávila,Ávila,10275,157640,15381,142259,157640,16110
2020/05/15,Ávila,Cáceres,144,394151,43700,350451,157640,16110
2020/05/15,Ávila,Toledo,202,694844,70978,623866,157640,16110
2020/05/15,Badajoz,Badajoz,65076,673559,87053,586506,673559,85761
2020/05/15,Badajoz,Córdoba,53,782979,110215,672764,673559,85761
2020/05/15,Badajoz,Sevilla,41,1942389,294420,1647969,673559,85761
2020/05/15,Badajoz,Ciudad Real,43,495761,39093,456668,673559,85761
2020/05/15,Badajoz,Huelva,195,521870,69903,451967,673559,85761
2020/05/15,Badajoz,Cáceres,943,394151,43700,350451,673559,85761
2020/05/15,Balears,Valencia,31,2565124,418413,2146711,1149460,161160
2020/05/15,Balears,Balears,140779,1149460,160471,988989,1149460,161160
2020/05/15,Barcelona,Tarragona,1692,804664,109854,694810,5664579,894819
2020/05/15,Barcelona,Girona,2584,771044,89022,682022,5664579,894819
2020/05/15,Barcelona,Lleida,297,434930,58326,376604,5664579,894819
2020/05/15,Barcelona,Barcelona,560883,5664579,894597,4769982,5664579,894819
2020/05/15,Bizkaia,Burgos,64,357072,40984,316088,1152934,206365
2020/05/15,Bizkaia,Bizkaia,161453,1152934,210659,942275,1152934,206365
2020/05/15,Bizkaia,Gipuzkoa,945,723576,105756,617820,1152934,206365
2020/05/15,Bizkaia,Araba,745,331549,57073,274476,1152934,206365
2020/05/15,Bizkaia,Cantabria,2428,580795,88297,492498,1152934,206365
2020/05/15,Burgos,Rioja,66,316798,48117,268681,357072,41065
2020/05/15,Burgos,Bizkaia,130,1152934,210659,942275,357072,41065
2020/05/15,Burgos,Valladolid,128,519546,76601,442945,357072,41065
2020/05/15,Burgos,Palencia,182,160866,20270,140596,357072,41065
2020/05/15,Burgos,Burgos,30087,357072,40984,316088,357072,41065
2020/05/15,Burgos,Araba,950,331549,57073,274476,357072,41065
2020/05/15,Burgos,Segovia,50,153129,18186,134943,357072,41065
2020/05/15,Burgos,Soria,50,88636,7249,81387,357072,41065
2020/05/15,Cáceres,Ávila,165,157640,15381,142259,394151,44229
2020/05/15,Cáceres,Cáceres,30503,394151,43700,350451,394151,44229
2020/05/15,Cáceres,Toledo,186,694844,70978,623866,394151,44229
2020/05/15,Cáceres,Badajoz,1257,673559,87053,586506,394151,44229
2020/05/15,Cádiz,Málaga,1231,1661785,209219,1452566,1240155,173180
2020/05/15,Cádiz,Cádiz,143279,1240155,170899,1069256,1240155,173180
2020/05/15,Cádiz,Huelva,716,521870,69903,451967,1240155,173180
2020/05/15,Cádiz,Sevilla,803,1942389,294420,1647969,1240155,173180
2020/05/15,Cantabria,Bizkaia,519,1152934,210659,942275,580795,84228
2020/05/15,Cantabria,Palencia,52,160866,20270,140596,580795,84228
2020/05/15,Cantabria,Asturias,197,1022800,147137,875663,580795,84228
2020/05/15,Cantabria,Burgos,25,357072,40984,316088,580795,84228
2020/05/15,Cantabria,Cantabria,64214,580795,88297,492498,580795,84228
2020/05/15,Castellón,Castellón,54262,579962,72376,507586,579962,76236
2020/05/15,Castellón,Teruel,42,134137,10023,124114,579962,76236
2020/05/15,Castellón,Tarragona,866,804664,109854,694810,579962,76236
2020/05/15,Castellón,Valencia,749,2565124,418413,2146711,579962,76236
2020/05/15,Ceuta,Ceuta,10321,84777,10700,74077,84777,10707
2020/05/15,Ciudad Real,Ciudad Real,23758,495761,39093,456668,495761,37722
2020/05/15,Ciudad Real,Albacete,407,388167,32561,355606,495761,37722
2020/05/15,Ciudad Real,Toledo,245,694844,70978,623866,495761,37722
2020/05/15,Ciudad Real,Badajoz,51,673559,87053,586506,495761,37722
2020/05/15,Ciudad Real,Córdoba,351,782979,110215,672764,495761,37722
2020/05/15,Córdoba,Granada,150,914678,116598,798080,782979,108317
2020/05/15,Córdoba,Badajoz,113,673559,87053,586506,782979,108317
2020/05/15,Córdoba,Ciudad Real,331,495761,39093,456668,782979,108317
2020/05/15,Córdoba,Jaén,577,633564,67124,566440,782979,108317
2020/05/15,Córdoba,Córdoba,79667,782979,110215,672764,782979,108317
2020/05/15,Córdoba,Sevilla,1553,1942389,294420,1647969,782979,108317
2020/05/15,Córdoba,Málaga,193,1661785,209219,1452566,782979,108317
2020/05/15,Coruña,Lugo,620,329587,45713,283874,1119596,187330
2020/05/15,Coruña,Coruña,143822,1119596,186033,933563,1119596,187330
2020/05/15,Coruña,Pontevedra,5094,942665,165962,776703,1119596,187330
2020/05/15,Cuenca,Toledo,132,694844,70978,623866,196329,17711
2020/05/15,Cuenca,Madrid,61,6663394,708701,5954693,196329,17711
2020/05/15,Cuenca,Albacete,500,388167,32561,355606,196329,17711
2020/05/15,Cuenca,Guadalajara,28,257762,32561,225201,196329,17711
2020/05/15,Cuenca,Ciudad Real,45,495761,39093,456668,196329,17711
2020/05/15,Cuenca,Valencia,41,2565124,418413,2146711,196329,17711
2020/05/15,Cuenca,Cuenca,9561,196329,17416,178913,196329,17711
2020/05/15,Gipuzkoa,Bizkaia,1460,1152934,210659,942275,723576,109044
2020/05/15,Gipuzkoa,Araba,183,331549,57073,274476,723576,109044
2020/05/15,Gipuzkoa,Gipuzkoa,81939,723576,105756,617820,723576,109044
2020/05/15,Gipuzkoa,Navarra,415,654183,101502,552681,723576,109044
2020/05/15,Girona,Girona,59739,771044,89022,682022,771044,93530
2020/05/15,Girona,Lleida,176,434930,58326,376604,771044,93530
2020/05/15,Girona,Barcelona,2560,5664579,894597,4769982,771044,93530
2020/05/15,Granada,Granada,85757,914678,116598,798080,914678,115009
2020/05/15,Granada,Córdoba,185,782979,110215,672764,914678,115009
2020/05/15,Granada,Málaga,139,1661785,209219,1452566,914678,115009
2020/05/15,Granada,Almería,388,716820,97481,619339,914678,115009
2020/05/15,Granada,Jaén,319,633564,67124,566440,914678,115009
2020/05/15,Guadalajara,Teruel,28,134137,10023,124114,257762,33469
2020/05/15,Guadalajara,Cuenca,36,196329,17416,178913,257762,33469
2020/05/15,Guadalajara,Guadalajara,21054,257762,32561,225201,257762,33469
2020/05/15,Guadalajara,Madrid,1790,6663394,708701,5954693,257762,33469
2020/05/15,Huelva,Cádiz,562,1240155,170899,1069256,521870,73075
2020/05/15,Huelva,Sevilla,1591,1942389,294420,1647969,521870,73075
2020/05/15,Huelva,Badajoz,343,673559,87053,586506,521870,73075
2020/05/15,Huelva,Huelva,54475,521870,69903,451967,521870,73075
2020/05/15,Huesca,Zaragoza,201,964724,157225,807499,220461,28924
2020/05/15,Huesca,Huesca,18105,220461,26417,194044,220461,28924
2020/05/15,Huesca,Lleida,926,434930,58326,376604,220461,28924
2020/05/15,Jaén,Jaén,47339,633564,67124,566440,633564,65932
2020/05/15,Jaén,Córdoba,724,782979,110215,672764,633564,65932
2020/05/15,Jaén,Granada,247,914678,116598,798080,633564,65932
2020/05/15,Jaén,Albacete,32,388167,32561,355606,633564,65932
2020/05/15,Las Palmas de Gran Canaria,Las Palmas de Gran Canaria,152049,1120406,165006,955400,1120406,164014
2020/05/15,León,Asturias,36,1022800,147137,875663,460001,57866
2020/05/15,León,Zamora,133,172539,20469,152070,460001,57866
2020/05/15,León,Lugo,29,329587,45713,283874,460001,57866
2020/05/15,León,Ourense,365,307651,51972,255679,460001,57866
2020/05/15,León,Palencia,61,160866,20270,140596,460001,57866
2020/05/15,León,León,43087,460001,58212,401789,460001,57866
2020/05/15,Lleida,Zaragoza,166,964724,157225,807499,434930,55775
2020/05/15,Lleida,Tarragona,72,804664,109854,694810,434930,55775
2020/05/15,Lleida,Lleida,37298,434930,58326,376604,434930,55775
2020/05/15,Lleida,Girona,212,771044,89022,682022,434930,55775
2020/05/15,Lleida,Barcelona,290,5664579,894597,4769982,434930,55775
2020/05/15,Lleida,Huesca,620,220461,26417,194044,434930,55775
2020/05/15,Lugo,Coruña,592,1119596,186033,933563,329587,46790
2020/05/15,Lugo,Ourense,163,307651,51972,255679,329587,46790
2020/05/15,Lugo,Asturias,687,1022800,147137,875663,329587,46790
2020/05/15,Lugo,Lugo,33165,329587,45713,283874,329587,46790
2020/05/15,Madrid,Cuenca,70,196329,17416,178913,6663394,708493
2020/05/15,Madrid,Madrid,450729,6663394,708701,5954693,6663394,708493
2020/05/15,Madrid,Ávila,232,157640,15381,142259,6663394,708493
2020/05/15,Madrid,Toledo,2837,694844,70978,623866,6663394,708493
2020/05/15,Madrid,Guadalajara,2061,257762,32561,225201,6663394,708493
2020/05/15,Madrid,Segovia,26,153129,18186,134943,6663394,708493
2020/05/15,Málaga,Málaga,173060,1661785,209219,1452566,1661785,211904
2020/05/15,Málaga,Granada,239,914678,116598,798080,1661785,211904
2020/05/15,Málaga,Córdoba,340,782979,110215,672764,1661785,211904
2020/05/15,Málaga,Cádiz,904,1240155,170899,1069256,1661785,211904
2020/05/15,Málaga,Melilla,16,86487,12950,73537,1661785,211904
2020/05/15,Málaga,Sevilla,244,1942389,294420,1647969,1661785,211904
2020/05/15,Melilla,Melilla,12717,86487,12950,73537,86487,12901
2020/05/15,Murcia,Albacete,451,388167,32561,355606,1493898,230647
2020/05/15,Murcia,Murcia,184346,1493898,234392,1259506,1493898,230647
2020/05/15,Murcia,Almería,1300,716820,97481,619339,1493898,230647
2020/05/15,Murcia,Alicante,2821,1858683,276725,1581958,1493898,230647
2020/05/15,Murcia,Granada,33,914678,116598,798080,1493898,230647
2020/05/15,Navarra,Araba,64,331549,57073,274476,654183,101925
2020/05/15,Navarra,Gipuzkoa,332,723576,105756,617820,654183,101925
2020/05/15,Navarra,Navarra,73557,654183,101502,552681,654183,101925
2020/05/15,Navarra,Zaragoza,562,964724,157225,807499,654183,101925
2020/05/15,Navarra,Rioja,2183,316798,48117,268681,654183,101925
2020/05/15,Ourense,Ourense,40715,307651,51972,255679,307651,52300
2020/05/15,Ourense,Pontevedra,184,942665,165962,776703,307651,52300
2020/05/15,Ourense,Zamora,53,172539,20469,152070,307651,52300
2020/05/15,Ourense,Lugo,243,329587,45713,283874,307651,52300
2020/05/15,Ourense,León,371,460001,58212,401789,307651,52300
2020/05/15,Palencia,Burgos,186,357072,40984,316088,160866,21439
2020/05/15,Palencia,León,26,460001,58212,401789,160866,21439
2020/05/15,Palencia,Valladolid,143,519546,76601,442945,160866,21439
2020/05/15,Palencia,Palencia,14482,160866,20270,140596,160866,21439
2020/05/15,Palencia,Cantabria,148,580795,88297,492498,160866,21439
2020/05/15,Pontevedra,Lugo,34,329587,45713,283874,942665,165561
2020/05/15,Pontevedra,Ourense,242,307651,51972,255679,942665,165561
2020/05/15,Pontevedra,Coruña,4126,1119596,186033,933563,942665,165561
2020/05/15,Pontevedra,Pontevedra,131341,942665,165962,776703,942665,165561
2020/05/15,Rioja,Rioja,35338,316798,48117,268681,316798,45616
2020/05/15,Rioja,Araba,742,331549,57073,274476,316798,45616
2020/05/15,Rioja,Burgos,51,357072,40984,316088,316798,45616
2020/05/15,Rioja,Navarra,1736,654183,101502,552681,316798,45616
2020/05/15,Salamanca,Ávila,189,157640,15381,142259,330119,42056
2020/05/15,Salamanca,Zamora,29,172539,20469,152070,330119,42056
2020/05/15,Salamanca,Salamanca,33692,330119,42827,287292,330119,42056
2020/05/15,Santa Cruz de Tenerife,Santa Cruz de Tenerife,139203,1032983,153756,879227,1032983,153428
2020/05/15,Santa Cruz de Tenerife,Las Palmas de Gran Canaria,21,1120406,165006,955400,1032983,153428
2020/05/15,Segovia,Ávila,79,157640,15381,142259,153129,19058
2020/05/15,Segovia,Valladolid,269,519546,76601,442945,153129,19058
2020/05/15,Segovia,Segovia,12391,153129,18186,134943,153129,19058
2020/05/15,Segovia,Burgos,95,357072,40984,316088,153129,19058
2020/05/15,Sevilla,Cádiz,713,1240155,170899,1069256,1942389,290916
2020/05/15,Sevilla,Huelva,734,521870,69903,451967,1942389,290916
2020/05/15,Sevilla,Sevilla,211583,1942389,294420,1647969,1942389,290916
2020/05/15,Sevilla,Málaga,99,1661785,209219,1452566,1942389,290916
2020/05/15,Sevilla,Córdoba,1896,782979,110215,672764,1942389,290916
2020/05/15,Soria,Burgos,29,357072,40984,316088,88636,7839
2020/05/15,Soria,Soria,5303,88636,7249,81387,88636,7839
2020/05/15,Soria,Valladolid,28,519546,76601,442945,88636,7839
2020/05/15,Soria,Zaragoza,73,964724,157225,807499,88636,7839
2020/05/15,Soria,Segovia,18,153129,18186,134943,88636,7839
2020/05/15,Soria,Navarra,18,654183,101502,552681,88636,7839
2020/05/15,Tarragona,Tarragona,75119,804664,109854,694810,804664,109730
2020/05/15,Tarragona,Castellón,801,579962,72376,507586,804664,109730
2020/05/15,Tarragona,Teruel,77,134137,10023,124114,804664,109730
2020/05/15,Tarragona,Barcelona,941,5664579,894597,4769982,804664,109730
2020/05/15,Teruel,Tarragona,199,804664,109854,694810,134137,11329
2020/05/15,Teruel,Zaragoza,89,964724,157225,807499,134137,11329
2020/05/15,Teruel,Teruel,6191,134137,10023,124114,134137,11329
2020/05/15,Teruel,Castellón,103,579962,72376,507586,134137,11329
2020/05/15,Toledo,Madrid,2540,6663394,708701,5954693,694844,69716
2020/05/15,Toledo,Ciudad Real,255,495761,39093,456668,694844,69716
2020/05/15,Toledo,Cuenca,59,196329,17416,178913,694844,69716
2020/05/15,Toledo,Cáceres,149,394151,43700,350451,694844,69716
2020/05/15,Toledo,Toledo,36854,694844,70978,623866,694844,69716
2020/05/15,Toledo,Ávila,190,157640,15381,142259,694844,69716
2020/05/15,Valencia,Albacete,270,388167,32561,355606,2565124,409987
2020/05/15,Valencia,Castellón,585,579962,72376,507586,2565124,409987
2020/05/15,Valencia,Cáceres,19,394151,43700,350451,2565124,409987
2020/05/15,Valencia,Valencia,293547,2565124,418413,2146711,2565124,409987
2020/05/15,Valencia,Murcia,28,1493898,234392,1259506,2565124,409987
2020/05/15,Valencia,Alicante,1072,1858683,276725,1581958,2565124,409987
2020/05/15,Valencia,Madrid,17,6663394,708701,5954693,2565124,409987
2020/05/15,Valencia,Cuenca,110,196329,17416,178913,2565124,409987
2020/05/15,Valladolid,Zamora,124,172539,20469,152070,519546,74413
2020/05/15,Valladolid,Ávila,49,157640,15381,142259,519546,74413
2020/05/15,Valladolid,Burgos,81,357072,40984,316088,519546,74413
2020/05/15,Valladolid,León,27,460001,58212,401789,519546,74413
2020/05/15,Valladolid,Valladolid,56116,519546,76601,442945,519546,74413
2020/05/15,Valladolid,Palencia,54,160866,20270,140596,519546,74413
2020/05/15,Valladolid,Segovia,255,153129,18186,134943,519546,74413
2020/05/15,Valladolid,Soria,42,88636,7249,81387,519546,74413
2020/05/15,Zamora,Zamora,14163,172539,20469,152070,172539,20325
2020/05/15,Zamora,Valladolid,68,519546,76601,442945,172539,20325
2020/05/15,Zamora,Ourense,74,307651,51972,255679,172539,20325
2020/05/15,Zaragoza,Lleida,72,434930,58326,376604,964724,152060
2020/05/15,Zaragoza,Teruel,165,134137,10023,124114,964724,152060
2020/05/15,Zaragoza,Navarra,434,654183,101502,552681,964724,152060
2020/05/15,Zaragoza,Zaragoza,121990,964724,157225,807499,964724,152060
2020/05/15,Zaragoza,Huesca,249,220461,26417,194044,964724,152060
2020/05/15,Zaragoza,Soria,36,88636,7249,81387,964724,152060
2020/05/16,Albacete,Cuenca,244,196329,13644,182685,388167,22985
2020/05/16,Albacete,Jaén,47,633564,54869,578695,388167,22985
2020/05/16,Albacete,Murcia,478,1493898,186443,1307455,388167,22985
2020/05/16,Albacete,Albacete,14892,388167,21983,366184,388167,22985
2020/05/16,Albacete,Alicante,150,1858683,198110,1660573,388167,22985
2020/05/16,Albacete,Valencia,296,2565124,263044,2302080,388167,22985
2020/05/16,Albacete,Ciudad Real,351,495761,27591,468170,388167,22985
2020/05/16,Alicante,Valencia,642,2565124,263044,2302080,1858683,200152
2020/05/16,Alicante,Murcia,2572,1493898,186443,1307455,1858683,200152
2020/05/16,Alicante,Alicante,163163,1858683,198110,1660573,1858683,200152
2020/05/16,Alicante,Albacete,230,388167,21983,366184,1858683,200152
2020/05/16,Almería,Almería,65347,716820,78811,638009,716820,79268
2020/05/16,Almería,Murcia,1246,1493898,186443,1307455,716820,79268
2020/05/16,Almería,Granada,288,914678,83519,831159,716820,79268
2020/05/16,Araba,Gipuzkoa,70,723576,72380,651196,331549,39925
2020/05/16,Araba,Bizkaia,563,1152934,147976,1004958,331549,39925
2020/05/16,Araba,Rioja,804,316798,34358,282440,331549,39925
2020/05/16,Araba,Navarra,32,654183,75553,578630,331549,39925
2020/05/16,Araba,Araba,32420,331549,38691,292858,331549,39925
2020/05/16,Araba,Burgos,709,357072,25941,331131,331549,39925
2020/05/16,Asturias,Cantabria,181,580795,71576,509219,1022800,130882
2020/05/16,Asturias,León,22,460001,44587,415414,1022800,130882
2020/05/16,Asturias,Asturias,105369,1022800,130721,892079,1022800,130882
2020/05/16,Asturias,Lugo,742,329587,37984,291603,1022800,130882
2020/05/16,Ávila,Ávila,7765,157640,11023,146617,157640,11700
2020/05/16,Ávila,Toledo,233,694844,49154,645690,157640,11700
2020/05/16,Ávila,Madrid,124,6663394,609586,6053808,157640,11700
2020/05/16,Ávila,Cáceres,116,394151,36303,357848,157640,11700
2020/05/16,Ávila,Salamanca,252,330119,30629,299490,157640,11700
2020/05/16,Ávila,Segovia,78,153129,12256,140873,157640,11700
2020/05/16,Badajoz,Badajoz,54916,673559,72354,601205,673559,71760
2020/05/16,Badajoz,Huelva,205,521870,58173,463697,673559,71760
2020/05/16,Badajoz,Cáceres,745,394151,36303,357848,673559,71760
2020/05/16,Badajoz,Sevilla,41,1942389,239806,1702583,673559,71760
2020/05/16,Badajoz,Córdoba,125,782979,91936,691043,673559,71760
2020/05/16,Badajoz,Ciudad Real,83,495761,27591,468170,673559,71760
2020/05/16,Balears,Balears,112971,1149460,129864,1019596,1149460,130320
2020/05/16,Balears,Valencia,16,2565124,263044,2302080,1149460,130320
2020/05/16,Barcelona,Tarragona,795,804664,89488,715176,5664579,645740
2020/05/16,Barcelona,Girona,1945,771044,59800,711244,5664579,645740
2020/05/16,Barcelona,Barcelona,452314,5664579,645141,5019438,5664579,645740
2020/05/16,Barcelona,Lleida,75,434930,41450,393480,5664579,645740
2020/05/16,Bizkaia,Araba,533,331549,38691,292858,1152934,146573
2020/05/16,Bizkaia,Bizkaia,118410,1152934,147976,1004958,1152934,146573
2020/05/16,Bizkaia,Gipuzkoa,535,723576,72380,651196,1152934,146573
2020/05/16,Bizkaia,Cantabria,683,580795,71576,509219,1152934,146573
2020/05/16,Bizkaia,Burgos,52,357072,25941,331131,1152934,146573
2020/05/16,Burgos,Burgos,19555,357072,25941,331131,357072,26418
2020/05/16,Burgos,Araba,752,331549,38691,292858,357072,26418
2020/05/16,Burgos,Valladolid,43,519546,49681,469865,357072,26418
2020/05/16,Burgos,Palencia,161,160866,14030,146836,357072,26418
2020/05/16,Burgos,Bizkaia,57,1152934,147976,1004958,357072,26418
2020/05/16,Burgos,Cantabria,35,580795,71576,509219,357072,26418
2020/05/16,Cáceres,Ávila,121,157640,11023,146617,394151,36664
2020/05/16,Cáceres,Cáceres,25952,394151,36303,357848,394151,36664
2020/05/16,Cáceres,Toledo,90,694844,49154,645690,394151,36664
2020/05/16,Cáceres,Badajoz,990,673559,72354,601205,394151,36664
2020/05/16,Cádiz,Cádiz,127409,1240155,148138,1092017,1240155,149783
2020/05/16,Cádiz,Huelva,720,521870,58173,463697,1240155,149783
2020/05/16,Cádiz,Sevilla,825,1942389,239806,1702583,1240155,149783
2020/05/16,Cádiz,Málaga,657,1661785,141609,1520176,1240155,149783
2020/05/16,Cantabria,Asturias,173,1022800,130721,892079,580795,71197
2020/05/16,Cantabria,Cantabria,54749,580795,71576,509219,580795,71197
2020/05/16,Cantabria,Bizkaia,469,1152934,147976,1004958,580795,71197
2020/05/16,Cantabria,Palencia,52,160866,14030,146836,580795,71197
2020/05/16,Castellón,Teruel,33,134137,6741,127396,579962,47227
2020/05/16,Castellón,Tarragona,792,804664,89488,715176,579962,47227
2020/05/16,Castellón,Valencia,592,2565124,263044,2302080,579962,47227
2020/05/16,Castellón,Castellón,34484,579962,46594,533368,579962,47227
2020/05/16,Ceuta,Ceuta,8666,84777,9069,75708,84777,8996
2020/05/16,Ciudad Real,Badajoz,50,673559,72354,601205,495761,27284
2020/05/16,Ciudad Real,Toledo,80,694844,49154,645690,495761,27284
2020/05/16,Ciudad Real,Córdoba,372,782979,91936,691043,495761,27284
2020/05/16,Ciudad Real,Jaén,20,633564,54869,578695,495761,27284
2020/05/16,Ciudad Real,Ciudad Real,17827,495761,27591,468170,495761,27284
2020/05/16,Ciudad Real,Albacete,350,388167,21983,366184,495761,27284
2020/05/16,Córdoba,Sevilla,1476,1942389,239806,1702583,782979,91132
2020/05/16,Córdoba,Jaén,543,633564,54869,578695,782979,91132
2020/05/16,Córdoba,Badajoz,106,673559,72354,601205,782979,91132
2020/05/16,Córdoba,Málaga,148,1661785,141609,1520176,782979,91132
2020/05/16,Córdoba,Córdoba,68293,782979,91936,691043,782979,91132
2020/05/16,Córdoba,Granada,119,914678,83519,831159,782979,91132
2020/05/16,Córdoba,Ciudad Real,245,495761,27591,468170,782979,91132
2020/05/16,Coruña,Coruña,116343,1119596,150817,968779,1119596,151715
2020/05/16,Coruña,Lugo,492,329587,37984,291603,1119596,151715
2020/05/16,Coruña,Pontevedra,4170,942665,133461,809204,1119596,151715
2020/05/16,Cuenca,Valencia,46,2565124,263044,2302080,196329,13803
2020/05/16,Cuenca,Madrid,46,6663394,609586,6053808,196329,13803
2020/05/16,Cuenca,Ciudad Real,64,495761,27591,468170,196329,13803
2020/05/16,Cuenca,Albacete,378,388167,21983,366184,196329,13803
2020/05/16,Cuenca,Toledo,86,694844,49154,645690,196329,13803
2020/05/16,Cuenca,Cuenca,8131,196329,13644,182685,196329,13803
2020/05/16,Gipuzkoa,Gipuzkoa,57788,723576,72380,651196,723576,73612
2020/05/16,Gipuzkoa,Bizkaia,679,1152934,147976,1004958,723576,73612
2020/05/16,Gipuzkoa,Navarra,227,654183,75553,578630,723576,73612
2020/05/16,Gipuzkoa,Araba,102,331549,38691,292858,723576,73612
2020/05/16,Girona,Girona,41390,771044,59800,711244,771044,62072
2020/05/16,Girona,Lleida,116,434930,41450,393480,771044,62072
2020/05/16,Girona,Almería,20,716820,78811,638009,771044,62072
2020/05/16,Girona,Barcelona,1720,5664579,645141,5019438,771044,62072
2020/05/16,Granada,Córdoba,215,782979,91936,691043,914678,83894
2020/05/16,Granada,Almería,477,716820,78811,638009,914678,83894
2020/05/16,Granada,Jaén,269,633564,54869,578695,914678,83894
2020/05/16,Granada,Murcia,33,1493898,186443,1307455,914678,83894
2020/05/16,Granada,Málaga,101,1661785,141609,1520176,914678,83894
2020/05/16,Granada,Granada,63263,914678,83519,831159,914678,83894
2020/05/16,Guadalajara,Madrid,1114,6663394,609586,6053808,257762,25370
2020/05/16,Guadalajara,Guadalajara,17578,257762,25743,232019,257762,25370
2020/05/16,Huelva,Cádiz,566,1240155,148138,1092017,521870,59690
2020/05/16,Huelva,Badajoz,336,673559,72354,601205,521870,59690
2020/05/16,Huelva,Sevilla,1475,1942389,239806,1702583,521870,59690
2020/05/16,Huelva,Huelva,45919,521870,58173,463697,521870,59690
2020/05/16,Huesca,Lleida,533,434930,41450,393480,220461,20615
2020/05/16,Huesca,Zaragoza,94,964724,125770,838954,220461,20615
2020/05/16,Huesca,Huesca,14310,220461,19774,200687,220461,20615
2020/05/16,Jaén,Jaén,40206,633564,54869,578695,633564,54635
2020/05/16,Jaén,Albacete,19,388167,21983,366184,633564,54635
2020/05/16,Jaén,Granada,244,914678,83519,831159,633564,54635
2020/05/16,Jaén,Córdoba,674,782979,91936,691043,633564,54635
2020/05/16,Las Palmas de Gran Canaria,Las Palmas de Gran Canaria,119826,1120406,132635,987771,1120406,131529
2020/05/16,Las Palmas de Gran Canaria,Santa Cruz de Tenerife,41,1032983,122912,910071,1120406,131529
2020/05/16,León,Palencia,34,160866,14030,146836,460001,44254
2020/05/16,León,León,34079,460001,44587,415414,460001,44254
2020/05/16,León,Zamora,38,172539,14749,157790,460001,44254
2020/05/16,León,Ourense,196,307651,44197,263454,460001,44254
2020/05/16,León,Asturias,52,1022800,130721,892079,460001,44254
2020/05/16,Lleida,Barcelona,85,5664579,645141,5019438,434930,40466
2020/05/16,Lleida,Huesca,401,220461,19774,200687,434930,40466
2020/05/16,Lleida,Girona,196,771044,59800,711244,434930,40466
2020/05/16,Lleida,Zaragoza,127,964724,125770,838954,434930,40466
2020/05/16,Lleida,Lleida,28376,434930,41450,393480,434930,40466
2020/05/16,Lleida,Tarragona,47,804664,89488,715176,434930,40466
2020/05/16,Lugo,Ourense,148,307651,44197,263454,329587,38904
2020/05/16,Lugo,Asturias,681,1022800,130721,892079,329587,38904
2020/05/16,Lugo,Lugo,28547,329587,37984,291603,329587,38904
2020/05/16,Lugo,Coruña,501,1119596,150817,968779,329587,38904
2020/05/16,Lugo,Pontevedra,30,942665,133461,809204,329587,38904
2020/05/16,Madrid,Toledo,1990,694844,49154,645690,6663394,611346
2020/05/16,Madrid,Guadalajara,1206,257762,25743,232019,6663394,611346
2020/05/16,Madrid,Madrid,402283,6663394,609586,6053808,6663394,611346
2020/05/16,Madrid,Cuenca,36,196329,13644,182685,6663394,611346
2020/05/16,Madrid,Ávila,88,157640,11023,146617,6663394,611346
2020/05/16,Málaga,Córdoba,259,782979,91936,691043,1661785,141678
2020/05/16,Málaga,Málaga,116269,1661785,141609,1520176,1661785,141678
2020/05/16,Málaga,Sevilla,157,1942389,239806,1702583,1661785,141678
2020/05/16,Málaga,Granada,98,914678,83519,831159,1661785,141678
2020/05/16,Málaga,Cádiz,635,1240155,148138,1092017,1661785,141678
2020/05/16,Melilla,Melilla,11542,86487,11761,74726,86487,11733
2020/05/16,Murcia,Alicante,1971,1858683,198110,1660573,1493898,184088
2020/05/16,Murcia,Albacete,195,388167,21983,366184,1493898,184088
2020/05/16,Murcia,Murcia,149986,1493898,186443,1307455,1493898,184088
2020/05/16,Murcia,Almería,987,716820,78811,638009,1493898,184088
2020/05/16,Navarra,Araba,23,331549,38691,292858,654183,75219
2020/05/16,Navarra,Navarra,54562,654183,75553,578630,654183,75219
2020/05/16,Navarra,Zaragoza,425,964724,125770,838954,654183,75219
2020/05/16,Navarra,Gipuzkoa,262,723576,72380,651196,654183,75219
2020/05/16,Navarra,Rioja,1028,316798,34358,282440,654183,75219
2020/05/16,Ourense,Lugo,201,329587,37984,291603,307651,44735
2020/05/16,Ourense,Ourense,36265,307651,44197,263454,307651,44735
2020/05/16,Ourense,León,94,460001,44587,415414,307651,44735
2020/05/16,Ourense,Pontevedra,122,942665,133461,809204,307651,44735
2020/05/16,Palencia,León,23,460001,44587,415414,160866,14181
2020/05/16,Palencia,Palencia,10114,160866,14030,146836,160866,14181
2020/05/16,Palencia,Valladolid,25,519546,49681,469865,160866,14181
2020/05/16,Palencia,Burgos,139,357072,25941,331131,160866,14181
2020/05/16,Palencia,Cantabria,36,580795,71576,509219,160866,14181
2020/05/16,Pontevedra,Pontevedra,104832,942665,133461,809204,942665,132655
2020/05/16,Pontevedra,Coruña,3608,1119596,150817,968779,942665,132655
2020/05/16,Pontevedra,Ourense,164,307651,44197,263454,942665,132655
2020/05/16,Rioja,Araba,505,331549,38691,292858,316798,33848
2020/05/16,Rioja,Rioja,26982,316798,34358,282440,316798,33848
2020/05/16,Rioja,Navarra,1370,654183,75553,578630,316798,33848
2020/05/16,Salamanca,Salamanca,24484,330119,30629,299490,330119,30700
2020/05/16,Salamanca,Zamora,38,172539,14749,157790,330119,30700
2020/05/16,Salamanca,Ávila,190,157640,11023,146617,330119,30700
2020/05/16,Santa Cruz de Tenerife,Santa Cruz de Tenerife,108097,1032983,122912,910071,1032983,122530
2020/05/16,Segovia,Segovia,8589,153129,12256,140873,153129,12647
2020/05/16,Segovia,Burgos,85,357072,25941,331131,153129,12647
2020/05/16,Segovia,Valladolid,111,519546,49681,469865,153129,12647
2020/05/16,Segovia,Ávila,70,157640,11023,146617,153129,12647
2020/05/16,Sevilla,Sevilla,172093,1942389,239806,1702583,1942389,237126
2020/05/16,Sevilla,Córdoba,1776,782979,91936,691043,1942389,237126
2020/05/16,Sevilla,Cádiz,718,1240155,148138,1092017,1942389,237126
2020/05/16,Sevilla,Huelva,498,521870,58173,463697,1942389,237126
2020/05/16,Sevilla,Málaga,83,1661785,141609,1520176,1942389,237126
2020/05/16,Sevilla,Badajoz,27,673559,72354,601205,1942389,237126
2020/05/16,Soria,Soria,3493,88636,4737,83899,88636,4763
2020/05/16,Soria,Segovia,19,153129,12256,140873,88636,4763
2020/05/16,Tarragona,Castellón,480,579962,46594,533368,804664,88298
2020/05/16,Tarragona,Lleida,42,434930,41450,393480,804664,88298
2020/05/16,Tarragona,Tarragona,65104,804664,89488,715176,804664,88298
2020/05/16,Tarragona,Teruel,154,134137,6741,127396,804664,88298
2020/05/16,Tarragona,Barcelona,745,5664579,645141,5019438,804664,88298
2020/05/16,Teruel,Tarragona,38,804664,89488,715176,134137,7016
2020/05/16,Teruel,Zaragoza,42,964724,125770,838954,134137,7016
2020/05/16,Teruel,Teruel,4174,134137,6741,127396,134137,7016
2020/05/16,Teruel,Castellón,39,579962,46594,533368,134137,7016
2020/05/16,Toledo,Madrid,1894,6663394,609586,6053808,694844,48688
2020/05/16,Toledo,Ávila,185,157640,11023,146617,694844,48688
2020/05/16,Toledo,Cuenca,41,196329,13644,182685,694844,48688
2020/05/16,Toledo,Toledo,26971,694844,49154,645690,694844,48688
2020/05/16,Toledo,Cáceres,120,394151,36303,357848,694844,48688
2020/05/16,Toledo,Ciudad Real,162,495761,27591,468170,694844,48688
2020/05/16,Valencia,Albacete,215,388167,21983,366184,2565124,261392
2020/05/16,Valencia,Alicante,778,1858683,198110,1660573,2565124,261392
2020/05/16,Valencia,Castellón,347,579962,46594,533368,2565124,261392
2020/05/16,Valencia,Cuenca,70,196329,13644,182685,2565124,261392
2020/05/16,Valencia,Valencia,189163,2565124,263044,2302080,2565124,261392
2020/05/16,Valencia,Barcelona,21,5664579,645141,5019438,2565124,261392
2020/05/16,Valladolid,Zamora,66,172539,14749,157790,519546,48409
2020/05/16,Valladolid,León,26,460001,44587,415414,519546,48409
2020/05/16,Valladolid,Burgos,84,357072,25941,331131,519546,48409
2020/05/16,Valladolid,Valladolid,35623,519546,49681,469865,519546,48409
2020/05/16,Valladolid,Soria,20,88636,4737,83899,519546,48409
2020/05/16,Valladolid,Segovia,148,153129,12256,140873,519546,48409
2020/05/16,Valladolid,Palencia,29,160866,14030,146836,519546,48409
2020/05/16,Zamora,Valladolid,82,519546,49681,469865,172539,14837
2020/05/16,Zamora,Salamanca,17,330119,30629,299490,172539,14837
2020/05/16,Zamora,Zamora,10806,172539,14749,157790,172539,14837
2020/05/16,Zamora,León,32,460001,44587,415414,172539,14837
2020/05/16,Zaragoza,Teruel,56,134137,6741,127396,964724,122714
2020/05/16,Zaragoza,Soria,19,88636,4737,83899,964724,122714
2020/05/16,Zaragoza,Tarragona,32,804664,89488,715176,964724,122714
2020/05/16,Zaragoza,Huesca,113,220461,19774,200687,964724,122714
2020/05/16,Zaragoza,Lleida,105,434930,41450,393480,964724,122714
2020/05/16,Zaragoza,Zaragoza,95847,964724,125770,838954,964724,122714
2020/05/16,Zaragoza,Navarra,376,654183,75553,578630,964724,122714
2020/05/17,Albacete,Albacete,11433,388167,16959,371208,388167,17058
2020/05/17,Albacete,Cuenca,221,196329,11430,184899,388167,17058
2020/05/17,Albacete,Alicante,156,1858683,153424,1705259,388167,17058
2020/05/17,Albacete,Valencia,282,2565124,212592,2352532,388167,17058
2020/05/17,Albacete,Murcia,248,1493898,150805,1343093,388167,17058
2020/05/17,Albacete,Jaén,70,633564,45640,587924,388167,17058
2020/05/17,Albacete,Ciudad Real,288,495761,20404,475357,388167,17058
2020/05/17,Alicante,Murcia,1856,1493898,150805,1343093,1858683,153924
2020/05/17,Alicante,Alicante,126554,1858683,153424,1705259,1858683,153924
2020/05/17,Alicante,Albacete,184,388167,16959,371208,1858683,153924
2020/05/17,Alicante,Valencia,827,2565124,212592,2352532,1858683,153924
2020/05/17,Almería,Murcia,628,1493898,150805,1343093,716820,59388
2020/05/17,Almería,Almería,48809,716820,60596,656224,716820,59388
2020/05/17,Almería,Granada,237,914678,64531,850147,716820,59388
2020/05/17,Araba,Navarra,42,654183,65963,588220,331549,34162
2020/05/17,Araba,Rioja,864,316798,32522,284276,331549,34162
2020/05/17,Araba,Araba,28047,331549,32946,298603,331549,34162
2020/05/17,Araba,Bizkaia,480,1152934,124729,1028205,331549,34162
2020/05/17,Araba,Burgos,588,357072,19482,337590,331549,34162
2020/05/17,Araba,Gipuzkoa,64,723576,56888,666688,331549,34162
2020/05/17,Asturias,Asturias,95919,1022800,119280,903520,1022800,119018
2020/05/17,Asturias,Cantabria,219,580795,65445,515350,1022800,119018
2020/05/17,Asturias,Lugo,667,329587,32965,296622,1022800,119018
2020/05/17,Ávila,Cáceres,75,394151,31851,362300,157640,9477
2020/05/17,Ávila,Ávila,6434,157640,9193,148447,157640,9477
2020/05/17,Ávila,Segovia,55,153129,9881,143248,157640,9477
2020/05/17,Ávila,Madrid,81,6663394,507908,6155486,157640,9477
2020/05/17,Ávila,Salamanca,138,330119,24020,306099,157640,9477
2020/05/17,Ávila,Toledo,194,694844,36887,657957,157640,9477
2020/05/17,Badajoz,Sevilla,128,1942389,200965,1741424,673559,62885
2020/05/17,Badajoz,Badajoz,48707,673559,63686,609873,673559,62885
2020/05/17,Badajoz,Huelva,231,521870,49407,472463,673559,62885
2020/05/17,Badajoz,Ciudad Real,38,495761,20404,475357,673559,62885
2020/05/17,Badajoz,Cáceres,788,394151,31851,362300,673559,62885
2020/05/17,Badajoz,Córdoba,132,782979,79224,703755,673559,62885
2020/05/17,Balears,Balears,98571,1149460,114345,1035115,1149460,113999
2020/05/17,Barcelona,Balears,16,1149460,114345,1035115,5664579,478796
2020/05/17,Barcelona,Lleida,87,434930,33613,401317,5664579,478796
2020/05/17,Barcelona,Girona,1343,771044,44426,726618,5664579,478796
2020/05/17,Barcelona,Barcelona,347905,5664579,475777,5188802,5664579,478796
2020/05/17,Barcelona,Tarragona,611,804664,75273,729391,5664579,478796
2020/05/17,Bizkaia,Bizkaia,101584,1152934,124729,1028205,1152934,124154
2020/05/17,Bizkaia,Gipuzkoa,515,723576,56888,666688,1152934,124154
2020/05/17,Bizkaia,Cantabria,538,580795,65445,515350,1152934,124154
2020/05/17,Bizkaia,Araba,417,331549,32946,298603,1152934,124154
2020/05/17,Bizkaia,Burgos,21,357072,19482,337590,1152934,124154
2020/05/17,Burgos,Bizkaia,56,1152934,124729,1028205,357072,20171
2020/05/17,Burgos,Segovia,25,153129,9881,143248,357072,20171
2020/05/17,Burgos,Araba,621,331549,32946,298603,357072,20171
2020/05/17,Burgos,Burgos,14639,357072,19482,337590,357072,20171
2020/05/17,Burgos,Soria,28,88636,3755,84881,357072,20171
2020/05/17,Burgos,Valladolid,88,519546,36619,482927,357072,20171
2020/05/17,Burgos,Palencia,119,160866,10672,150194,357072,20171
2020/05/17,Cáceres,Toledo,103,694844,36887,657957,394151,31621
2020/05/17,Cáceres,Cáceres,23118,394151,31851,362300,394151,31621
2020/05/17,Cáceres,Ávila,100,157640,9193,148447,394151,31621
2020/05/17,Cáceres,Badajoz,731,673559,63686,609873,394151,31621
2020/05/17,Cádiz,Sevilla,673,1942389,200965,1741424,1240155,133782
2020/05/17,Cádiz,Ceuta,20,84777,7523,77254,1240155,133782
2020/05/17,Cádiz,Huelva,629,521870,49407,472463,1240155,133782
2020/05/17,Cádiz,Málaga,546,1661785,105421,1556364,1240155,133782
2020/05/17,Cádiz,Cádiz,114320,1240155,133155,1107000,1240155,133782
2020/05/17,Cantabria,Asturias,154,1022800,119280,903520,580795,64885
2020/05/17,Cantabria,Cantabria,50300,580795,65445,515350,580795,64885
2020/05/17,Cantabria,Palencia,37,160866,10672,150194,580795,64885
2020/05/17,Cantabria,Bizkaia,486,1152934,124729,1028205,580795,64885
2020/05/17,Castellón,Almería,17,716820,60596,656224,579962,36291
2020/05/17,Castellón,Valencia,501,2565124,212592,2352532,579962,36291
2020/05/17,Castellón,Tarragona,617,804664,75273,729391,579962,36291
2020/05/17,Castellón,Castellón,26704,579962,35669,544293,579962,36291
2020/05/17,Ceuta,Ceuta,7089,84777,7523,77254,84777,7452
2020/05/17,Ciudad Real,Ciudad Real,13235,495761,20404,475357,495761,20404
2020/05/17,Ciudad Real,Córdoba,336,782979,79224,703755,495761,20404
2020/05/17,Ciudad Real,Badajoz,59,673559,63686,609873,495761,20404
2020/05/17,Ciudad Real,Toledo,65,694844,36887,657957,495761,20404
2020/05/17,Ciudad Real,Jaén,29,633564,45640,587924,495761,20404
2020/05/17,Ciudad Real,Albacete,313,388167,16959,371208,495761,20404
2020/05/17,Córdoba,Málaga,166,1661785,105421,1556364,782979,77811
2020/05/17,Córdoba,Córdoba,58289,782979,79224,703755,782979,77811
2020/05/17,Córdoba,Badajoz,176,673559,63686,609873,782979,77811
2020/05/17,Córdoba,Sevilla,1130,1942389,200965,1741424,782979,77811
2020/05/17,Córdoba,Granada,106,914678,64531,850147,782979,77811
2020/05/17,Córdoba,Ciudad Real,224,495761,20404,475357,782979,77811
2020/05/17,Córdoba,Jaén,508,633564,45640,587924,782979,77811
2020/05/17,Coruña,Lugo,399,329587,32965,296622,1119596,128731
2020/05/17,Coruña,Coruña,98138,1119596,128469,991127,1119596,128731
2020/05/17,Coruña,Pontevedra,3679,942665,112850,829815,1119596,128731
2020/05/17,Cuenca,Albacete,368,388167,16959,371208,196329,11747
2020/05/17,Cuenca,Cuenca,7333,196329,11430,184899,196329,11747
2020/05/17,Cuenca,Toledo,35,694844,36887,657957,196329,11747
2020/05/17,Cuenca,Madrid,49,6663394,507908,6155486,196329,11747
2020/05/17,Cuenca,Guadalajara,21,257762,22183,235579,196329,11747
2020/05/17,Cuenca,Valencia,61,2565124,212592,2352532,196329,11747
2020/05/17,Gipuzkoa,Navarra,137,654183,65963,588220,723576,57678
2020/05/17,Gipuzkoa,Gipuzkoa,45948,723576,56888,666688,723576,57678
2020/05/17,Gipuzkoa,Araba,39,331549,32946,298603,723576,57678
2020/05/17,Gipuzkoa,Bizkaia,450,1152934,124729,1028205,723576,57678
2020/05/17,Girona,Barcelona,1226,5664579,475777,5188802,771044,45683
2020/05/17,Girona,Girona,31067,771044,44426,726618,771044,45683
2020/05/17,Girona,Lleida,140,434930,33613,401317,771044,45683
2020/05/17,Granada,Málaga,84,1661785,105421,1556364,914678,64506
2020/05/17,Granada,Almería,497,716820,60596,656224,914678,64506
2020/05/17,Granada,Jaén,235,633564,45640,587924,914678,64506
2020/05/17,Granada,Córdoba,200,782979,79224,703755,914678,64506
2020/05/17,Granada,Granada,48178,914678,64531,850147,914678,64506
2020/05/17,Guadalajara,Guadalajara,15436,257762,22183,235579,257762,21862
2020/05/17,Guadalajara,Cuenca,29,196329,11430,184899,257762,21862
2020/05/17,Guadalajara,Madrid,942,6663394,507908,6155486,257762,21862
2020/05/17,Huelva,Cádiz,596,1240155,133155,1107000,521870,49486
2020/05/17,Huelva,Badajoz,307,673559,63686,609873,521870,49486
2020/05/17,Huelva,Sevilla,443,1942389,200965,1741424,521870,49486
2020/05/17,Huelva,Huelva,38912,521870,49407,472463,521870,49486
2020/05/17,Huesca,Zaragoza,157,964724,107757,856967,220461,20055
2020/05/17,Huesca,Lleida,517,434930,33613,401317,220461,20055
2020/05/17,Huesca,Huesca,14261,220461,19194,201267,220461,20055
2020/05/17,Jaén,Jaén,33397,633564,45640,587924,633564,45122
2020/05/17,Jaén,Granada,157,914678,64531,850147,633564,45122
2020/05/17,Jaén,Córdoba,603,782979,79224,703755,633564,45122
2020/05/17,Las Palmas de Gran Canaria,Las Palmas de Gran Canaria,92740,1120406,105306,1015100,1120406,104189
2020/05/17,León,León,25306,460001,33331,426670,460001,33554
2020/05/17,León,Ourense,29,307651,36495,271156,460001,33554
2020/05/17,León,Asturias,53,1022800,119280,903520,460001,33554
2020/05/17,Lleida,Huesca,316,220461,19194,201267,434930,32685
2020/05/17,Lleida,Girona,142,771044,44426,726618,434930,32685
2020/05/17,Lleida,Zaragoza,86,964724,107757,856967,434930,32685
2020/05/17,Lleida,Tarragona,29,804664,75273,729391,434930,32685
2020/05/17,Lleida,Lleida,22902,434930,33613,401317,434930,32685
2020/05/17,Lleida,Barcelona,53,5664579,475777,5188802,434930,32685
2020/05/17,Lugo,Ourense,99,307651,36495,271156,329587,33076
2020/05/17,Lugo,Coruña,430,1119596,128469,991127,329587,33076
2020/05/17,Lugo,Asturias,538,1022800,119280,903520,329587,33076
2020/05/17,Lugo,Lugo,24491,329587,32965,296622,329587,33076
2020/05/17,Madrid,Guadalajara,964,257762,22183,235579,6663394,511777
2020/05/17,Madrid,Madrid,361951,6663394,507908,6155486,6663394,511777
2020/05/17,Madrid,Ávila,113,157640,9193,148447,6663394,511777
2020/05/17,Madrid,Cuenca,55,196329,11430,184899,6663394,511777
2020/05/17,Madrid,Toledo,1725,694844,36887,657957,6663394,511777
2020/05/17,Málaga,Cádiz,497,1240155,133155,1107000,1661785,105147
2020/05/17,Málaga,Sevilla,64,1942389,200965,1741424,1661785,105147
2020/05/17,Málaga,Córdoba,50,782979,79224,703755,1661785,105147
2020/05/17,Málaga,Málaga,86210,1661785,105421,1556364,1661785,105147
2020/05/17,Málaga,Granada,92,914678,64531,850147,1661785,105147
2020/05/17,Melilla,Melilla,9659,86487,9769,76718,86487,9900
2020/05/17,Murcia,Alicante,1471,1858683,153424,1705259,1493898,148808
2020/05/17,Murcia,Albacete,114,388167,16959,371208,1493898,148808
2020/05/17,Murcia,Almería,662,716820,60596,656224,1493898,148808
2020/05/17,Murcia,Murcia,120446,1493898,150805,1343093,1493898,148808
2020/05/17,Navarra,Gipuzkoa,127,723576,56888,666688,654183,66231
2020/05/17,Navarra,Rioja,861,316798,32522,284276,654183,66231
2020/05/17,Navarra,Navarra,48771,654183,65963,588220,654183,66231
2020/05/17,Navarra,Zaragoza,296,964724,107757,856967,654183,66231
2020/05/17,Ourense,Ourense,30104,307651,36495,271156,307651,36358
2020/05/17,Ourense,León,78,460001,33331,426670,307651,36358
2020/05/17,Ourense,Lugo,129,329587,32965,296622,307651,36358
2020/05/17,Ourense,Pontevedra,105,942665,112850,829815,307651,36358
2020/05/17,Palencia,Cantabria,54,580795,65445,515350,160866,10875
2020/05/17,Palencia,Palencia,7723,160866,10672,150194,160866,10875
2020/05/17,Palencia,Valladolid,29,519546,36619,482927,160866,10875
2020/05/17,Palencia,Burgos,126,357072,19482,337590,160866,10875
2020/05/17,Pontevedra,Coruña,3379,1119596,128469,991127,942665,112266
2020/05/17,Pontevedra,Pontevedra,87866,942665,112850,829815,942665,112266
2020/05/17,Pontevedra,Ourense,205,307651,36495,271156,942665,112266
2020/05/17,Rioja,Araba,410,331549,32946,298603,316798,31989
2020/05/17,Rioja,Navarra,1035,654183,65963,588220,316798,31989
2020/05/17,Rioja,Rioja,26146,316798,32522,284276,316798,31989
2020/05/17,Salamanca,Salamanca,18928,330119,24020,306099,330119,23818
2020/05/17,Salamanca,Ávila,170,157640,9193,148447,330119,23818
2020/05/17,Santa Cruz de Tenerife,Santa Cruz de Tenerife,80322,1032983,95201,937782,1032983,94842
2020/05/17,Santa Cruz de Tenerife,Las Palmas de Gran Canaria,19,1120406,105306,1015100,1032983,94842
2020/05/17,Segovia,Valladolid,108,519546,36619,482927,153129,10031
2020/05/17,Segovia,Segovia,7015,153129,9881,143248,153129,10031
2020/05/17,Segovia,Burgos,52,357072,19482,337590,153129,10031
2020/05/17,Segovia,Ávila,52,157640,9193,148447,153129,10031
2020/05/17,Sevilla,Cádiz,688,1240155,133155,1107000,1942389,200371
2020/05/17,Sevilla,Córdoba,1707,782979,79224,703755,1942389,200371
2020/05/17,Sevilla,Badajoz,74,673559,63686,609873,1942389,200371
2020/05/17,Sevilla,Sevilla,142208,1942389,200965,1741424,1942389,200371
2020/05/17,Sevilla,Huelva,435,521870,49407,472463,1942389,200371
2020/05/17,Sevilla,Málaga,41,1661785,105421,1556364,1942389,200371
2020/05/17,Soria,Valladolid,21,519546,36619,482927,88636,3910
2020/05/17,Soria,Soria,2836,88636,3755,84881,88636,3910
2020/05/17,Tarragona,Barcelona,566,5664579,475777,5188802,804664,74353
2020/05/17,Tarragona,Tarragona,54901,804664,75273,729391,804664,74353
2020/05/17,Tarragona,Castellón,433,579962,35669,544293,804664,74353
2020/05/17,Tarragona,Teruel,34,134137,5575,128562,804664,74353
2020/05/17,Tarragona,Zaragoza,38,964724,107757,856967,804664,74353
2020/05/17,Teruel,Teruel,3503,134137,5575,128562,134137,6082
2020/05/17,Teruel,Castellón,25,579962,35669,544293,134137,6082
2020/05/17,Teruel,Tarragona,52,804664,75273,729391,134137,6082
2020/05/17,Toledo,Madrid,1585,6663394,507908,6155486,694844,36825
2020/05/17,Toledo,Ávila,214,157640,9193,148447,694844,36825
2020/05/17,Toledo,Cáceres,124,394151,31851,362300,694844,36825
2020/05/17,Toledo,Ciudad Real,112,495761,20404,475357,694844,36825
2020/05/17,Toledo,Toledo,20560,694844,36887,657957,694844,36825
2020/05/17,Toledo,Cuenca,35,196329,11430,184899,694844,36825
2020/05/17,Valencia,Cuenca,60,196329,11430,184899,2565124,211827
2020/05/17,Valencia,Alicante,571,1858683,153424,1705259,2565124,211827
2020/05/17,Valencia,Castellón,384,579962,35669,544293,2565124,211827
2020/05/17,Valencia,Valencia,161729,2565124,212592,2352532,2565124,211827
2020/05/17,Valencia,Albacete,157,388167,16959,371208,2565124,211827
2020/05/17,Valladolid,Valladolid,26519,519546,36619,482927,519546,36567
2020/05/17,Valladolid,Burgos,90,357072,19482,337590,519546,36567
2020/05/17,Valladolid,Soria,22,88636,3755,84881,519546,36567
2020/05/17,Valladolid,Zamora,100,172539,10948,161591,519546,36567
2020/05/17,Valladolid,Palencia,34,160866,10672,150194,519546,36567
2020/05/17,Valladolid,Segovia,87,153129,9881,143248,519546,36567
2020/05/17,Zamora,Valladolid,67,519546,36619,482927,172539,11107
2020/05/17,Zamora,Zamora,8204,172539,10948,161591,172539,11107
2020/05/17,Zaragoza,Huesca,146,220461,19194,201267,964724,106257
2020/05/17,Zaragoza,Navarra,312,654183,65963,588220,964724,106257
2020/05/17,Zaragoza,Lleida,86,434930,33613,401317,964724,106257
2020/05/17,Zaragoza,Zaragoza,81487,964724,107757,856967,964724,106257
2020/05/17,Zaragoza,Teruel,25,134137,5575,128562,964724,106257
2020/05/18,Albacete,Albacete,23228,388167,38294,349873,388167,38127
2020/05/18,Albacete,Jaén,41,633564,71800,561764,388167,38127
2020/05/18,Albacete,Cuenca,767,196329,21686,174643,388167,38127
2020/05/18,Albacete,Alicante,192,1858683,290651,1568032,388167,38127
2020/05/18,Albacete,Valencia,348,2565124,466526,2098598,388167,38127
2020/05/18,Albacete,Ciudad Real,585,495761,49453,446308,388167,38127
2020/05/18,Albacete,Murcia,569,1493898,229243,1264655,388167,38127
2020/05/18,Alicante,Albacete,356,388167,38294,349873,1858683,294432
2020/05/18,Alicante,Alicante,226487,1858683,290651,1568032,1858683,294432
2020/05/18,Alicante,Murcia,3334,1493898,229243,1264655,1858683,294432
2020/05/18,Alicante,Valencia,1370,2565124,466526,2098598,1858683,294432
2020/05/18,Almería,Almería,80019,716820,97598,619222,716820,99567
2020/05/18,Almería,Granada,479,914678,136652,778026,716820,99567
2020/05/18,Almería,Murcia,1907,1493898,229243,1264655,716820,99567
2020/05/18,Araba,Rioja,2455,316798,51220,265578,331549,68160
2020/05/18,Araba,Navarra,192,654183,104038,550145,331549,68160
2020/05/18,Araba,Araba,49150,331549,59541,272008,331549,68160
2020/05/18,Araba,Gipuzkoa,158,723576,109206,614370,331549,68160
2020/05/18,Araba,Bizkaia,1447,1152934,218469,934465,331549,68160
2020/05/18,Araba,Burgos,1831,357072,42828,314244,331549,68160
2020/05/18,Asturias,Lugo,1003,329587,48738,280849,1022800,164671
2020/05/18,Asturias,Cantabria,302,580795,95055,485740,1022800,164671
2020/05/18,Asturias,León,29,460001,63825,396176,1022800,164671
2020/05/18,Asturias,Asturias,131909,1022800,166084,856716,1022800,164671
2020/05/18,Ávila,Toledo,188,694844,90693,604151,157640,18374
2020/05/18,Ávila,Segovia,80,153129,19166,133963,157640,18374
2020/05/18,Ávila,Salamanca,390,330119,45880,284239,157640,18374
2020/05/18,Ávila,Ávila,11609,157640,17768,139872,157640,18374
2020/05/18,Ávila,Cáceres,131,394151,47880,346271,157640,18374
2020/05/18,Ávila,Madrid,122,6663394,984934,5678460,157640,18374
2020/05/18,Badajoz,Badajoz,67485,673559,92769,580790,673559,90578
2020/05/18,Badajoz,Córdoba,104,782979,114866,668113,673559,90578
2020/05/18,Badajoz,Huelva,246,521870,76020,445850,673559,90578
2020/05/18,Badajoz,Sevilla,83,1942389,313361,1629028,673559,90578
2020/05/18,Badajoz,Ciudad Real,56,495761,49453,446308,673559,90578
2020/05/18,Badajoz,Cáceres,1059,394151,47880,346271,673559,90578
2020/05/18,Balears,Valencia,22,2565124,466526,2098598,1149460,158886
2020/05/18,Balears,Balears,137661,1149460,158141,991319,1149460,158886
2020/05/18,Barcelona,Girona,2844,771044,99178,671866,5664579,911386
2020/05/18,Barcelona,Lleida,249,434930,64039,370891,5664579,911386
2020/05/18,Barcelona,Tarragona,1741,804664,112226,692438,5664579,911386
2020/05/18,Barcelona,Barcelona,565433,5664579,910281,4754298,5664579,911386
2020/05/18,Bizkaia,Burgos,58,357072,42828,314244,1152934,214050
2020/05/18,Bizkaia,Cantabria,2608,580795,95055,485740,1152934,214050
2020/05/18,Bizkaia,Bizkaia,165425,1152934,218469,934465,1152934,214050
2020/05/18,Bizkaia,Gipuzkoa,1080,723576,109206,614370,1152934,214050
2020/05/18,Bizkaia,Araba,786,331549,59541,272008,1152934,214050
2020/05/18,Burgos,Cantabria,23,580795,95055,485740,357072,44868
2020/05/18,Burgos,Segovia,29,153129,19166,133963,357072,44868
2020/05/18,Burgos,Burgos,31163,357072,42828,314244,357072,44868
2020/05/18,Burgos,Rioja,67,316798,51220,265578,357072,44868
2020/05/18,Burgos,Palencia,194,160866,20974,139892,357072,44868
2020/05/18,Burgos,Araba,1254,331549,59541,272008,357072,44868
2020/05/18,Burgos,Valladolid,76,519546,77400,442146,357072,44868
2020/05/18,Burgos,Bizkaia,143,1152934,218469,934465,357072,44868
2020/05/18,Burgos,Soria,35,88636,7863,80773,357072,44868
2020/05/18,Cáceres,Badajoz,1303,673559,92769,580790,394151,48152
2020/05/18,Cáceres,Toledo,181,694844,90693,604151,394151,48152
2020/05/18,Cáceres,Cáceres,32511,394151,47880,346271,394151,48152
2020/05/18,Cáceres,Ávila,145,157640,17768,139872,394151,48152
2020/05/18,Cádiz,Cádiz,153842,1240155,186422,1053733,1240155,188445
2020/05/18,Cádiz,Málaga,1307,1661785,245558,1416227,1240155,188445
2020/05/18,Cádiz,Huelva,766,521870,76020,445850,1240155,188445
2020/05/18,Cádiz,Sevilla,1071,1942389,313361,1629028,1240155,188445
2020/05/18,Cantabria,Bizkaia,612,1152934,218469,934465,580795,89089
2020/05/18,Cantabria,Palencia,37,160866,20974,139892,580795,89089
2020/05/18,Cantabria,Cantabria,67943,580795,95055,485740,580795,89089
2020/05/18,Cantabria,Asturias,237,1022800,166084,856716,580795,89089
2020/05/18,Castellón,Valencia,588,2565124,466526,2098598,579962,84763
2020/05/18,Castellón,Teruel,130,134137,10871,123266,579962,84763
2020/05/18,Castellón,Tarragona,852,804664,112226,692438,579962,84763
2020/05/18,Castellón,Castellón,60206,579962,79794,500168,579962,84763
2020/05/18,Ceuta,Ceuta,10606,84777,11109,73668,84777,11188
2020/05/18,Ceuta,Cádiz,25,1240155,186422,1053733,84777,11188
2020/05/18,Ciudad Real,Albacete,447,388167,38294,349873,495761,44426
2020/05/18,Ciudad Real,Ciudad Real,28824,495761,49453,446308,495761,44426
2020/05/18,Ciudad Real,Córdoba,333,782979,114866,668113,495761,44426
2020/05/18,Ciudad Real,Badajoz,57,673559,92769,580790,495761,44426
2020/05/18,Ciudad Real,Cuenca,34,196329,21686,174643,495761,44426
2020/05/18,Ciudad Real,Toledo,397,694844,90693,604151,495761,44426
2020/05/18,Córdoba,Sevilla,1823,1942389,313361,1629028,782979,110610
2020/05/18,Córdoba,Málaga,197,1661785,245558,1416227,782979,110610
2020/05/18,Córdoba,Córdoba,80136,782979,114866,668113,782979,110610
2020/05/18,Córdoba,Ciudad Real,266,495761,49453,446308,782979,110610
2020/05/18,Córdoba,Granada,119,914678,136652,778026,782979,110610
2020/05/18,Córdoba,Jaén,649,633564,71800,561764,782979,110610
2020/05/18,Córdoba,Badajoz,145,673559,92769,580790,782979,110610
2020/05/18,Coruña,Pontevedra,5342,942665,172398,770267,1119596,194110
2020/05/18,Coruña,Coruña,148594,1119596,194639,924957,1119596,194110
2020/05/18,Coruña,Lugo,660,329587,48738,280849,1119596,194110
2020/05/18,Cuenca,Guadalajara,70,257762,38496,219266,196329,23241
2020/05/18,Cuenca,Toledo,191,694844,90693,604151,196329,23241
2020/05/18,Cuenca,Cuenca,11832,196329,21686,174643,196329,23241
2020/05/18,Cuenca,Ciudad Real,106,495761,49453,446308,196329,23241
2020/05/18,Cuenca,Albacete,635,388167,38294,349873,196329,23241
2020/05/18,Cuenca,Madrid,88,6663394,984934,5678460,196329,23241
2020/05/18,Cuenca,Valencia,71,2565124,466526,2098598,196329,23241
2020/05/18,Gipuzkoa,Navarra,485,654183,104038,550145,723576,115370
2020/05/18,Gipuzkoa,Gipuzkoa,84199,723576,109206,614370,723576,115370
2020/05/18,Gipuzkoa,Bizkaia,1525,1152934,218469,934465,723576,115370
2020/05/18,Gipuzkoa,Araba,215,331549,59541,272008,723576,115370
2020/05/18,Girona,Girona,65396,771044,99178,671866,771044,103640
2020/05/18,Girona,Barcelona,2654,5664579,910281,4754298,771044,103640
2020/05/18,Girona,Lleida,202,434930,64039,370891,771044,103640
2020/05/18,Granada,Córdoba,239,782979,114866,668113,914678,132907
2020/05/18,Granada,Almería,561,716820,97598,619222,914678,132907
2020/05/18,Granada,Murcia,98,1493898,229243,1264655,914678,132907
2020/05/18,Granada,Málaga,144,1661785,245558,1416227,914678,132907
2020/05/18,Granada,Jaén,312,633564,71800,561764,914678,132907
2020/05/18,Granada,Granada,98589,914678,136652,778026,914678,132907
2020/05/18,Guadalajara,Guadalajara,22823,257762,38496,219266,257762,41242
2020/05/18,Guadalajara,Cuenca,71,196329,21686,174643,257762,41242
2020/05/18,Guadalajara,Madrid,2366,6663394,984934,5678460,257762,41242
2020/05/18,Huelva,Huelva,59150,521870,76020,445850,521870,80471
2020/05/18,Huelva,Sevilla,1670,1942389,313361,1629028,521870,80471
2020/05/18,Huelva,Cádiz,567,1240155,186422,1053733,521870,80471
2020/05/18,Huelva,Badajoz,329,673559,92769,580790,521870,80471
2020/05/18,Huesca,Huesca,19609,220461,28669,191792,220461,32543
2020/05/18,Huesca,Lleida,1003,434930,64039,370891,220461,32543
2020/05/18,Huesca,Zaragoza,271,964724,165899,798825,220461,32543
2020/05/18,Jaén,Albacete,53,388167,38294,349873,633564,68687
2020/05/18,Jaén,Jaén,48568,633564,71800,561764,633564,68687
2020/05/18,Jaén,Córdoba,786,782979,114866,668113,633564,68687
2020/05/18,Jaén,Granada,367,914678,136652,778026,633564,68687
2020/05/18,Las Palmas de Gran Canaria,Las Palmas de Gran Canaria,150641,1120406,163673,956733,1120406,162890
2020/05/18,León,León,47049,460001,63825,396176,460001,63439
2020/05/18,León,Lugo,37,329587,48738,280849,460001,63439
2020/05/18,León,Valladolid,31,519546,77400,442146,460001,63439
2020/05/18,León,Asturias,50,1022800,166084,856716,460001,63439
2020/05/18,León,Zamora,172,172539,20949,151590,460001,63439
2020/05/18,León,Ourense,349,307651,54054,253597,460001,63439
2020/05/18,León,Palencia,90,160866,20974,139892,460001,63439
2020/05/18,Lleida,Barcelona,287,5664579,910281,4754298,434930,62211
2020/05/18,Lleida,Girona,213,771044,99178,671866,434930,62211
2020/05/18,Lleida,Huesca,627,220461,28669,191792,434930,62211
2020/05/18,Lleida,Zaragoza,183,964724,165899,798825,434930,62211
2020/05/18,Lleida,Tarragona,54,804664,112226,692438,434930,62211
2020/05/18,Lleida,Lleida,41318,434930,64039,370891,434930,62211
2020/05/18,Lugo,Coruña,636,1119596,194639,924957,329587,49683
2020/05/18,Lugo,Pontevedra,29,942665,172398,770267,329587,49683
2020/05/18,Lugo,Asturias,813,1022800,166084,856716,329587,49683
2020/05/18,Lugo,Lugo,34791,329587,48738,280849,329587,49683
2020/05/18,Lugo,Ourense,216,307651,54054,253597,329587,49683
2020/05/18,Madrid,Guadalajara,2815,257762,38496,219266,6663394,993039
2020/05/18,Madrid,Madrid,562273,6663394,984934,5678460,6663394,993039
2020/05/18,Madrid,Segovia,16,153129,19166,133963,6663394,993039
2020/05/18,Madrid,Ávila,218,157640,17768,139872,6663394,993039
2020/05/18,Madrid,Toledo,3683,694844,90693,604151,6663394,993039
2020/05/18,Madrid,Cuenca,92,196329,21686,174643,6663394,993039
2020/05/18,Málaga,Sevilla,251,1942389,313361,1629028,1661785,254111
2020/05/18,Málaga,Málaga,203251,1661785,245558,1416227,1661785,254111
2020/05/18,Málaga,Cádiz,1203,1240155,186422,1053733,1661785,254111
2020/05/18,Málaga,Granada,285,914678,136652,778026,1661785,254111
2020/05/18,Málaga,Córdoba,311,782979,114866,668113,1661785,254111
2020/05/18,Melilla,Melilla,13172,86487,13305,73182,86487,13347
2020/05/18,Murcia,Albacete,437,388167,38294,349873,1493898,225288
2020/05/18,Murcia,Almería,1420,716820,97598,619222,1493898,225288
2020/05/18,Murcia,Granada,32,914678,136652,778026,1493898,225288
2020/05/18,Murcia,Alicante,2730,1858683,290651,1568032,1493898,225288
2020/05/18,Murcia,Murcia,177434,1493898,229243,1264655,1493898,225288
2020/05/18,Navarra,Navarra,74426,654183,104038,550145,654183,106183
2020/05/18,Navarra,Araba,69,331549,59541,272008,654183,106183
2020/05/18,Navarra,Rioja,2418,316798,51220,265578,654183,106183
2020/05/18,Navarra,Zaragoza,617,964724,165899,798825,654183,106183
2020/05/18,Navarra,Gipuzkoa,368,723576,109206,614370,654183,106183
2020/05/18,Ourense,Ourense,41634,307651,54054,253597,307651,54380
2020/05/18,Ourense,León,327,460001,63825,396176,307651,54380
2020/05/18,Ourense,Lugo,243,329587,48738,280849,307651,54380
2020/05/18,Ourense,Zamora,47,172539,20949,151590,307651,54380
2020/05/18,Ourense,Pontevedra,215,942665,172398,770267,307651,54380
2020/05/18,Palencia,Valladolid,205,519546,77400,442146,160866,22595
2020/05/18,Palencia,Burgos,204,357072,42828,314244,160866,22595
2020/05/18,Palencia,Palencia,14700,160866,20974,139892,160866,22595
2020/05/18,Palencia,León,24,460001,63825,396176,160866,22595
2020/05/18,Palencia,Cantabria,184,580795,95055,485740,160866,22595
2020/05/18,Pontevedra,Ourense,174,307651,54054,253597,942665,168958
2020/05/18,Pontevedra,Pontevedra,134267,942665,172398,770267,942665,168958
2020/05/18,Pontevedra,Lugo,25,329587,48738,280849,942665,168958
2020/05/18,Pontevedra,Coruña,3982,1119596,194639,924957,942665,168958
2020/05/18,Rioja,Burgos,67,357072,42828,314244,316798,48824
2020/05/18,Rioja,Navarra,1844,654183,104038,550145,316798,48824
2020/05/18,Rioja,Araba,749,331549,59541,272008,316798,48824
2020/05/18,Rioja,Rioja,37450,316798,51220,265578,316798,48824
2020/05/18,Salamanca,Ávila,202,157640,17768,139872,330119,45490
2020/05/18,Salamanca,Zamora,28,172539,20949,151590,330119,45490
2020/05/18,Salamanca,Cáceres,51,394151,47880,346271,330119,45490
2020/05/18,Salamanca,Salamanca,35913,330119,45880,284239,330119,45490
2020/05/18,Santa Cruz de Tenerife,Las Palmas de Gran Canaria,16,1120406,163673,956733,1032983,149378
2020/05/18,Santa Cruz de Tenerife,Santa Cruz de Tenerife,134761,1032983,149941,883042,1032983,149378
2020/05/18,Segovia,Segovia,12482,153129,19166,133963,153129,20761
2020/05/18,Segovia,Madrid,23,6663394,984934,5678460,153129,20761
2020/05/18,Segovia,Burgos,116,357072,42828,314244,153129,20761
2020/05/18,Segovia,Valladolid,274,519546,77400,442146,153129,20761
2020/05/18,Segovia,Ávila,83,157640,17768,139872,153129,20761
2020/05/18,Segovia,Soria,27,88636,7863,80773,153129,20761
2020/05/18,Sevilla,Cádiz,797,1240155,186422,1053733,1942389,305226
2020/05/18,Sevilla,Málaga,149,1661785,245558,1416227,1942389,305226
2020/05/18,Sevilla,Sevilla,220743,1942389,313361,1629028,1942389,305226
2020/05/18,Sevilla,Badajoz,22,673559,92769,580790,1942389,305226
2020/05/18,Sevilla,Córdoba,2002,782979,114866,668113,1942389,305226
2020/05/18,Sevilla,Huelva,599,521870,76020,445850,1942389,305226
2020/05/18,Soria,Guadalajara,18,257762,38496,219266,88636,9619
2020/05/18,Soria,Valladolid,42,519546,77400,442146,88636,9619
2020/05/18,Soria,Segovia,28,153129,19166,133963,88636,9619
2020/05/18,Soria,Zaragoza,137,964724,165899,798825,88636,9619
2020/05/18,Soria,Burgos,60,357072,42828,314244,88636,9619
2020/05/18,Soria,Soria,6028,88636,7863,80773,88636,9619
2020/05/18,Tarragona,Zaragoza,38,964724,165899,798825,804664,110852
2020/05/18,Tarragona,Teruel,96,134137,10871,123266,804664,110852
2020/05/18,Tarragona,Castellón,731,579962,79794,500168,804664,110852
2020/05/18,Tarragona,Tarragona,74442,804664,112226,692438,804664,110852
2020/05/18,Tarragona,Barcelona,1055,5664579,910281,4754298,804664,110852
2020/05/18,Tarragona,Lleida,25,434930,64039,370891,804664,110852
2020/05/18,Teruel,Teruel,6675,134137,10871,123266,134137,13008
2020/05/18,Teruel,Tarragona,73,804664,112226,692438,134137,13008
2020/05/18,Teruel,Zaragoza,138,964724,165899,798825,134137,13008
2020/05/18,Teruel,Castellón,68,579962,79794,500168,134137,13008
2020/05/18,Toledo,Madrid,3589,6663394,984934,5678460,694844,87066
2020/05/18,Toledo,Toledo,43228,694844,90693,604151,694844,87066
2020/05/18,Toledo,Ciudad Real,307,495761,49453,446308,694844,87066
2020/05/18,Toledo,Ávila,218,157640,17768,139872,694844,87066
2020/05/18,Toledo,Cáceres,183,394151,47880,346271,694844,87066
2020/05/18,Toledo,Cuenca,105,196329,21686,174643,694844,87066
2020/05/18,Valencia,Albacete,324,388167,38294,349873,2565124,453794
2020/05/18,Valencia,Castellón,605,579962,79794,500168,2565124,453794
2020/05/18,Valencia,Alicante,1136,1858683,290651,1568032,2565124,453794
2020/05/18,Valencia,Cuenca,72,196329,21686,174643,2565124,453794
2020/05/18,Valencia,Valencia,326107,2565124,466526,2098598,2565124,453794
2020/05/18,Valladolid,Burgos,47,357072,42828,314244,519546,75274
2020/05/18,Valladolid,León,33,460001,63825,396176,519546,75274
2020/05/18,Valladolid,Zamora,189,172539,20949,151590,519546,75274
2020/05/18,Valladolid,Valladolid,54947,519546,77400,442146,519546,75274
2020/05/18,Valladolid,Segovia,211,153129,19166,133963,519546,75274
2020/05/18,Valladolid,Palencia,127,160866,20974,139892,519546,75274
2020/05/18,Valladolid,Ávila,23,157640,17768,139872,519546,75274
2020/05/18,Zamora,Ourense,53,307651,54054,253597,172539,20971
2020/05/18,Zamora,Zamora,13998,172539,20949,151590,172539,20971
2020/05/18,Zamora,Palencia,17,160866,20974,139892,172539,20971
2020/05/18,Zamora,León,88,460001,63825,396176,172539,20971
2020/05/18,Zamora,Valladolid,102,519546,77400,442146,172539,20971
2020/05/18,Zaragoza,Zaragoza,125788,964724,165899,798825,964724,161776
2020/05/18,Zaragoza,Huesca,307,220461,28669,191792,964724,161776
2020/05/18,Zaragoza,Tarragona,35,804664,112226,692438,964724,161776
2020/05/18,Zaragoza,Lleida,103,434930,64039,370891,964724,161776
2020/05/18,Zaragoza,Soria,89,88636,7863,80773,964724,161776
2020/05/18,Zaragoza,Teruel,223,134137,10871,123266,964724,161776
2020/05/18,Zaragoza,Navarra,537,654183,104038,550145,964724,161776
2020/05/19,Albacete,Alicante,269,1858683,314728,1543955,388167,42449
2020/05/19,Albacete,Cuenca,801,196329,22807,173522,388167,42449
2020/05/19,Albacete,Valencia,472,2565124,502015,2063109,388167,42449
2020/05/19,Albacete,Ciudad Real,601,495761,52404,443357,388167,42449
2020/05/19,Albacete,Jaén,38,633564,73963,559601,388167,42449
2020/05/19,Albacete,Albacete,27192,388167,42095,346072,388167,42449
2020/05/19,Albacete,Murcia,665,1493898,244241,1249657,388167,42449
2020/05/19,Alicante,Murcia,3815,1493898,244241,1249657,1858683,319534
2020/05/19,Alicante,Valencia,1501,2565124,502015,2063109,1858683,319534
2020/05/19,Alicante,Alicante,248692,1858683,314728,1543955,1858683,319534
2020/05/19,Alicante,Albacete,415,388167,42095,346072,1858683,319534
2020/05/19,Almería,Almería,84886,716820,102337,614483,716820,104327
2020/05/19,Almería,Murcia,2052,1493898,244241,1249657,716820,104327
2020/05/19,Almería,Granada,571,914678,146553,768125,716820,104327
2020/05/19,Araba,Araba,53195,331549,64340,267209,331549,72741
2020/05/19,Araba,Burgos,1980,357072,46036,311036,331549,72741
2020/05/19,Araba,Rioja,2511,316798,53551,263247,331549,72741
2020/05/19,Araba,Navarra,194,654183,109519,544664,331549,72741
2020/05/19,Araba,Gipuzkoa,345,723576,121420,602156,331549,72741
2020/05/19,Araba,Bizkaia,1769,1152934,238082,914852,331549,72741
2020/05/19,Asturias,Cantabria,253,580795,98961,481834,1022800,172492
2020/05/19,Asturias,Asturias,141466,1022800,172695,850105,1022800,172492
2020/05/19,Asturias,Lugo,1043,329587,49108,280479,1022800,172492
2020/05/19,Asturias,León,28,460001,67329,392672,1022800,172492
2020/05/19,Ávila,Toledo,357,694844,97433,597411,157640,18987
2020/05/19,Ávila,Madrid,106,6663394,1056280,5607114,157640,18987
2020/05/19,Ávila,Cáceres,108,394151,48487,345664,157640,18987
2020/05/19,Ávila,Valladolid,99,519546,82306,437240,157640,18987
2020/05/19,Ávila,Salamanca,302,330119,46119,284000,157640,18987
2020/05/19,Ávila,Segovia,78,153129,20380,132749,157640,18987
2020/05/19,Ávila,Ávila,11958,157640,18074,139566,157640,18987
2020/05/19,Badajoz,Ciudad Real,57,495761,52404,443357,673559,93311
2020/05/19,Badajoz,Sevilla,75,1942389,327585,1614804,673559,93311
2020/05/19,Badajoz,Córdoba,106,782979,121018,661961,673559,93311
2020/05/19,Badajoz,Huelva,240,521870,79280,442590,673559,93311
2020/05/19,Badajoz,Badajoz,69678,673559,93972,579587,673559,93311
2020/05/19,Badajoz,Cáceres,1292,394151,48487,345664,673559,93311
2020/05/19,Balears,Balears,147692,1149460,167451,982009,1149460,168480
2020/05/19,Balears,Valencia,36,2565124,502015,2063109,1149460,168480
2020/05/19,Barcelona,Tarragona,2086,804664,122206,682458,5664579,991422
2020/05/19,Barcelona,Barcelona,635419,5664579,992044,4672535,5664579,991422
2020/05/19,Barcelona,Girona,3100,771044,109227,661817,5664579,991422
2020/05/19,Barcelona,Lleida,352,434930,70303,364627,5664579,991422
2020/05/19,Bizkaia,Gipuzkoa,1315,723576,121420,602156,1152934,233180
2020/05/19,Bizkaia,Bizkaia,184955,1152934,238082,914852,1152934,233180
2020/05/19,Bizkaia,Cantabria,3091,580795,98961,481834,1152934,233180
2020/05/19,Bizkaia,Burgos,58,357072,46036,311036,1152934,233180
2020/05/19,Bizkaia,Araba,995,331549,64340,267209,1152934,233180
2020/05/19,Burgos,Rioja,85,316798,53551,263247,357072,47040
2020/05/19,Burgos,Bizkaia,135,1152934,238082,914852,357072,47040
2020/05/19,Burgos,Segovia,63,153129,20380,132749,357072,47040
2020/05/19,Burgos,Cantabria,26,580795,98961,481834,357072,47040
2020/05/19,Burgos,Burgos,33938,357072,46036,311036,357072,47040
2020/05/19,Burgos,Valladolid,120,519546,82306,437240,357072,47040
2020/05/19,Burgos,Soria,39,88636,8393,80243,357072,47040
2020/05/19,Burgos,Araba,1345,331549,64340,267209,357072,47040
2020/05/19,Burgos,Palencia,240,160866,22455,138411,357072,47040
2020/05/19,Cáceres,Cáceres,33927,394151,48487,345664,394151,48836
2020/05/19,Cáceres,Ávila,134,157640,18074,139566,394151,48836
2020/05/19,Cáceres,Badajoz,1327,673559,93972,579587,394151,48836
2020/05/19,Cáceres,Toledo,176,694844,97433,597411,394151,48836
2020/05/19,Cáceres,Valencia,26,2565124,502015,2063109,394151,48836
2020/05/19,Cádiz,Huelva,891,521870,79280,442590,1240155,198188
2020/05/19,Cádiz,Málaga,1484,1661785,267909,1393876,1240155,198188
2020/05/19,Cádiz,Cádiz,163835,1240155,194695,1045460,1240155,198188
2020/05/19,Cádiz,Sevilla,1105,1942389,327585,1614804,1240155,198188
2020/05/19,Cantabria,Cantabria,72800,580795,98961,481834,580795,94484
2020/05/19,Cantabria,Bizkaia,822,1152934,238082,914852,580795,94484
2020/05/19,Cantabria,Palencia,93,160866,22455,138411,580795,94484
2020/05/19,Cantabria,Burgos,21,357072,46036,311036,580795,94484
2020/05/19,Cantabria,Asturias,331,1022800,172695,850105,580795,94484
2020/05/19,Castellón,Valencia,897,2565124,502015,2063109,579962,93107
2020/05/19,Castellón,Castellón,66840,579962,87136,492826,579962,93107
2020/05/19,Castellón,Teruel,93,134137,11481,122656,579962,93107
2020/05/19,Castellón,Tarragona,978,804664,122206,682458,579962,93107
2020/05/19,Ceuta,Cádiz,26,1240155,194695,1045460,84777,11950
2020/05/19,Ceuta,Ceuta,11409,84777,11919,72858,84777,11950
2020/05/19,Ciudad Real,Córdoba,378,782979,121018,661961,495761,48526
2020/05/19,Ciudad Real,Jaén,17,633564,73963,559601,495761,48526
2020/05/19,Ciudad Real,Badajoz,52,673559,93972,579587,495761,48526
2020/05/19,Ciudad Real,Ciudad Real,32395,495761,52404,443357,495761,48526
2020/05/19,Ciudad Real,Albacete,507,388167,42095,346072,495761,48526
2020/05/19,Ciudad Real,Cuenca,70,196329,22807,173522,495761,48526
2020/05/19,Ciudad Real,Toledo,469,694844,97433,597411,495761,48526
2020/05/19,Córdoba,Málaga,370,1661785,267909,1393876,782979,118202
2020/05/19,Córdoba,Ciudad Real,311,495761,52404,443357,782979,118202
2020/05/19,Córdoba,Jaén,720,633564,73963,559601,782979,118202
2020/05/19,Córdoba,Badajoz,131,673559,93972,579587,782979,118202
2020/05/19,Córdoba,Sevilla,1824,1942389,327585,1614804,782979,118202
2020/05/19,Córdoba,Granada,147,914678,146553,768125,782979,118202
2020/05/19,Córdoba,Córdoba,87563,782979,121018,661961,782979,118202
2020/05/19,Coruña,Coruña,154487,1119596,199229,920367,1119596,200264
2020/05/19,Coruña,Lugo,724,329587,49108,280479,1119596,200264
2020/05/19,Coruña,Pontevedra,5342,942665,175945,766720,1119596,200264
2020/05/19,Cuenca,Ciudad Real,102,495761,52404,443357,196329,23997
2020/05/19,Cuenca,Albacete,823,388167,42095,346072,196329,23997
2020/05/19,Cuenca,Guadalajara,50,257762,41132,216630,196329,23997
2020/05/19,Cuenca,Valencia,85,2565124,502015,2063109,196329,23997
2020/05/19,Cuenca,Toledo,201,694844,97433,597411,196329,23997
2020/05/19,Cuenca,Madrid,77,6663394,1056280,5607114,196329,23997
2020/05/19,Cuenca,Cuenca,12829,196329,22807,173522,196329,23997
2020/05/19,Gipuzkoa,Bizkaia,1914,1152934,238082,914852,723576,126868
2020/05/19,Gipuzkoa,Gipuzkoa,95296,723576,121420,602156,723576,126868
2020/05/19,Gipuzkoa,Navarra,412,654183,109519,544664,723576,126868
2020/05/19,Gipuzkoa,Araba,224,331549,64340,267209,723576,126868
2020/05/19,Girona,Lleida,207,434930,70303,364627,771044,116470
2020/05/19,Girona,Girona,75980,771044,109227,661817,771044,116470
2020/05/19,Girona,Barcelona,3236,5664579,992044,4672535,771044,116470
2020/05/19,Granada,Murcia,71,1493898,244241,1249657,914678,143376
2020/05/19,Granada,Granada,109709,914678,146553,768125,914678,143376
2020/05/19,Granada,Málaga,169,1661785,267909,1393876,914678,143376
2020/05/19,Granada,Jaén,381,633564,73963,559601,914678,143376
2020/05/19,Granada,Almería,527,716820,102337,614483,914678,143376
2020/05/19,Granada,Córdoba,259,782979,121018,661961,914678,143376
2020/05/19,Guadalajara,Madrid,2607,6663394,1056280,5607114,257762,43626
2020/05/19,Guadalajara,Guadalajara,24785,257762,41132,216630,257762,43626
2020/05/19,Guadalajara,Teruel,67,134137,11481,122656,257762,43626
2020/05/19,Guadalajara,Cuenca,59,196329,22807,173522,257762,43626
2020/05/19,Huelva,Huelva,62305,521870,79280,442590,521870,83780
2020/05/19,Huelva,Cádiz,667,1240155,194695,1045460,521870,83780
2020/05/19,Huelva,Badajoz,441,673559,93972,579587,521870,83780
2020/05/19,Huelva,Sevilla,1781,1942389,327585,1614804,521870,83780
2020/05/19,Huesca,Huesca,20972,220461,30164,190297,220461,34037
2020/05/19,Huesca,Zaragoza,353,964724,175759,788965,220461,34037
2020/05/19,Huesca,Lleida,1361,434930,70303,364627,220461,34037
2020/05/19,Jaén,Córdoba,824,782979,121018,661961,633564,72651
2020/05/19,Jaén,Jaén,51758,633564,73963,559601,633564,72651
2020/05/19,Jaén,Albacete,16,388167,42095,346072,633564,72651
2020/05/19,Jaén,Granada,343,914678,146553,768125,633564,72651
2020/05/19,Las Palmas de Gran Canaria,Santa Cruz de Tenerife,17,1032983,156718,876265,1120406,166437
2020/05/19,Las Palmas de Gran Canaria,Las Palmas de Gran Canaria,153701,1120406,167195,953211,1120406,166437
2020/05/19,León,León,50572,460001,67329,392672,460001,66874
2020/05/19,León,Zamora,189,172539,22591,149948,460001,66874
2020/05/19,León,Palencia,72,160866,22455,138411,460001,66874
2020/05/19,León,Asturias,62,1022800,172695,850105,460001,66874
2020/05/19,León,Ourense,373,307651,54749,252902,460001,66874
2020/05/19,León,Valladolid,29,519546,82306,437240,460001,66874
2020/05/19,Lleida,Barcelona,322,5664579,992044,4672535,434930,67801
2020/05/19,Lleida,Tarragona,28,804664,122206,682458,434930,67801
2020/05/19,Lleida,Zaragoza,176,964724,175759,788965,434930,67801
2020/05/19,Lleida,Lleida,46693,434930,70303,364627,434930,67801
2020/05/19,Lleida,Huesca,746,220461,30164,190297,434930,67801
2020/05/19,Lleida,Girona,210,771044,109227,661817,434930,67801
2020/05/19,Lugo,Asturias,837,1022800,172695,850105,329587,50791
2020/05/19,Lugo,Coruña,701,1119596,199229,920367,329587,50791
2020/05/19,Lugo,Ourense,196,307651,54749,252902,329587,50791
2020/05/19,Lugo,Lugo,35492,329587,49108,280479,329587,50791
2020/05/19,Madrid,Madrid,617542,6663394,1056280,5607114,6663394,1055611
2020/05/19,Madrid,Guadalajara,3196,257762,41132,216630,6663394,1055611
2020/05/19,Madrid,Toledo,4141,694844,97433,597411,6663394,1055611
2020/05/19,Madrid,Ciudad Real,16,495761,52404,443357,6663394,1055611
2020/05/19,Madrid,Cuenca,70,196329,22807,173522,6663394,1055611
2020/05/19,Madrid,Ávila,227,157640,18074,139566,6663394,1055611
2020/05/19,Málaga,Málaga,225968,1661785,267909,1393876,1661785,272726
2020/05/19,Málaga,Sevilla,305,1942389,327585,1614804,1661785,272726
2020/05/19,Málaga,Córdoba,499,782979,121018,661961,1661785,272726
2020/05/19,Málaga,Cádiz,1394,1240155,194695,1045460,1661785,272726
2020/05/19,Málaga,Granada,330,914678,146553,768125,1661785,272726
2020/05/19,Melilla,Melilla,13966,86487,14126,72361,86487,14150
2020/05/19,Murcia,Albacete,525,388167,42095,346072,1493898,239480
2020/05/19,Murcia,Alicante,2948,1858683,314728,1543955,1493898,239480
2020/05/19,Murcia,Almería,1340,716820,102337,614483,1493898,239480
2020/05/19,Murcia,Murcia,191474,1493898,244241,1249657,1493898,239480
2020/05/19,Navarra,Gipuzkoa,362,723576,121420,602156,654183,112230
2020/05/19,Navarra,Alicante,17,1858683,314728,1543955,654183,112230
2020/05/19,Navarra,Navarra,80318,654183,109519,544664,654183,112230
2020/05/19,Navarra,Zaragoza,688,964724,175759,788965,654183,112230
2020/05/19,Navarra,Rioja,2792,316798,53551,263247,654183,112230
2020/05/19,Navarra,Araba,92,331549,64340,267209,654183,112230
2020/05/19,Ourense,Lugo,245,329587,49108,280479,307651,55054
2020/05/19,Ourense,Pontevedra,248,942665,175945,766720,307651,55054
2020/05/19,Ourense,León,387,460001,67329,392672,307651,55054
2020/05/19,Ourense,Zamora,76,172539,22591,149948,307651,55054
2020/05/19,Ourense,Ourense,42790,307651,54749,252902,307651,55054
2020/05/19,Palencia,León,31,460001,67329,392672,160866,24037
2020/05/19,Palencia,Palencia,16177,160866,22455,138411,160866,24037
2020/05/19,Palencia,Burgos,205,357072,46036,311036,160866,24037
2020/05/19,Palencia,Valladolid,220,519546,82306,437240,160866,24037
2020/05/19,Palencia,Cantabria,173,580795,98961,481834,160866,24037
2020/05/19,Pontevedra,Coruña,4335,1119596,199229,920367,942665,174500
2020/05/19,Pontevedra,Ourense,201,307651,54749,252902,942665,174500
2020/05/19,Pontevedra,Pontevedra,139053,942665,175945,766720,942665,174500
2020/05/19,Pontevedra,Lugo,22,329587,49108,280479,942665,174500
2020/05/19,Rioja,Rioja,39417,316798,53551,263247,316798,50604
2020/05/19,Rioja,Burgos,78,357072,46036,311036,316798,50604
2020/05/19,Rioja,Navarra,1989,654183,109519,544664,316798,50604
2020/05/19,Rioja,Araba,870,331549,64340,267209,316798,50604
2020/05/19,Salamanca,Salamanca,36480,330119,46119,284000,330119,45852
2020/05/19,Salamanca,Zamora,57,172539,22591,149948,330119,45852
2020/05/19,Salamanca,Ávila,248,157640,18074,139566,330119,45852
2020/05/19,Santa Cruz de Tenerife,Santa Cruz de Tenerife,141577,1032983,156718,876265,1032983,156595
2020/05/19,Santa Cruz de Tenerife,Las Palmas de Gran Canaria,34,1120406,167195,953211,1032983,156595
2020/05/19,Segovia,Ávila,128,157640,18074,139566,153129,22171
2020/05/19,Segovia,Segovia,13484,153129,20380,132749,153129,22171
2020/05/19,Segovia,Valladolid,313,519546,82306,437240,153129,22171
2020/05/19,Segovia,Soria,24,88636,8393,80243,153129,22171
2020/05/19,Segovia,Burgos,128,357072,46036,311036,153129,22171
2020/05/19,Sevilla,Cádiz,1036,1240155,194695,1045460,1942389,319500
2020/05/19,Sevilla,Sevilla,235841,1942389,327585,1614804,1942389,319500
2020/05/19,Sevilla,Córdoba,2258,782979,121018,661961,1942389,319500
2020/05/19,Sevilla,Málaga,159,1661785,267909,1393876,1942389,319500
2020/05/19,Sevilla,Huelva,633,521870,79280,442590,1942389,319500
2020/05/19,Sevilla,Badajoz,24,673559,93972,579587,1942389,319500
2020/05/19,Soria,Segovia,28,153129,20380,132749,88636,9496
2020/05/19,Soria,Soria,6271,88636,8393,80243,88636,9496
2020/05/19,Soria,Zaragoza,170,964724,175759,788965,88636,9496
2020/05/19,Soria,Navarra,25,654183,109519,544664,88636,9496
2020/05/19,Soria,Valladolid,32,519546,82306,437240,88636,9496
2020/05/19,Soria,Burgos,81,357072,46036,311036,88636,9496
2020/05/19,Tarragona,Tarragona,84241,804664,122206,682458,804664,122291
2020/05/19,Tarragona,Castellón,780,579962,87136,492826,804664,122291
2020/05/19,Tarragona,Teruel,66,134137,11481,122656,804664,122291
2020/05/19,Tarragona,Lleida,32,434930,70303,364627,804664,122291
2020/05/19,Tarragona,Barcelona,1322,5664579,992044,4672535,804664,122291
2020/05/19,Teruel,Zaragoza,239,964724,175759,788965,134137,13377
2020/05/19,Teruel,Teruel,6874,134137,11481,122656,134137,13377
2020/05/19,Teruel,Castellón,119,579962,87136,492826,134137,13377
2020/05/19,Teruel,Guadalajara,47,257762,41132,216630,134137,13377
2020/05/19,Teruel,Tarragona,89,804664,122206,682458,134137,13377
2020/05/19,Toledo,Cuenca,94,196329,22807,173522,694844,94786
2020/05/19,Toledo,Cáceres,168,394151,48487,345664,694844,94786
2020/05/19,Toledo,Toledo,49036,694844,97433,597411,694844,94786
2020/05/19,Toledo,Ciudad Real,432,495761,52404,443357,694844,94786
2020/05/19,Toledo,Ávila,218,157640,18074,139566,694844,94786
2020/05/19,Toledo,Madrid,3967,6663394,1056280,5607114,694844,94786
2020/05/19,Valencia,Albacete,433,388167,42095,346072,2565124,488637
2020/05/19,Valencia,Valencia,359794,2565124,502015,2063109,2565124,488637
2020/05/19,Valencia,Castellón,603,579962,87136,492826,2565124,488637
2020/05/19,Valencia,Teruel,17,134137,11481,122656,2565124,488637
2020/05/19,Valencia,Cuenca,96,196329,22807,173522,2565124,488637
2020/05/19,Valencia,Alicante,1357,1858683,314728,1543955,2565124,488637
2020/05/19,Valladolid,Burgos,83,357072,46036,311036,519546,79242
2020/05/19,Valladolid,Zamora,203,172539,22591,149948,519546,79242
2020/05/19,Valladolid,Segovia,350,153129,20380,132749,519546,79242
2020/05/19,Valladolid,León,58,460001,67329,392672,519546,79242
2020/05/19,Valladolid,Palencia,100,160866,22455,138411,519546,79242
2020/05/19,Valladolid,Valladolid,59502,519546,82306,437240,519546,79242
2020/05/19,Valladolid,Soria,45,88636,8393,80243,519546,79242
2020/05/19,Valladolid,Ávila,27,157640,18074,139566,519546,79242
2020/05/19,Zamora,León,27,460001,67329,392672,172539,22351
2020/05/19,Zamora,Zamora,15392,172539,22591,149948,172539,22351
2020/05/19,Zamora,Ourense,81,307651,54749,252902,172539,22351
2020/05/19,Zamora,Salamanca,37,330119,46119,284000,172539,22351
2020/05/19,Zamora,Valladolid,103,519546,82306,437240,172539,22351
2020/05/19,Zaragoza,Soria,76,88636,8393,80243,964724,169055
2020/05/19,Zaragoza,Teruel,306,134137,11481,122656,964724,169055
2020/05/19,Zaragoza,Navarra,530,654183,109519,544664,964724,169055
2020/05/19,Zaragoza,Huesca,326,220461,30164,190297,964724,169055
2020/05/19,Zaragoza,Zaragoza,135840,964724,175759,788965,964724,169055
2020/05/19,Zaragoza,Lleida,159,434930,70303,364627,964724,169055
2020/05/20,Albacete,Ciudad Real,652,495761,51493,444268,388167,42174
2020/05/20,Albacete,Valencia,513,2565124,500692,2064432,388167,42174
2020/05/20,Albacete,Murcia,701,1493898,246775,1247123,388167,42174
2020/05/20,Albacete,Cuenca,668,196329,22901,173428,388167,42174
2020/05/20,Albacete,Alicante,249,1858683,314347,1544336,388167,42174
2020/05/20,Albacete,Albacete,26682,388167,41460,346707,388167,42174
2020/05/20,Albacete,Jaén,62,633564,74649,558915,388167,42174
2020/05/20,Alicante,Valencia,1538,2565124,500692,2064432,1858683,319847
2020/05/20,Alicante,Albacete,432,388167,41460,346707,1858683,319847
2020/05/20,Alicante,Murcia,3899,1493898,246775,1247123,1858683,319847
2020/05/20,Alicante,Alicante,248840,1858683,314347,1544336,1858683,319847
2020/05/20,Almería,Granada,675,914678,146699,767979,716820,106806
2020/05/20,Almería,Almería,86863,716820,104827,611993,716820,106806
2020/05/20,Almería,Murcia,2069,1493898,246775,1247123,716820,106806
2020/05/20,Almería,Córdoba,17,782979,119975,663004,716820,106806
2020/05/20,Araba,Navarra,181,654183,111824,542359,331549,72847
2020/05/20,Araba,Araba,53247,331549,64421,267128,331549,72847
2020/05/20,Araba,Burgos,2046,357072,46342,310730,331549,72847
2020/05/20,Araba,Bizkaia,1747,1152934,238586,914348,331549,72847
2020/05/20,Araba,Rioja,2608,316798,53757,263041,331549,72847
2020/05/20,Araba,Gipuzkoa,305,723576,120587,602989,331549,72847
2020/05/20,Asturias,Asturias,143438,1022800,175088,847712,1022800,175168
2020/05/20,Asturias,León,40,460001,66960,393041,1022800,175168
2020/05/20,Asturias,Lugo,1090,329587,49813,279774,1022800,175168
2020/05/20,Asturias,Cantabria,286,580795,100980,479815,1022800,175168
2020/05/20,Ávila,Toledo,248,694844,96518,598326,157640,19089
2020/05/20,Ávila,Madrid,386,6663394,1062774,5600620,157640,19089
2020/05/20,Ávila,Salamanca,417,330119,46169,283950,157640,19089
2020/05/20,Ávila,Cáceres,125,394151,48476,345675,157640,19089
2020/05/20,Ávila,Valladolid,68,519546,83112,436434,157640,19089
2020/05/20,Ávila,Ávila,11619,157640,17824,139816,157640,19089
2020/05/20,Ávila,Segovia,115,153129,20476,132653,157640,19089
2020/05/20,Badajoz,Badajoz,70751,673559,94511,579048,673559,93680
2020/05/20,Badajoz,Cáceres,1169,394151,48476,345675,673559,93680
2020/05/20,Badajoz,Córdoba,111,782979,119975,663004,673559,93680
2020/05/20,Badajoz,Huelva,236,521870,80141,441729,673559,93680
2020/05/20,Badajoz,Sevilla,89,1942389,334382,1608007,673559,93680
2020/05/20,Badajoz,Ciudad Real,36,495761,51493,444268,673559,93680
2020/05/20,Balears,Balears,151717,1149460,171435,978025,1149460,172345
2020/05/20,Balears,Barcelona,16,5664579,989850,4674729,1149460,172345
2020/05/20,Balears,Valencia,33,2565124,500692,2064432,1149460,172345
2020/05/20,Barcelona,Tarragona,2049,804664,122205,682459,5664579,989234
2020/05/20,Barcelona,Barcelona,629917,5664579,989850,4674729,5664579,989234
2020/05/20,Barcelona,Girona,3114,771044,108839,662205,5664579,989234
2020/05/20,Barcelona,Lleida,327,434930,70439,364491,5664579,989234
2020/05/20,Bizkaia,Burgos,82,357072,46342,310730,1152934,233805
2020/05/20,Bizkaia,Gipuzkoa,1212,723576,120587,602989,1152934,233805
2020/05/20,Bizkaia,Araba,989,331549,64421,267128,1152934,233805
2020/05/20,Bizkaia,Cantabria,3135,580795,100980,479815,1152934,233805
2020/05/20,Bizkaia,Bizkaia,185385,1152934,238586,914348,1152934,233805
2020/05/20,Burgos,Burgos,33935,357072,46342,310730,357072,47260
2020/05/20,Burgos,Soria,26,88636,8347,80289,357072,47260
2020/05/20,Burgos,Bizkaia,176,1152934,238586,914348,357072,47260
2020/05/20,Burgos,Palencia,257,160866,22442,138424,357072,47260
2020/05/20,Burgos,Segovia,54,153129,20476,132653,357072,47260
2020/05/20,Burgos,Araba,1250,331549,64421,267128,357072,47260
2020/05/20,Burgos,Rioja,81,316798,53757,263041,357072,47260
2020/05/20,Burgos,Valladolid,138,519546,83112,436434,357072,47260
2020/05/20,Cáceres,Ávila,123,157640,17824,139816,394151,48601
2020/05/20,Cáceres,Cáceres,33710,394151,48476,345675,394151,48601
2020/05/20,Cáceres,Toledo,170,694844,96518,598326,394151,48601
2020/05/20,Cáceres,Badajoz,1300,673559,94511,579048,394151,48601
2020/05/20,Cádiz,Córdoba,51,782979,119975,663004,1240155,200480
2020/05/20,Cádiz,Cádiz,165279,1240155,197911,1042244,1240155,200480
2020/05/20,Cádiz,Ceuta,32,84777,11807,72970,1240155,200480
2020/05/20,Cádiz,Málaga,1532,1661785,266570,1395215,1240155,200480
2020/05/20,Cádiz,Huelva,912,521870,80141,441729,1240155,200480
2020/05/20,Cádiz,Sevilla,1163,1942389,334382,1608007,1240155,200480
2020/05/20,Cantabria,Asturias,314,1022800,175088,847712,580795,96254
2020/05/20,Cantabria,Bizkaia,860,1152934,238586,914348,580795,96254
2020/05/20,Cantabria,Cantabria,74559,580795,100980,479815,580795,96254
2020/05/20,Cantabria,Palencia,58,160866,22442,138424,580795,96254
2020/05/20,Castellón,Castellón,66357,579962,87006,492956,579962,92211
2020/05/20,Castellón,Tarragona,887,804664,122205,682459,579962,92211
2020/05/20,Castellón,Valencia,836,2565124,500692,2064432,579962,92211
2020/05/20,Castellón,Teruel,65,134137,11754,122383,579962,92211
2020/05/20,Ceuta,Cádiz,51,1240155,197911,1042244,84777,11939
2020/05/20,Ceuta,Ceuta,11319,84777,11807,72970,84777,11939
2020/05/20,Ciudad Real,Córdoba,403,782979,119975,663004,495761,48042
2020/05/20,Ciudad Real,Badajoz,63,673559,94511,579048,495761,48042
2020/05/20,Ciudad Real,Ciudad Real,31946,495761,51493,444268,495761,48042
2020/05/20,Ciudad Real,Toledo,344,694844,96518,598326,495761,48042
2020/05/20,Ciudad Real,Jaén,17,633564,74649,558915,495761,48042
2020/05/20,Ciudad Real,Albacete,494,388167,41460,346707,495761,48042
2020/05/20,Ciudad Real,Cuenca,64,196329,22901,173428,495761,48042
2020/05/20,Córdoba,Ciudad Real,343,495761,51493,444268,782979,116899
2020/05/20,Córdoba,Jaén,744,633564,74649,558915,782979,116899
2020/05/20,Córdoba,Málaga,233,1661785,266570,1395215,782979,116899
2020/05/20,Córdoba,Badajoz,119,673559,94511,579048,782979,116899
2020/05/20,Córdoba,Granada,177,914678,146699,767979,782979,116899
2020/05/20,Córdoba,Sevilla,1992,1942389,334382,1608007,782979,116899
2020/05/20,Córdoba,Córdoba,86431,782979,119975,663004,782979,116899
2020/05/20,Coruña,Lugo,742,329587,49813,279774,1119596,201085
2020/05/20,Coruña,Coruña,154788,1119596,199691,919905,1119596,201085
2020/05/20,Coruña,Pontevedra,5623,942665,178251,764414,1119596,201085
2020/05/20,Cuenca,Cuenca,12986,196329,22901,173428,196329,24211
2020/05/20,Cuenca,Guadalajara,78,257762,41544,216218,196329,24211
2020/05/20,Cuenca,Ciudad Real,92,495761,51493,444268,196329,24211
2020/05/20,Cuenca,Madrid,69,6663394,1062774,5600620,196329,24211
2020/05/20,Cuenca,Toledo,200,694844,96518,598326,196329,24211
2020/05/20,Cuenca,Albacete,867,388167,41460,346707,196329,24211
2020/05/20,Cuenca,Valencia,125,2565124,500692,2064432,196329,24211
2020/05/20,Gipuzkoa,Navarra,432,654183,111824,542359,723576,125198
2020/05/20,Gipuzkoa,Araba,286,331549,64421,267128,723576,125198
2020/05/20,Gipuzkoa,Gipuzkoa,93773,723576,120587,602989,723576,125198
2020/05/20,Gipuzkoa,Bizkaia,1801,1152934,238586,914348,723576,125198
2020/05/20,Girona,Almería,19,716820,104827,611993,771044,115367
2020/05/20,Girona,Murcia,28,1493898,246775,1247123,771044,115367
2020/05/20,Girona,Girona,74992,771044,108839,662205,771044,115367
2020/05/20,Girona,Lleida,205,434930,70439,364491,771044,115367
2020/05/20,Girona,Barcelona,2990,5664579,989850,4674729,771044,115367
2020/05/20,Granada,Almería,696,716820,104827,611993,914678,144082
2020/05/20,Granada,Murcia,68,1493898,246775,1247123,914678,144082
2020/05/20,Granada,Córdoba,255,782979,119975,663004,914678,144082
2020/05/20,Granada,Jaén,371,633564,74649,558915,914678,144082
2020/05/20,Granada,Málaga,204,1661785,266570,1395215,914678,144082
2020/05/20,Granada,Granada,110023,914678,146699,767979,914678,144082
2020/05/20,Guadalajara,Madrid,2575,6663394,1062774,5600620,257762,44235
2020/05/20,Guadalajara,Cuenca,69,196329,22901,173428,257762,44235
2020/05/20,Guadalajara,Teruel,53,134137,11754,122383,257762,44235
2020/05/20,Guadalajara,Guadalajara,24929,257762,41544,216218,257762,44235
2020/05/20,Huelva,Sevilla,1664,1942389,334382,1608007,521870,84346
2020/05/20,Huelva,Cádiz,768,1240155,197911,1042244,521870,84346
2020/05/20,Huelva,Huelva,62950,521870,80141,441729,521870,84346
2020/05/20,Huelva,Badajoz,418,673559,94511,579048,521870,84346
2020/05/20,Huesca,Lleida,1268,434930,70439,364491,220461,34356
2020/05/20,Huesca,Huesca,21280,220461,30382,190079,220461,34356
2020/05/20,Huesca,Zaragoza,379,964724,178204,786520,220461,34356
2020/05/20,Jaén,Granada,396,914678,146699,767979,633564,73838
2020/05/20,Jaén,Jaén,52437,633564,74649,558915,633564,73838
2020/05/20,Jaén,Córdoba,888,782979,119975,663004,633564,73838
2020/05/20,Las Palmas de Gran Canaria,Las Palmas de Gran Canaria,162201,1120406,174655,945751,1120406,174049
2020/05/20,León,Zamora,107,172539,22453,150086,460001,66948
2020/05/20,León,Valladolid,27,519546,83112,436434,460001,66948
2020/05/20,León,Ourense,385,307651,55178,252473,460001,66948
2020/05/20,León,Asturias,46,1022800,175088,847712,460001,66948
2020/05/20,León,Lugo,28,329587,49813,279774,460001,66948
2020/05/20,León,León,50757,460001,66960,393041,460001,66948
2020/05/20,León,Palencia,32,160866,22442,138424,460001,66948
2020/05/20,Lleida,Lleida,46524,434930,70439,364491,434930,67449
2020/05/20,Lleida,Barcelona,216,5664579,989850,4674729,434930,67449
2020/05/20,Lleida,Tarragona,28,804664,122205,682459,434930,67449
2020/05/20,Lleida,Zaragoza,217,964724,178204,786520,434930,67449
2020/05/20,Lleida,Huesca,788,220461,30382,190079,434930,67449
2020/05/20,Lleida,Girona,215,771044,108839,662205,434930,67449
2020/05/20,Lugo,Pontevedra,21,942665,178251,764414,329587,51163
2020/05/20,Lugo,Asturias,837,1022800,175088,847712,329587,51163
2020/05/20,Lugo,Coruña,917,1119596,199691,919905,329587,51163
2020/05/20,Lugo,Lugo,35851,329587,49813,279774,329587,51163
2020/05/20,Lugo,Ourense,144,307651,55178,252473,329587,51163
2020/05/20,Madrid,Ciudad Real,32,495761,51493,444268,6663394,1062334
2020/05/20,Madrid,Segovia,48,153129,20476,132653,6663394,1062334
2020/05/20,Madrid,Ávila,194,157640,17824,139816,6663394,1062334
2020/05/20,Madrid,Cuenca,79,196329,22901,173428,6663394,1062334
2020/05/20,Madrid,Guadalajara,3183,257762,41544,216218,6663394,1062334
2020/05/20,Madrid,Madrid,624993,6663394,1062774,5600620,6663394,1062334
2020/05/20,Madrid,Toledo,4078,694844,96518,598326,6663394,1062334
2020/05/20,Málaga,Córdoba,445,782979,119975,663004,1661785,271421
2020/05/20,Málaga,Cádiz,1314,1240155,197911,1042244,1661785,271421
2020/05/20,Málaga,Granada,359,914678,146699,767979,1661785,271421
2020/05/20,Málaga,Sevilla,321,1942389,334382,1608007,1661785,271421
2020/05/20,Málaga,Málaga,224718,1661785,266570,1395215,1661785,271421
2020/05/20,Melilla,Melilla,13569,86487,13711,72776,86487,13755
2020/05/20,Murcia,Albacete,555,388167,41460,346707,1493898,241388
2020/05/20,Murcia,Murcia,193537,1493898,246775,1247123,1493898,241388
2020/05/20,Murcia,Almería,1386,716820,104827,611993,1493898,241388
2020/05/20,Murcia,Alicante,3055,1858683,314347,1544336,1493898,241388
2020/05/20,Navarra,Rioja,2664,316798,53757,263041,654183,114210
2020/05/20,Navarra,Navarra,82409,654183,111824,542359,654183,114210
2020/05/20,Navarra,Gipuzkoa,421,723576,120587,602989,654183,114210
2020/05/20,Navarra,Zaragoza,688,964724,178204,786520,654183,114210
2020/05/20,Navarra,Araba,119,331549,64421,267128,654183,114210
2020/05/20,Ourense,Lugo,238,329587,49813,279774,307651,55613
2020/05/20,Ourense,León,294,460001,66960,393041,307651,55613
2020/05/20,Ourense,Ourense,43446,307651,55178,252473,307651,55613
2020/05/20,Ourense,Zamora,89,172539,22453,150086,307651,55613
2020/05/20,Ourense,Pontevedra,162,942665,178251,764414,307651,55613
2020/05/20,Palencia,Cantabria,155,580795,100980,479815,160866,23876
2020/05/20,Palencia,Valladolid,229,519546,83112,436434,160866,23876
2020/05/20,Palencia,Palencia,16040,160866,22442,138424,160866,23876
2020/05/20,Palencia,Burgos,272,357072,46342,310730,160866,23876
2020/05/20,Palencia,León,51,460001,66960,393041,160866,23876
2020/05/20,Pontevedra,Pontevedra,141434,942665,178251,764414,942665,176924
2020/05/20,Pontevedra,Ourense,246,307651,55178,252473,942665,176924
2020/05/20,Pontevedra,Coruña,4435,1119596,199691,919905,942665,176924
2020/05/20,Pontevedra,Lugo,25,329587,49813,279774,942665,176924
2020/05/20,Rioja,Burgos,50,357072,46342,310730,316798,50921
2020/05/20,Rioja,Araba,822,331549,64421,267128,316798,50921
2020/05/20,Rioja,Rioja,39524,316798,53757,263041,316798,50921
2020/05/20,Rioja,Navarra,1933,654183,111824,542359,316798,50921
2020/05/20,Salamanca,Zamora,112,172539,22453,150086,330119,45771
2020/05/20,Salamanca,Cáceres,58,394151,48476,345675,330119,45771
2020/05/20,Salamanca,Ávila,236,157640,17824,139816,330119,45771
2020/05/20,Salamanca,Salamanca,36120,330119,46169,283950,330119,45771
2020/05/20,Santa Cruz de Tenerife,Las Palmas de Gran Canaria,17,1120406,174655,945751,1032983,160526
2020/05/20,Santa Cruz de Tenerife,Santa Cruz de Tenerife,145754,1032983,161111,871872,1032983,160526
2020/05/20,Segovia,Valladolid,321,519546,83112,436434,153129,21992
2020/05/20,Segovia,Ávila,110,157640,17824,139816,153129,21992
2020/05/20,Segovia,Soria,31,88636,8347,80289,153129,21992
2020/05/20,Segovia,Burgos,145,357072,46342,310730,153129,21992
2020/05/20,Segovia,Segovia,13518,153129,20476,132653,153129,21992
2020/05/20,Sevilla,Badajoz,83,673559,94511,579048,1942389,327843
2020/05/20,Sevilla,Huelva,643,521870,80141,441729,1942389,327843
2020/05/20,Sevilla,Cádiz,1166,1240155,197911,1042244,1942389,327843
2020/05/20,Sevilla,Córdoba,2365,782979,119975,663004,1942389,327843
2020/05/20,Sevilla,Málaga,161,1661785,266570,1395215,1942389,327843
2020/05/20,Sevilla,Sevilla,242359,1942389,334382,1608007,1942389,327843
2020/05/20,Soria,Soria,6176,88636,8347,80289,88636,9284
2020/05/20,Soria,Segovia,20,153129,20476,132653,88636,9284
2020/05/20,Soria,Burgos,88,357072,46342,310730,88636,9284
2020/05/20,Soria,Zaragoza,108,964724,178204,786520,88636,9284
2020/05/20,Soria,Navarra,17,654183,111824,542359,88636,9284
2020/05/20,Soria,Valladolid,31,519546,83112,436434,88636,9284
2020/05/20,Tarragona,Tarragona,84519,804664,122205,682459,804664,122894
2020/05/20,Tarragona,Zaragoza,38,964724,178204,786520,804664,122894
2020/05/20,Tarragona,Teruel,57,134137,11754,122383,804664,122894
2020/05/20,Tarragona,Lleida,19,434930,70439,364491,804664,122894
2020/05/20,Tarragona,Barcelona,1337,5664579,989850,4674729,804664,122894
2020/05/20,Tarragona,Castellón,958,579962,87006,492956,804664,122894
2020/05/20,Teruel,Tarragona,89,804664,122205,682459,134137,13722
2020/05/20,Teruel,Zaragoza,224,964724,178204,786520,134137,13722
2020/05/20,Teruel,Valencia,20,2565124,500692,2064432,134137,13722
2020/05/20,Teruel,Castellón,98,579962,87006,492956,134137,13722
2020/05/20,Teruel,Teruel,7327,134137,11754,122383,134137,13722
2020/05/20,Toledo,Toledo,47661,694844,96518,598326,694844,93129
2020/05/20,Toledo,Ávila,254,157640,17824,139816,694844,93129
2020/05/20,Toledo,Cáceres,111,394151,48476,345675,694844,93129
2020/05/20,Toledo,Ciudad Real,417,495761,51493,444268,694844,93129
2020/05/20,Toledo,Cuenca,152,196329,22901,173428,694844,93129
2020/05/20,Toledo,Madrid,3892,6663394,1062774,5600620,694844,93129
2020/05/20,Valencia,Valencia,360610,2565124,500692,2064432,2565124,488223
2020/05/20,Valencia,Cuenca,142,196329,22901,173428,2565124,488223
2020/05/20,Valencia,Castellón,767,579962,87006,492956,2565124,488223
2020/05/20,Valencia,Cáceres,20,394151,48476,345675,2565124,488223
2020/05/20,Valencia,Murcia,17,1493898,246775,1247123,2565124,488223
2020/05/20,Valencia,Albacete,408,388167,41460,346707,2565124,488223
2020/05/20,Valencia,Alicante,1337,1858683,314347,1544336,2565124,488223
2020/05/20,Valladolid,Segovia,342,153129,20476,132653,519546,79959
2020/05/20,Valladolid,Soria,29,88636,8347,80289,519546,79959
2020/05/20,Valladolid,Palencia,32,160866,22442,138424,519546,79959
2020/05/20,Valladolid,Valladolid,60422,519546,83112,436434,519546,79959
2020/05/20,Valladolid,Ávila,60,157640,17824,139816,519546,79959
2020/05/20,Valladolid,León,39,460001,66960,393041,519546,79959
2020/05/20,Valladolid,Burgos,96,357072,46342,310730,519546,79959
2020/05/20,Valladolid,Zamora,129,172539,22453,150086,519546,79959
2020/05/20,Zamora,Zamora,15241,172539,22453,150086,172539,22187
2020/05/20,Zamora,Ourense,118,307651,55178,252473,172539,22187
2020/05/20,Zamora,Valladolid,83,519546,83112,436434,172539,22187
2020/05/20,Zamora,Salamanca,36,330119,46169,283950,172539,22187
2020/05/20,Zamora,León,55,460001,66960,393041,172539,22187
2020/05/20,Zaragoza,Navarra,598,654183,111824,542359,964724,171327
2020/05/20,Zaragoza,Huesca,350,220461,30382,190079,964724,171327
2020/05/20,Zaragoza,Teruel,355,134137,11754,122383,964724,171327
2020/05/20,Zaragoza,Lleida,152,434930,70439,364491,964724,171327
2020/05/20,Zaragoza,Zaragoza,138494,964724,178204,786520,964724,171327
2020/05/20,Zaragoza,Soria,91,88636,8347,80289,964724,171327
2020/05/21,Albacete,Cuenca,815,196329,23060,173269,388167,41916
2020/05/21,Albacete,Murcia,670,1493898,249304,1244594,388167,41916
2020/05/21,Albacete,Granada,22,914678,145508,769170,388167,41916
2020/05/21,Albacete,Valencia,509,2565124,498583,2066541,388167,41916
2020/05/21,Albacete,Jaén,65,633564,75223,558341,388167,41916
2020/05/21,Albacete,Alicante,281,1858683,315163,1543520,388167,41916
2020/05/21,Albacete,Ciudad Real,678,495761,51430,444331,388167,41916
2020/05/21,Albacete,Albacete,26239,388167,40988,347179,388167,41916
2020/05/21,Alicante,Albacete,391,388167,40988,347179,1858683,320919
2020/05/21,Alicante,Valencia,1548,2565124,498583,2066541,1858683,320919
2020/05/21,Alicante,Murcia,3828,1493898,249304,1244594,1858683,320919
2020/05/21,Alicante,Alicante,248752,1858683,315163,1543520,1858683,320919
2020/05/21,Almería,Granada,521,914678,145508,769170,716820,105940
2020/05/21,Almería,Almería,86526,716820,103802,613018,716820,105940
2020/05/21,Almería,Murcia,1835,1493898,249304,1244594,716820,105940
2020/05/21,Araba,Araba,52980,331549,64536,267013,331549,72543
2020/05/21,Araba,Burgos,2021,357072,46529,310543,331549,72543
2020/05/21,Araba,Rioja,2625,316798,54108,262690,331549,72543
2020/05/21,Araba,Bizkaia,1730,1152934,241533,911401,331549,72543
2020/05/21,Araba,Gipuzkoa,276,723576,123069,600507,331549,72543
2020/05/21,Araba,Navarra,189,654183,114262,539921,331549,72543
2020/05/21,Asturias,León,35,460001,67077,392924,1022800,174108
2020/05/21,Asturias,Cantabria,455,580795,101067,479728,1022800,174108
2020/05/21,Asturias,Asturias,142448,1022800,174279,848521,1022800,174108
2020/05/21,Asturias,Lugo,1020,329587,49273,280314,1022800,174108
2020/05/21,Ávila,Toledo,238,694844,96618,598226,157640,18617
2020/05/21,Ávila,Ávila,11428,157640,17698,139942,157640,18617
2020/05/21,Ávila,Cáceres,125,394151,48563,345588,157640,18617
2020/05/21,Ávila,Salamanca,330,330119,46105,284014,157640,18617
2020/05/21,Ávila,Segovia,93,153129,20295,132834,157640,18617
2020/05/21,Ávila,Valladolid,55,519546,85618,433928,157640,18617
2020/05/21,Ávila,Madrid,121,6663394,1061131,5602263,157640,18617
2020/05/21,Badajoz,Huelva,215,521870,80181,441689,673559,92927
2020/05/21,Badajoz,Ciudad Real,40,495761,51430,444331,673559,92927
2020/05/21,Badajoz,Badajoz,69752,673559,93545,580014,673559,92927
2020/05/21,Badajoz,Cáceres,1269,394151,48563,345588,673559,92927
2020/05/21,Badajoz,Sevilla,99,1942389,337178,1605211,673559,92927
2020/05/21,Badajoz,Córdoba,94,782979,121147,661832,673559,92927
2020/05/21,Balears,Valencia,26,2565124,498583,2066541,1149460,174296
2020/05/21,Balears,Balears,153761,1149460,173403,976057,1149460,174296
2020/05/21,Balears,Barcelona,18,5664579,1003296,4661283,1149460,174296
2020/05/21,Barcelona,Barcelona,642472,5664579,1003296,4661283,5664579,1000458
2020/05/21,Barcelona,Tarragona,2047,804664,122992,681672,5664579,1000458
2020/05/21,Barcelona,Girona,3457,771044,110421,660623,5664579,1000458
2020/05/21,Barcelona,Lleida,183,434930,71578,363352,5664579,1000458
2020/05/21,Bizkaia,Cantabria,3042,580795,101067,479728,1152934,235934
2020/05/21,Bizkaia,Gipuzkoa,1315,723576,123069,600507,1152934,235934
2020/05/21,Bizkaia,Bizkaia,186731,1152934,241533,911401,1152934,235934
2020/05/21,Bizkaia,Araba,915,331549,64536,267013,1152934,235934
2020/05/21,Bizkaia,Burgos,60,357072,46529,310543,1152934,235934
2020/05/21,Burgos,Soria,52,88636,8538,80098,357072,47716
2020/05/21,Burgos,Segovia,55,153129,20295,132834,357072,47716
2020/05/21,Burgos,Rioja,72,316798,54108,262690,357072,47716
2020/05/21,Burgos,Palencia,243,160866,22438,138428,357072,47716
2020/05/21,Burgos,Valladolid,114,519546,85618,433928,357072,47716
2020/05/21,Burgos,Araba,1407,331549,64536,267013,357072,47716
2020/05/21,Burgos,Bizkaia,206,1152934,241533,911401,357072,47716
2020/05/21,Burgos,Cantabria,34,580795,101067,479728,357072,47716
2020/05/21,Burgos,Burgos,34278,357072,46529,310543,357072,47716
2020/05/21,Cáceres,Toledo,167,694844,96618,598226,394151,48799
2020/05/21,Cáceres,Cáceres,33720,394151,48563,345588,394151,48799
2020/05/21,Cáceres,Ávila,140,157640,17698,139942,394151,48799
2020/05/21,Cáceres,Badajoz,1348,673559,93545,580014,394151,48799
2020/05/21,Cádiz,Ceuta,75,84777,13020,71757,1240155,201812
2020/05/21,Cádiz,Málaga,1370,1661785,266361,1395424,1240155,201812
2020/05/21,Cádiz,Sevilla,1094,1942389,337178,1605211,1240155,201812
2020/05/21,Cádiz,Huelva,894,521870,80181,441689,1240155,201812
2020/05/21,Cádiz,Cádiz,166862,1240155,198609,1041546,1240155,201812
2020/05/21,Cantabria,Bizkaia,890,1152934,241533,911401,580795,95598
2020/05/21,Cantabria,Palencia,90,160866,22438,138428,580795,95598
2020/05/21,Cantabria,Asturias,314,1022800,174279,848521,580795,95598
2020/05/21,Cantabria,Cantabria,74096,580795,101067,479728,580795,95598
2020/05/21,Castellón,Teruel,73,134137,11973,122164,579962,93592
2020/05/21,Castellón,Valencia,896,2565124,498583,2066541,579962,93592
2020/05/21,Castellón,Tarragona,965,804664,122992,681672,579962,93592
2020/05/21,Castellón,Castellón,67413,579962,87687,492275,579962,93592
2020/05/21,Ceuta,Cádiz,27,1240155,198609,1041546,84777,12834
2020/05/21,Ceuta,Ceuta,12326,84777,13020,71757,84777,12834
2020/05/21,Ciudad Real,Albacete,505,388167,40988,347179,495761,47802
2020/05/21,Ciudad Real,Ciudad Real,31652,495761,51430,444331,495761,47802
2020/05/21,Ciudad Real,Badajoz,57,673559,93545,580014,495761,47802
2020/05/21,Ciudad Real,Córdoba,356,782979,121147,661832,495761,47802
2020/05/21,Ciudad Real,Toledo,371,694844,96618,598226,495761,47802
2020/05/21,Ciudad Real,Cuenca,61,196329,23060,173269,495761,47802
2020/05/21,Córdoba,Badajoz,135,673559,93545,580014,782979,118686
2020/05/21,Córdoba,Jaén,781,633564,75223,558341,782979,118686
2020/05/21,Córdoba,Málaga,296,1661785,266361,1395424,782979,118686
2020/05/21,Córdoba,Córdoba,87562,782979,121147,661832,782979,118686
2020/05/21,Córdoba,Granada,161,914678,145508,769170,782979,118686
2020/05/21,Córdoba,Ciudad Real,344,495761,51430,444331,782979,118686
2020/05/21,Córdoba,Sevilla,1994,1942389,337178,1605211,782979,118686
2020/05/21,Coruña,Coruña,146439,1119596,191107,928489,1119596,191662
2020/05/21,Coruña,Pontevedra,4881,942665,176273,766392,1119596,191662
2020/05/21,Coruña,Lugo,854,329587,49273,280314,1119596,191662
2020/05/21,Cuenca,Madrid,65,6663394,1061131,5602263,196329,24444
2020/05/21,Cuenca,Albacete,878,388167,40988,347179,196329,24444
2020/05/21,Cuenca,Valencia,75,2565124,498583,2066541,196329,24444
2020/05/21,Cuenca,Cuenca,13057,196329,23060,173269,196329,24444
2020/05/21,Cuenca,Toledo,221,694844,96618,598226,196329,24444
2020/05/21,Cuenca,Ciudad Real,105,495761,51430,444331,196329,24444
2020/05/21,Cuenca,Guadalajara,72,257762,41590,216172,196329,24444
2020/05/21,Gipuzkoa,Navarra,467,654183,114262,539921,723576,127831
2020/05/21,Gipuzkoa,Barcelona,17,5664579,1003296,4661283,723576,127831
2020/05/21,Gipuzkoa,Gipuzkoa,96158,723576,123069,600507,723576,127831
2020/05/21,Gipuzkoa,Araba,274,331549,64536,267013,723576,127831
2020/05/21,Gipuzkoa,Bizkaia,1891,1152934,241533,911401,723576,127831
2020/05/21,Girona,Barcelona,3028,5664579,1003296,4661283,771044,115076
2020/05/21,Girona,Lleida,224,434930,71578,363352,771044,115076
2020/05/21,Girona,Girona,75924,771044,110421,660623,771044,115076
2020/05/21,Granada,Granada,108366,914678,145508,769170,914678,143071
2020/05/21,Granada,Jaén,394,633564,75223,558341,914678,143071
2020/05/21,Granada,Córdoba,249,782979,121147,661832,914678,143071
2020/05/21,Granada,Murcia,49,1493898,249304,1244594,914678,143071
2020/05/21,Granada,Almería,594,716820,103802,613018,914678,143071
2020/05/21,Granada,Málaga,189,1661785,266361,1395424,914678,143071
2020/05/21,Guadalajara,Madrid,2556,6663394,1061131,5602263,257762,43956
2020/05/21,Guadalajara,Cuenca,81,196329,23060,173269,257762,43956
2020/05/21,Guadalajara,Guadalajara,24901,257762,41590,216172,257762,43956
2020/05/21,Guadalajara,Teruel,44,134137,11973,122164,257762,43956
2020/05/21,Huelva,Badajoz,386,673559,93545,580014,521870,84501
2020/05/21,Huelva,Sevilla,1670,1942389,337178,1605211,521870,84501
2020/05/21,Huelva,Huelva,63558,521870,80181,441689,521870,84501
2020/05/21,Huelva,Cádiz,695,1240155,198609,1041546,521870,84501
2020/05/21,Huesca,Zaragoza,308,964724,176315,788409,220461,34744
2020/05/21,Huesca,Lleida,1367,434930,71578,363352,220461,34744
2020/05/21,Huesca,Huesca,21631,220461,31134,189327,220461,34744
2020/05/21,Jaén,Jaén,52846,633564,75223,558341,633564,74304
2020/05/21,Jaén,Granada,279,914678,145508,769170,633564,74304
2020/05/21,Jaén,Albacete,30,388167,40988,347179,633564,74304
2020/05/21,Jaén,Córdoba,865,782979,121147,661832,633564,74304
2020/05/21,Las Palmas de Gran Canaria,Las Palmas de Gran Canaria,163269,1120406,176062,944344,1120406,175229
2020/05/21,Las Palmas de Gran Canaria,Santa Cruz de Tenerife,20,1032983,162150,870833,1120406,175229
2020/05/21,León,León,50823,460001,67077,392924,460001,67348
2020/05/21,León,Palencia,87,160866,22438,138428,460001,67348
2020/05/21,León,Ourense,350,307651,55219,252432,460001,67348
2020/05/21,León,Asturias,53,1022800,174279,848521,460001,67348
2020/05/21,León,Valladolid,28,519546,85618,433928,460001,67348
2020/05/21,León,Zamora,168,172539,22425,150114,460001,67348
2020/05/21,León,Lugo,25,329587,49273,280314,460001,67348
2020/05/21,Lleida,Lleida,47617,434930,71578,363352,434930,69301
2020/05/21,Lleida,Tarragona,30,804664,122992,681672,434930,69301
2020/05/21,Lleida,Zaragoza,177,964724,176315,788409,434930,69301
2020/05/21,Lleida,Huesca,908,220461,31134,189327,434930,69301
2020/05/21,Lleida,Barcelona,354,5664579,1003296,4661283,434930,69301
2020/05/21,Lleida,Girona,186,771044,110421,660623,434930,69301
2020/05/21,Lugo,Asturias,777,1022800,174279,848521,329587,50521
2020/05/21,Lugo,Ourense,188,307651,55219,252432,329587,50521
2020/05/21,Lugo,Lugo,35524,329587,49273,280314,329587,50521
2020/05/21,Lugo,Coruña,718,1119596,191107,928489,329587,50521
2020/05/21,Madrid,Madrid,622590,6663394,1061131,5602263,6663394,1061395
2020/05/21,Madrid,Segovia,20,153129,20295,132834,6663394,1061395
2020/05/21,Madrid,Ávila,250,157640,17698,139942,6663394,1061395
2020/05/21,Madrid,Ciudad Real,16,495761,51430,444331,6663394,1061395
2020/05/21,Madrid,Toledo,4068,694844,96618,598226,6663394,1061395
2020/05/21,Madrid,Cuenca,104,196329,23060,173269,6663394,1061395
2020/05/21,Madrid,Guadalajara,3135,257762,41590,216172,6663394,1061395
2020/05/21,Málaga,Sevilla,370,1942389,337178,1605211,1661785,271684
2020/05/21,Málaga,Cádiz,1311,1240155,198609,1041546,1661785,271684
2020/05/21,Málaga,Málaga,224534,1661785,266361,1395424,1661785,271684
2020/05/21,Málaga,Granada,347,914678,145508,769170,1661785,271684
2020/05/21,Málaga,Córdoba,475,782979,121147,661832,1661785,271684
2020/05/21,Melilla,Melilla,13666,86487,13896,72591,86487,13770
2020/05/21,Murcia,Murcia,196563,1493898,249304,1244594,1493898,245673
2020/05/21,Murcia,Albacete,549,388167,40988,347179,1493898,245673
2020/05/21,Murcia,Almería,1543,716820,103802,613018,1493898,245673
2020/05/21,Murcia,Alicante,3047,1858683,315163,1543520,1493898,245673
2020/05/21,Navarra,Rioja,2633,316798,54108,262690,654183,115394
2020/05/21,Navarra,Navarra,83866,654183,114262,539921,654183,115394
2020/05/21,Navarra,Gipuzkoa,382,723576,123069,600507,654183,115394
2020/05/21,Navarra,Zaragoza,626,964724,176315,788409,654183,115394
2020/05/21,Navarra,Araba,84,331549,64536,267013,654183,115394
2020/05/21,Ourense,Ourense,43368,307651,55219,252432,307651,55819
2020/05/21,Ourense,León,332,460001,67077,392924,307651,55819
2020/05/21,Ourense,Zamora,78,172539,22425,150114,307651,55819
2020/05/21,Ourense,Pontevedra,222,942665,176273,766392,307651,55819
2020/05/21,Ourense,Lugo,218,329587,49273,280314,307651,55819
2020/05/21,Palencia,Palencia,16165,160866,22438,138428,160866,24215
2020/05/21,Palencia,León,22,460001,67077,392924,160866,24215
2020/05/21,Palencia,Cantabria,216,580795,101067,479728,160866,24215
2020/05/21,Palencia,Burgos,244,357072,46529,310543,160866,24215
2020/05/21,Palencia,Valladolid,361,519546,85618,433928,160866,24215
2020/05/21,Pontevedra,Ourense,216,307651,55219,252432,942665,176294
2020/05/21,Pontevedra,Coruña,4491,1119596,191107,928489,942665,176294
2020/05/21,Pontevedra,Lugo,26,329587,49273,280314,942665,176294
2020/05/21,Pontevedra,Pontevedra,140009,942665,176273,766392,942665,176294
2020/05/21,Rioja,Araba,812,331549,64536,267013,316798,51699
2020/05/21,Rioja,Rioja,39959,316798,54108,262690,316798,51699
2020/05/21,Rioja,Navarra,2023,654183,114262,539921,316798,51699
2020/05/21,Rioja,Burgos,59,357072,46529,310543,316798,51699
2020/05/21,Salamanca,Salamanca,36017,330119,46105,284014,330119,45571
2020/05/21,Salamanca,Zamora,84,172539,22425,150114,330119,45571
2020/05/21,Salamanca,Ávila,210,157640,17698,139942,330119,45571
2020/05/21,Santa Cruz de Tenerife,Las Palmas de Gran Canaria,36,1120406,176062,944344,1032983,161854
2020/05/21,Santa Cruz de Tenerife,Santa Cruz de Tenerife,147963,1032983,162150,870833,1032983,161854
2020/05/21,Segovia,Segovia,13396,153129,20295,132834,153129,22161
2020/05/21,Segovia,Valladolid,291,519546,85618,433928,153129,22161
2020/05/21,Segovia,Madrid,22,6663394,1061131,5602263,153129,22161
2020/05/21,Segovia,Ávila,108,157640,17698,139942,153129,22161
2020/05/21,Segovia,Burgos,138,357072,46529,310543,153129,22161
2020/05/21,Sevilla,Córdoba,2248,782979,121147,661832,1942389,329650
2020/05/21,Sevilla,Huelva,632,521870,80181,441689,1942389,329650
2020/05/21,Sevilla,Málaga,68,1661785,266361,1395424,1942389,329650
2020/05/21,Sevilla,Badajoz,73,673559,93545,580014,1942389,329650
2020/05/21,Sevilla,Sevilla,244847,1942389,337178,1605211,1942389,329650
2020/05/21,Sevilla,Cádiz,1069,1240155,198609,1041546,1942389,329650
2020/05/21,Soria,Segovia,28,153129,20295,132834,88636,9780
2020/05/21,Soria,Burgos,108,357072,46529,310543,88636,9780
2020/05/21,Soria,Guadalajara,20,257762,41590,216172,88636,9780
2020/05/21,Soria,Zaragoza,137,964724,176315,788409,88636,9780
2020/05/21,Soria,Navarra,30,654183,114262,539921,88636,9780
2020/05/21,Soria,Soria,6366,88636,8538,80098,88636,9780
2020/05/21,Soria,Valladolid,28,519546,85618,433928,88636,9780
2020/05/21,Tarragona,Tarragona,85479,804664,122992,681672,804664,124370
2020/05/21,Tarragona,Castellón,879,579962,87687,492275,804664,124370
2020/05/21,Tarragona,Zaragoza,49,964724,176315,788409,804664,124370
2020/05/21,Tarragona,Barcelona,1379,5664579,1003296,4661283,804664,124370
2020/05/21,Tarragona,Teruel,78,134137,11973,122164,804664,124370
2020/05/21,Teruel,Guadalajara,22,257762,41590,216172,134137,13966
2020/05/21,Teruel,Castellón,137,579962,87687,492275,134137,13966
2020/05/21,Teruel,Teruel,7264,134137,11973,122164,134137,13966
2020/05/21,Teruel,Zaragoza,293,964724,176315,788409,134137,13966
2020/05/21,Teruel,Tarragona,99,804664,122992,681672,134137,13966
2020/05/21,Toledo,Madrid,3793,6663394,1061131,5602263,694844,93175
2020/05/21,Toledo,Cuenca,190,196329,23060,173269,694844,93175
2020/05/21,Toledo,Ciudad Real,429,495761,51430,444331,694844,93175
2020/05/21,Toledo,Ávila,207,157640,17698,139942,694844,93175
2020/05/21,Toledo,Toledo,47599,694844,96618,598226,694844,93175
2020/05/21,Toledo,Cáceres,150,394151,48563,345588,694844,93175
2020/05/21,Valencia,Cáceres,18,394151,48563,345588,2565124,485390
2020/05/21,Valencia,Castellón,690,579962,87687,492275,2565124,485390
2020/05/21,Valencia,Valencia,357881,2565124,498583,2066541,2565124,485390
2020/05/21,Valencia,Albacete,378,388167,40988,347179,2565124,485390
2020/05/21,Valencia,Cuenca,134,196329,23060,173269,2565124,485390
2020/05/21,Valencia,Alicante,1234,1858683,315163,1543520,2565124,485390
2020/05/21,Valencia,Murcia,28,1493898,249304,1244594,2565124,485390
2020/05/21,Valladolid,Valladolid,63061,519546,85618,433928,519546,82632
2020/05/21,Valladolid,Segovia,316,153129,20295,132834,519546,82632
2020/05/21,Valladolid,Zamora,139,172539,22425,150114,519546,82632
2020/05/21,Valladolid,Salamanca,29,330119,46105,284014,519546,82632
2020/05/21,Valladolid,Palencia,40,160866,22438,138428,519546,82632
2020/05/21,Valladolid,Burgos,93,357072,46529,310543,519546,82632
2020/05/21,Valladolid,Soria,31,88636,8538,80098,519546,82632
2020/05/21,Valladolid,León,50,460001,67077,392924,519546,82632
2020/05/21,Valladolid,Ávila,44,157640,17698,139942,519546,82632
2020/05/21,Zamora,León,104,460001,67077,392924,172539,22073
2020/05/21,Zamora,Ourense,116,307651,55219,252432,172539,22073
2020/05/21,Zamora,Valladolid,81,519546,85618,433928,172539,22073
2020/05/21,Zamora,Zamora,15154,172539,22425,150114,172539,22073
2020/05/21,Zaragoza,Zaragoza,136095,964724,176315,788409,964724,170341
2020/05/21,Zaragoza,Guadalajara,28,257762,41590,216172,964724,170341
2020/05/21,Zaragoza,Lleida,178,434930,71578,363352,964724,170341
2020/05/21,Zaragoza,Teruel,537,134137,11973,122164,964724,170341
2020/05/21,Zaragoza,Huesca,358,220461,31134,189327,964724,170341
2020/05/21,Zaragoza,Navarra,548,654183,114262,539921,964724,170341
2020/05/21,Zaragoza,Soria,86,88636,8538,80098,964724,170341
2020/05/22,Albacete,Murcia,850,1493898,248789,1245109,388167,42049
2020/05/22,Albacete,Cuenca,761,196329,22868,173461,388167,42049
2020/05/22,Albacete,Granada,22,914678,145690,768988,388167,42049
2020/05/22,Albacete,Jaén,47,633564,74146,559418,388167,42049
2020/05/22,Albacete,Albacete,26726,388167,41085,347082,388167,42049
2020/05/22,Albacete,Ciudad Real,692,495761,50880,444881,388167,42049
2020/05/22,Albacete,Alicante,276,1858683,316205,1542478,388167,42049
2020/05/22,Albacete,Valencia,378,2565124,496355,2068769,388167,42049
2020/05/22,Alicante,Albacete,401,388167,41085,347082,1858683,320724
2020/05/22,Alicante,Valencia,1599,2565124,496355,2068769,1858683,320724
2020/05/22,Alicante,Alicante,251248,1858683,316205,1542478,1858683,320724
2020/05/22,Alicante,Murcia,3400,1493898,248789,1245109,1858683,320724
2020/05/22,Almería,Granada,617,914678,145690,768988,716820,107091
2020/05/22,Almería,Málaga,16,1661785,265131,1396654,716820,107091
2020/05/22,Almería,Murcia,1873,1493898,248789,1245109,716820,107091
2020/05/22,Almería,Almería,88215,716820,105797,611023,716820,107091
2020/05/22,Araba,Rioja,2458,316798,54375,262423,331549,72871
2020/05/22,Araba,Araba,54106,331549,64893,266656,331549,72871
2020/05/22,Araba,Burgos,1948,357072,45936,311136,331549,72871
2020/05/22,Araba,Bizkaia,1836,1152934,239814,913120,331549,72871
2020/05/22,Araba,Navarra,246,654183,114637,539546,331549,72871
2020/05/22,Araba,Gipuzkoa,327,723576,123122,600454,331549,72871
2020/05/22,Asturias,Asturias,144572,1022800,175920,846880,1022800,175796
2020/05/22,Asturias,León,41,460001,66778,393223,1022800,175796
2020/05/22,Asturias,Cantabria,252,580795,100673,480122,1022800,175796
2020/05/22,Asturias,Lugo,1033,329587,49790,279797,1022800,175796
2020/05/22,Ávila,Segovia,87,153129,20086,133043,157640,18373
2020/05/22,Ávila,Cáceres,123,394151,48644,345507,157640,18373
2020/05/22,Ávila,Madrid,179,6663394,1056388,5607006,157640,18373
2020/05/22,Ávila,Salamanca,324,330119,46367,283752,157640,18373
2020/05/22,Ávila,Ávila,11362,157640,17331,140309,157640,18373
2020/05/22,Ávila,Valladolid,57,519546,83711,435835,157640,18373
2020/05/22,Ávila,Toledo,290,694844,94097,600747,157640,18373
2020/05/22,Badajoz,Badajoz,71043,673559,94551,579008,673559,93288
2020/05/22,Badajoz,Huelva,240,521870,80227,441643,673559,93288
2020/05/22,Badajoz,Sevilla,91,1942389,335578,1606811,673559,93288
2020/05/22,Badajoz,Cáceres,1070,394151,48644,345507,673559,93288
2020/05/22,Badajoz,Córdoba,96,782979,120679,662300,673559,93288
2020/05/22,Badajoz,Ciudad Real,55,495761,50880,444881,673559,93288
2020/05/22,Balears,Balears,154426,1149460,175080,974380,1149460,175813
2020/05/22,Balears,Barcelona,16,5664579,994006,4670573,1149460,175813
2020/05/22,Balears,Valencia,51,2565124,496355,2068769,1149460,175813
2020/05/22,Barcelona,Girona,4080,771044,110477,660567,5664579,993949
2020/05/22,Barcelona,Lleida,230,434930,71883,363047,5664579,993949
2020/05/22,Barcelona,Barcelona,639100,5664579,994006,4670573,5664579,993949
2020/05/22,Barcelona,Tarragona,2327,804664,122912,681752,5664579,993949
2020/05/22,Bizkaia,Burgos,68,357072,45936,311136,1152934,235149
2020/05/22,Bizkaia,Araba,949,331549,64893,266656,1152934,235149
2020/05/22,Bizkaia,Cantabria,2956,580795,100673,480122,1152934,235149
2020/05/22,Bizkaia,Bizkaia,188382,1152934,239814,913120,1152934,235149
2020/05/22,Bizkaia,Gipuzkoa,1177,723576,123122,600454,1152934,235149
2020/05/22,Burgos,Araba,1293,331549,64893,266656,357072,46870
2020/05/22,Burgos,Valladolid,101,519546,83711,435835,357072,46870
2020/05/22,Burgos,Burgos,34234,357072,45936,311136,357072,46870
2020/05/22,Burgos,Rioja,99,316798,54375,262423,357072,46870
2020/05/22,Burgos,Bizkaia,150,1152934,239814,913120,357072,46870
2020/05/22,Burgos,Palencia,248,160866,22601,138265,357072,46870
2020/05/22,Burgos,Segovia,42,153129,20086,133043,357072,46870
2020/05/22,Cáceres,Cáceres,34316,394151,48644,345507,394151,48853
2020/05/22,Cáceres,Salamanca,23,330119,46367,283752,394151,48853
2020/05/22,Cáceres,Badajoz,1353,673559,94551,579008,394151,48853
2020/05/22,Cáceres,Ávila,147,157640,17331,140309,394151,48853
2020/05/22,Cáceres,Toledo,222,694844,94097,600747,394151,48853
2020/05/22,Cáceres,Valencia,22,2565124,496355,2068769,394151,48853
2020/05/22,Cádiz,Cádiz,171051,1240155,201608,1038547,1240155,204030
2020/05/22,Cádiz,Ceuta,18,84777,11996,72781,1240155,204030
2020/05/22,Cádiz,Málaga,1416,1661785,265131,1396654,1240155,204030
2020/05/22,Cádiz,Sevilla,1059,1942389,335578,1606811,1240155,204030
2020/05/22,Cádiz,Huelva,865,521870,80227,441643,1240155,204030
2020/05/22,Cantabria,Asturias,396,1022800,175920,846880,580795,96304
2020/05/22,Cantabria,Bizkaia,877,1152934,239814,913120,580795,96304
2020/05/22,Cantabria,Palencia,58,160866,22601,138265,580795,96304
2020/05/22,Cantabria,Cantabria,74222,580795,100673,480122,580795,96304
2020/05/22,Castellón,Tarragona,1046,804664,122912,681752,579962,91331
2020/05/22,Castellón,Valencia,808,2565124,496355,2068769,579962,91331
2020/05/22,Castellón,Teruel,67,134137,12014,122123,579962,91331
2020/05/22,Castellón,Castellón,66198,579962,86257,493705,579962,91331
2020/05/22,Ceuta,Ceuta,11522,84777,11996,72781,84777,11997
2020/05/22,Ciudad Real,Albacete,454,388167,41085,347082,495761,48394
2020/05/22,Ciudad Real,Badajoz,65,673559,94551,579008,495761,48394
2020/05/22,Ciudad Real,Toledo,547,694844,94097,600747,495761,48394
2020/05/22,Ciudad Real,Ciudad Real,32220,495761,50880,444881,495761,48394
2020/05/22,Ciudad Real,Córdoba,380,782979,120679,662300,495761,48394
2020/05/22,Ciudad Real,Granada,110,914678,145690,768988,495761,48394
2020/05/22,Ciudad Real,Cuenca,100,196329,22868,173461,495761,48394
2020/05/22,Córdoba,Córdoba,88468,782979,120679,662300,782979,118906
2020/05/22,Córdoba,Granada,144,914678,145690,768988,782979,118906
2020/05/22,Córdoba,Sevilla,1850,1942389,335578,1606811,782979,118906
2020/05/22,Córdoba,Ciudad Real,256,495761,50880,444881,782979,118906
2020/05/22,Córdoba,Málaga,257,1661785,265131,1396654,782979,118906
2020/05/22,Córdoba,Badajoz,121,673559,94551,579008,782979,118906
2020/05/22,Córdoba,Jaén,736,633564,74146,559418,782979,118906
2020/05/22,Coruña,Pontevedra,5399,942665,176796,765869,1119596,199761
2020/05/22,Coruña,Coruña,153984,1119596,197163,922433,1119596,199761
2020/05/22,Coruña,Lugo,733,329587,49790,279797,1119596,199761
2020/05/22,Cuenca,Toledo,189,694844,94097,600747,196329,23586
2020/05/22,Cuenca,Valencia,84,2565124,496355,2068769,196329,23586
2020/05/22,Cuenca,Guadalajara,96,257762,40724,217038,196329,23586
2020/05/22,Cuenca,Albacete,921,388167,41085,347082,196329,23586
2020/05/22,Cuenca,Madrid,61,6663394,1056388,5607006,196329,23586
2020/05/22,Cuenca,Cuenca,13045,196329,22868,173461,196329,23586
2020/05/22,Cuenca,Ciudad Real,68,495761,50880,444881,196329,23586
2020/05/22,Gipuzkoa,Araba,284,331549,64893,266656,723576,127323
2020/05/22,Gipuzkoa,Bizkaia,1777,1152934,239814,913120,723576,127323
2020/05/22,Gipuzkoa,Navarra,535,654183,114637,539546,723576,127323
2020/05/22,Gipuzkoa,Gipuzkoa,97415,723576,123122,600454,723576,127323
2020/05/22,Girona,Girona,77136,771044,110477,660567,771044,115572
2020/05/22,Girona,Tarragona,25,804664,122912,681752,771044,115572
2020/05/22,Girona,Barcelona,2818,5664579,994006,4670573,771044,115572
2020/05/22,Girona,Lleida,213,434930,71883,363047,771044,115572
2020/05/22,Granada,Jaén,397,633564,74146,559418,914678,143293
2020/05/22,Granada,Granada,109144,914678,145690,768988,914678,143293
2020/05/22,Granada,Almería,487,716820,105797,611023,914678,143293
2020/05/22,Granada,Murcia,38,1493898,248789,1245109,914678,143293
2020/05/22,Granada,Málaga,230,1661785,265131,1396654,914678,143293
2020/05/22,Granada,Córdoba,207,782979,120679,662300,914678,143293
2020/05/22,Guadalajara,Cuenca,101,196329,22868,173461,257762,42751
2020/05/22,Guadalajara,Guadalajara,24760,257762,40724,217038,257762,42751
2020/05/22,Guadalajara,Madrid,2531,6663394,1056388,5607006,257762,42751
2020/05/22,Guadalajara,Teruel,29,134137,12014,122123,257762,42751
2020/05/22,Huelva,Sevilla,1612,1942389,335578,1606811,521870,83900
2020/05/22,Huelva,Badajoz,348,673559,94551,579008,521870,83900
2020/05/22,Huelva,Huelva,63495,521870,80227,441643,521870,83900
2020/05/22,Huelva,Cádiz,686,1240155,201608,1038547,521870,83900
2020/05/22,Huesca,Lleida,1312,434930,71883,363047,220461,34348
2020/05/22,Huesca,Huesca,21817,220461,30989,189472,220461,34348
2020/05/22,Huesca,Zaragoza,312,964724,176642,788082,220461,34348
2020/05/22,Jaén,Granada,395,914678,145690,768988,633564,73198
2020/05/22,Jaén,Albacete,48,388167,41085,347082,633564,73198
2020/05/22,Jaén,Córdoba,808,782979,120679,662300,633564,73198
2020/05/22,Jaén,Jaén,51909,633564,74146,559418,633564,73198
2020/05/22,Las Palmas de Gran Canaria,Las Palmas de Gran Canaria,164257,1120406,176633,943773,1120406,175789
2020/05/22,León,Palencia,38,160866,22601,138265,460001,66763
2020/05/22,León,Ourense,311,307651,55046,252605,460001,66763
2020/05/22,León,León,51002,460001,66778,393223,460001,66763
2020/05/22,León,Valladolid,27,519546,83711,435835,460001,66763
2020/05/22,León,Zamora,149,172539,22097,150442,460001,66763
2020/05/22,León,Asturias,77,1022800,175920,846880,460001,66763
2020/05/22,Lleida,Tarragona,98,804664,122912,681752,434930,69699
2020/05/22,Lleida,Huesca,1067,220461,30989,189472,434930,69699
2020/05/22,Lleida,Zaragoza,187,964724,176642,788082,434930,69699
2020/05/22,Lleida,Lleida,48806,434930,71883,363047,434930,69699
2020/05/22,Lleida,Barcelona,313,5664579,994006,4670573,434930,69699
2020/05/22,Lleida,Girona,196,771044,110477,660567,434930,69699
2020/05/22,Lugo,Asturias,814,1022800,175920,846880,329587,50747
2020/05/22,Lugo,Pontevedra,29,942665,176796,765869,329587,50747
2020/05/22,Lugo,Coruña,684,1119596,197163,922433,329587,50747
2020/05/22,Lugo,Lugo,36093,329587,49790,279797,329587,50747
2020/05/22,Lugo,Ourense,210,307651,55046,252605,329587,50747
2020/05/22,Madrid,Guadalajara,3165,257762,40724,217038,6663394,1056779
2020/05/22,Madrid,Ciudad Real,17,495761,50880,444881,6663394,1056779
2020/05/22,Madrid,Zaragoza,17,964724,176642,788082,6663394,1056779
2020/05/22,Madrid,Segovia,29,153129,20086,133043,6663394,1056779
2020/05/22,Madrid,Cuenca,87,196329,22868,173461,6663394,1056779
2020/05/22,Madrid,Ávila,210,157640,17331,140309,6663394,1056779
2020/05/22,Madrid,Madrid,627540,6663394,1056388,5607006,6663394,1056779
2020/05/22,Madrid,Toledo,4358,694844,94097,600747,6663394,1056779
2020/05/22,Málaga,Sevilla,264,1942389,335578,1606811,1661785,268414
2020/05/22,Málaga,Córdoba,390,782979,120679,662300,1661785,268414
2020/05/22,Málaga,Málaga,224068,1661785,265131,1396654,1661785,268414
2020/05/22,Málaga,Cádiz,1336,1240155,201608,1038547,1661785,268414
2020/05/22,Málaga,Granada,318,914678,145690,768988,1661785,268414
2020/05/22,Melilla,Melilla,13738,86487,13954,72533,86487,13951
2020/05/22,Murcia,Alicante,3385,1858683,316205,1542478,1493898,245816
2020/05/22,Murcia,Albacete,608,388167,41085,347082,1493898,245816
2020/05/22,Murcia,Granada,35,914678,145690,768988,1493898,245816
2020/05/22,Murcia,Murcia,197147,1493898,248789,1245109,1493898,245816
2020/05/22,Murcia,Almería,1387,716820,105797,611023,1493898,245816
2020/05/22,Navarra,Rioja,2603,316798,54375,262423,654183,114967
2020/05/22,Navarra,Navarra,84942,654183,114637,539546,654183,114967
2020/05/22,Navarra,Gipuzkoa,385,723576,123122,600454,654183,114967
2020/05/22,Navarra,Zaragoza,590,964724,176642,788082,654183,114967
2020/05/22,Navarra,Araba,94,331549,64893,266656,654183,114967
2020/05/22,Ourense,Lugo,264,329587,49790,279797,307651,55573
2020/05/22,Ourense,Pontevedra,195,942665,176796,765869,307651,55573
2020/05/22,Ourense,León,371,460001,66778,393223,307651,55573
2020/05/22,Ourense,Zamora,64,172539,22097,150442,307651,55573
2020/05/22,Ourense,Ourense,43396,307651,55046,252605,307651,55573
2020/05/22,Palencia,Burgos,188,357072,45936,311136,160866,24030
2020/05/22,Palencia,León,26,460001,66778,393223,160866,24030
2020/05/22,Palencia,Valladolid,196,519546,83711,435835,160866,24030
2020/05/22,Palencia,Palencia,16352,160866,22601,138265,160866,24030
2020/05/22,Palencia,Cantabria,195,580795,100673,480122,160866,24030
2020/05/22,Pontevedra,Coruña,4202,1119596,197163,922433,942665,175886
2020/05/22,Pontevedra,Lugo,55,329587,49790,279797,942665,175886
2020/05/22,Pontevedra,Pontevedra,140238,942665,176796,765869,942665,175886
2020/05/22,Pontevedra,Ourense,195,307651,55046,252605,942665,175886
2020/05/22,Rioja,Navarra,1924,654183,114637,539546,316798,51440
2020/05/22,Rioja,Rioja,40643,316798,54375,262423,316798,51440
2020/05/22,Rioja,Burgos,54,357072,45936,311136,316798,51440
2020/05/22,Rioja,Araba,745,331549,64893,266656,316798,51440
2020/05/22,Salamanca,Ávila,220,157640,17331,140309,330119,45930
2020/05/22,Salamanca,Zamora,29,172539,22097,150442,330119,45930
2020/05/22,Salamanca,Valladolid,27,519546,83711,435835,330119,45930
2020/05/22,Salamanca,Salamanca,36880,330119,46367,283752,330119,45930
2020/05/22,Santa Cruz de Tenerife,Santa Cruz de Tenerife,148780,1032983,163700,869283,1032983,163233
2020/05/22,Segovia,Segovia,13524,153129,20086,133043,153129,21723
2020/05/22,Segovia,Valladolid,338,519546,83711,435835,153129,21723
2020/05/22,Segovia,Burgos,141,357072,45936,311136,153129,21723
2020/05/22,Segovia,Ávila,130,157640,17331,140309,153129,21723
2020/05/22,Sevilla,Málaga,130,1661785,265131,1396654,1942389,331162
2020/05/22,Sevilla,Badajoz,30,673559,94551,579008,1942389,331162
2020/05/22,Sevilla,Sevilla,246152,1942389,335578,1606811,1942389,331162
2020/05/22,Sevilla,Huelva,602,521870,80227,441643,1942389,331162
2020/05/22,Sevilla,Cádiz,956,1240155,201608,1038547,1942389,331162
2020/05/22,Sevilla,Córdoba,2322,782979,120679,662300,1942389,331162
2020/05/22,Soria,Soria,6239,88636,8311,80325,88636,9030
2020/05/22,Soria,Segovia,22,153129,20086,133043,88636,9030
2020/05/22,Soria,Valladolid,31,519546,83711,435835,88636,9030
2020/05/22,Soria,Zaragoza,146,964724,176642,788082,88636,9030
2020/05/22,Soria,Burgos,66,357072,45936,311136,88636,9030
2020/05/22,Tarragona,Castellón,810,579962,86257,493705,804664,122628
2020/05/22,Tarragona,Teruel,67,134137,12014,122123,804664,122628
2020/05/22,Tarragona,Zaragoza,37,964724,176642,788082,804664,122628
2020/05/22,Tarragona,Tarragona,85366,804664,122912,681752,804664,122628
2020/05/22,Tarragona,Barcelona,1177,5664579,994006,4670573,804664,122628
2020/05/22,Tarragona,Lleida,19,434930,71883,363047,804664,122628
2020/05/22,Teruel,Teruel,7626,134137,12014,122123,134137,13430
2020/05/22,Teruel,Tarragona,83,804664,122912,681752,134137,13430
2020/05/22,Teruel,Castellón,122,579962,86257,493705,134137,13430
2020/05/22,Teruel,Zaragoza,187,964724,176642,788082,134137,13430
2020/05/22,Toledo,Toledo,46808,694844,94097,600747,694844,91427
2020/05/22,Toledo,Ciudad Real,399,495761,50880,444881,694844,91427
2020/05/22,Toledo,Cuenca,116,196329,22868,173461,694844,91427
2020/05/22,Toledo,Ávila,252,157640,17331,140309,694844,91427
2020/05/22,Toledo,Madrid,3787,6663394,1056388,5607006,694844,91427
2020/05/22,Toledo,Cáceres,130,394151,48644,345507,694844,91427
2020/05/22,Valencia,Valencia,358946,2565124,496355,2068769,2565124,485127
2020/05/22,Valencia,Castellón,692,579962,86257,493705,2565124,485127
2020/05/22,Valencia,Cuenca,104,196329,22868,173461,2565124,485127
2020/05/22,Valencia,Alicante,1262,1858683,316205,1542478,2565124,485127
2020/05/22,Valencia,Albacete,318,388167,41085,347082,2565124,485127
2020/05/22,Valencia,Cáceres,19,394151,48644,345507,2565124,485127
2020/05/22,Valladolid,Burgos,55,357072,45936,311136,519546,80937
2020/05/22,Valladolid,Soria,40,88636,8311,80325,519546,80937
2020/05/22,Valladolid,León,31,460001,66778,393223,519546,80937
2020/05/22,Valladolid,Ávila,26,157640,17331,140309,519546,80937
2020/05/22,Valladolid,Zamora,137,172539,22097,150442,519546,80937
2020/05/22,Valladolid,Valladolid,61356,519546,83711,435835,519546,80937
2020/05/22,Valladolid,Palencia,74,160866,22601,138265,519546,80937
2020/05/22,Valladolid,Segovia,309,153129,20086,133043,519546,80937
2020/05/22,Zamora,Zamora,15258,172539,22097,150442,172539,21712
2020/05/22,Zamora,Ourense,101,307651,55046,252605,172539,21712
2020/05/22,Zamora,León,26,460001,66778,393223,172539,21712
2020/05/22,Zamora,Valladolid,88,519546,83711,435835,172539,21712
2020/05/22,Zaragoza,Lleida,105,434930,71883,363047,964724,169693
2020/05/22,Zaragoza,Huesca,359,220461,30989,189472,964724,169693
2020/05/22,Zaragoza,Navarra,526,654183,114637,539546,964724,169693
2020/05/22,Zaragoza,Soria,94,88636,8311,80325,964724,169693
2020/05/22,Zaragoza,Zaragoza,137508,964724,176642,788082,964724,169693
2020/05/22,Zaragoza,Teruel,325,134137,12014,122123,964724,169693
2020/05/23,Albacete,Jaén,60,633564,65425,568139,388167,35706
2020/05/23,Albacete,Albacete,24741,388167,34912,353255,388167,35706
2020/05/23,Albacete,Cuenca,557,196329,18634,177695,388167,35706
2020/05/23,Albacete,Alicante,225,1858683,266206,1592477,388167,35706
2020/05/23,Albacete,Granada,24,914678,128732,785946,388167,35706
2020/05/23,Albacete,Valencia,337,2565124,411020,2154104,388167,35706
2020/05/23,Albacete,Ciudad Real,444,495761,41611,454150,388167,35706
2020/05/23,Albacete,Murcia,604,1493898,209037,1284861,388167,35706
2020/05/23,Alicante,Albacete,307,388167,34912,353255,1858683,268256
2020/05/23,Alicante,Alicante,214766,1858683,266206,1592477,1858683,268256
2020/05/23,Alicante,Murcia,3020,1493898,209037,1284861,1858683,268256
2020/05/23,Alicante,Valencia,1148,2565124,411020,2154104,1858683,268256
2020/05/23,Almería,Murcia,1260,1493898,209037,1284861,716820,87060
2020/05/23,Almería,Almería,71799,716820,86652,630168,716820,87060
2020/05/23,Almería,Granada,369,914678,128732,785946,716820,87060
2020/05/23,Araba,Burgos,930,357072,30522,326550,331549,47744
2020/05/23,Araba,Gipuzkoa,122,723576,78885,644691,331549,47744
2020/05/23,Araba,Bizkaia,631,1152934,162476,990458,331549,47744
2020/05/23,Araba,Araba,38590,331549,46038,285511,331549,47744
2020/05/23,Araba,Navarra,80,654183,89907,564276,331549,47744
2020/05/23,Araba,Rioja,1169,316798,42132,274666,331549,47744
2020/05/23,Asturias,Cantabria,181,580795,73889,506906,1022800,132676
2020/05/23,Asturias,Lugo,777,329587,40147,289440,1022800,132676
2020/05/23,Asturias,Asturias,104876,1022800,132375,890425,1022800,132676
2020/05/23,Asturias,León,22,460001,51310,408691,1022800,132676
2020/05/23,Ávila,Valladolid,39,519546,56104,463442,157640,13605
2020/05/23,Ávila,Cáceres,171,394151,41334,352817,157640,13605
2020/05/23,Ávila,Segovia,62,153129,14419,138710,157640,13605
2020/05/23,Ávila,Ávila,9097,157640,12738,144902,157640,13605
2020/05/23,Ávila,Madrid,159,6663394,723486,5939908,157640,13605
2020/05/23,Ávila,Salamanca,302,330119,34765,295354,157640,13605
2020/05/23,Ávila,Toledo,215,694844,70926,623918,157640,13605
2020/05/23,Badajoz,Cáceres,1063,394151,41334,352817,673559,79499
2020/05/23,Badajoz,Huelva,209,521870,65413,456457,673559,79499
2020/05/23,Badajoz,Sevilla,114,1942389,274564,1667825,673559,79499
2020/05/23,Badajoz,Badajoz,61297,673559,80353,593206,673559,79499
2020/05/23,Badajoz,Córdoba,92,782979,103048,679931,673559,79499
2020/05/23,Badajoz,Ciudad Real,65,495761,41611,454150,673559,79499
2020/05/23,Balears,Balears,135129,1149460,151637,997823,1149460,152290
2020/05/23,Balears,Valencia,28,2565124,411020,2154104,1149460,152290
2020/05/23,Barcelona,Lleida,256,434930,59161,375769,5664579,737365
2020/05/23,Barcelona,Barcelona,517399,5664579,737407,4927172,5664579,737365
2020/05/23,Barcelona,Tarragona,1284,804664,103791,700873,5664579,737365
2020/05/23,Barcelona,Girona,2813,771044,93847,677197,5664579,737365
2020/05/23,Bizkaia,Araba,639,331549,46038,285511,1152934,160423
2020/05/23,Bizkaia,Gipuzkoa,527,723576,78885,644691,1152934,160423
2020/05/23,Bizkaia,Bizkaia,125988,1152934,162476,990458,1152934,160423
2020/05/23,Bizkaia,Cantabria,816,580795,73889,506906,1152934,160423
2020/05/23,Bizkaia,Burgos,41,357072,30522,326550,1152934,160423
2020/05/23,Burgos,Araba,1515,331549,46038,285511,357072,31901
2020/05/23,Burgos,Burgos,23385,357072,30522,326550,357072,31901
2020/05/23,Burgos,Segovia,45,153129,14419,138710,357072,31901
2020/05/23,Burgos,Cantabria,24,580795,73889,506906,357072,31901
2020/05/23,Burgos,Valladolid,82,519546,56104,463442,357072,31901
2020/05/23,Burgos,Bizkaia,59,1152934,162476,990458,357072,31901
2020/05/23,Burgos,Palencia,178,160866,16061,144805,357072,31901
2020/05/23,Cáceres,Valencia,23,2565124,411020,2154104,394151,40902
2020/05/23,Cáceres,Ávila,99,157640,12738,144902,394151,40902
2020/05/23,Cáceres,Cáceres,29969,394151,41334,352817,394151,40902
2020/05/23,Cáceres,Badajoz,1105,673559,80353,593206,394151,40902
2020/05/23,Cáceres,Toledo,114,694844,70926,623918,394151,40902
2020/05/23,Cádiz,Cádiz,150685,1240155,174377,1065778,1240155,177355
2020/05/23,Cádiz,Huelva,915,521870,65413,456457,1240155,177355
2020/05/23,Cádiz,Almería,16,716820,86652,630168,1240155,177355
2020/05/23,Cádiz,Ceuta,48,84777,10392,74385,1240155,177355
2020/05/23,Cádiz,Sevilla,890,1942389,274564,1667825,1240155,177355
2020/05/23,Cádiz,Málaga,1024,1661785,222854,1438931,1240155,177355
2020/05/23,Cantabria,Asturias,189,1022800,132375,890425,580795,73169
2020/05/23,Cantabria,Palencia,56,160866,16061,144805,580795,73169
2020/05/23,Cantabria,Cantabria,55751,580795,73889,506906,580795,73169
2020/05/23,Cantabria,Bizkaia,520,1152934,162476,990458,580795,73169
2020/05/23,Castellón,Valencia,792,2565124,411020,2154104,579962,70348
2020/05/23,Castellón,Teruel,46,134137,9167,124970,579962,70348
2020/05/23,Castellón,Castellón,54187,579962,69406,510556,579962,70348
2020/05/23,Castellón,Tarragona,879,804664,103791,700873,579962,70348
2020/05/23,Ceuta,Cádiz,20,1240155,174377,1065778,84777,10345
2020/05/23,Ceuta,Ceuta,9882,84777,10392,74385,84777,10345
2020/05/23,Ciudad Real,Ciudad Real,28710,495761,41611,454150,495761,41500
2020/05/23,Ciudad Real,Albacete,402,388167,34912,353255,495761,41500
2020/05/23,Ciudad Real,Toledo,192,694844,70926,623918,495761,41500
2020/05/23,Ciudad Real,Córdoba,410,782979,103048,679931,495761,41500
2020/05/23,Ciudad Real,Badajoz,78,673559,80353,593206,495761,41500
2020/05/23,Ciudad Real,Cuenca,87,196329,18634,177695,495761,41500
2020/05/23,Córdoba,Granada,146,914678,128732,785946,782979,102038
2020/05/23,Córdoba,Badajoz,109,673559,80353,593206,782979,102038
2020/05/23,Córdoba,Sevilla,1774,1942389,274564,1667825,782979,102038
2020/05/23,Córdoba,Málaga,166,1661785,222854,1438931,782979,102038
2020/05/23,Córdoba,Ciudad Real,293,495761,41611,454150,782979,102038
2020/05/23,Córdoba,Córdoba,76699,782979,103048,679931,782979,102038
2020/05/23,Córdoba,Jaén,676,633564,65425,568139,782979,102038
2020/05/23,Coruña,Melilla,18,86487,12159,74328,1119596,160943
2020/05/23,Coruña,Lugo,532,329587,40147,289440,1119596,160943
2020/05/23,Coruña,Pontevedra,4322,942665,138969,803696,1119596,160943
2020/05/23,Coruña,Coruña,123452,1119596,158802,960794,1119596,160943
2020/05/23,Cuenca,Toledo,186,694844,70926,623918,196329,19358
2020/05/23,Cuenca,Ciudad Real,86,495761,41611,454150,196329,19358
2020/05/23,Cuenca,Cuenca,11791,196329,18634,177695,196329,19358
2020/05/23,Cuenca,Guadalajara,91,257762,31346,226416,196329,19358
2020/05/23,Cuenca,Valencia,94,2565124,411020,2154104,196329,19358
2020/05/23,Cuenca,Albacete,746,388167,34912,353255,196329,19358
2020/05/23,Cuenca,Madrid,52,6663394,723486,5939908,196329,19358
2020/05/23,Gipuzkoa,Rioja,16,316798,42132,274666,723576,80010
2020/05/23,Gipuzkoa,Bizkaia,849,1152934,162476,990458,723576,80010
2020/05/23,Gipuzkoa,Navarra,172,654183,89907,564276,723576,80010
2020/05/23,Gipuzkoa,Gipuzkoa,61215,723576,78885,644691,723576,80010
2020/05/23,Gipuzkoa,Araba,145,331549,46038,285511,723576,80010
2020/05/23,Girona,Lleida,145,434930,59161,375769,771044,96669
2020/05/23,Girona,Barcelona,2325,5664579,737407,4927172,771044,96669
2020/05/23,Girona,Tarragona,16,804664,103791,700873,771044,96669
2020/05/23,Girona,Girona,65942,771044,93847,677197,771044,96669
2020/05/23,Granada,Córdoba,341,782979,103048,679931,914678,129622
2020/05/23,Granada,Granada,97079,914678,128732,785946,914678,129622
2020/05/23,Granada,Almería,602,716820,86652,630168,914678,129622
2020/05/23,Granada,Jaén,406,633564,65425,568139,914678,129622
2020/05/23,Granada,Málaga,278,1661785,222854,1438931,914678,129622
2020/05/23,Guadalajara,Guadalajara,22253,257762,31346,226416,257762,31813
2020/05/23,Guadalajara,Teruel,34,134137,9167,124970,257762,31813
2020/05/23,Guadalajara,Madrid,1468,6663394,723486,5939908,257762,31813
2020/05/23,Guadalajara,Cuenca,74,196329,18634,177695,257762,31813
2020/05/23,Huelva,Sevilla,1231,1942389,274564,1667825,521870,66964
2020/05/23,Huelva,Badajoz,379,673559,80353,593206,521870,66964
2020/05/23,Huelva,Cádiz,728,1240155,174377,1065778,521870,66964
2020/05/23,Huelva,Huelva,52324,521870,65413,456457,521870,66964
2020/05/23,Huesca,Zaragoza,368,964724,144663,820061,220461,27596
2020/05/23,Huesca,Huesca,18547,220461,25265,195196,220461,27596
2020/05/23,Huesca,Lleida,1211,434930,59161,375769,220461,27596
2020/05/23,Jaén,Jaén,48111,633564,65425,568139,633564,65251
2020/05/23,Jaén,Granada,252,914678,128732,785946,633564,65251
2020/05/23,Jaén,Córdoba,695,782979,103048,679931,633564,65251
2020/05/23,Jaén,Ciudad Real,16,495761,41611,454150,633564,65251
2020/05/23,Las Palmas de Gran Canaria,Las Palmas de Gran Canaria,130511,1120406,143338,977068,1120406,142067
2020/05/23,Las Palmas de Gran Canaria,Santa Cruz de Tenerife,38,1032983,134665,898318,1120406,142067
2020/05/23,León,Zamora,70,172539,16153,156386,460001,51246
2020/05/23,León,Palencia,28,160866,16061,144805,460001,51246
2020/05/23,León,Asturias,46,1022800,132375,890425,460001,51246
2020/05/23,León,León,40211,460001,51310,408691,460001,51246
2020/05/23,León,Ourense,186,307651,46574,261077,460001,51246
2020/05/23,Lleida,Lleida,41249,434930,59161,375769,434930,57385
2020/05/23,Lleida,Zaragoza,145,964724,144663,820061,434930,57385
2020/05/23,Lleida,Huesca,602,220461,25265,195196,434930,57385
2020/05/23,Lleida,Barcelona,285,5664579,737407,4927172,434930,57385
2020/05/23,Lleida,Tarragona,31,804664,103791,700873,434930,57385
2020/05/23,Lleida,Girona,233,771044,93847,677197,434930,57385
2020/05/23,Lugo,Coruña,507,1119596,158802,960794,329587,41205
2020/05/23,Lugo,Lugo,30227,329587,40147,289440,329587,41205
2020/05/23,Lugo,Ourense,166,307651,46574,261077,329587,41205
2020/05/23,Lugo,Asturias,720,1022800,132375,890425,329587,41205
2020/05/23,Madrid,Guadalajara,1432,257762,31346,226416,6663394,720923
2020/05/23,Madrid,Ciudad Real,17,495761,41611,454150,6663394,720923
2020/05/23,Madrid,Cuenca,48,196329,18634,177695,6663394,720923
2020/05/23,Madrid,Toledo,2473,694844,70926,623918,6663394,720923
2020/05/23,Madrid,Madrid,471375,6663394,723486,5939908,6663394,720923
2020/05/23,Madrid,Ávila,245,157640,12738,144902,6663394,720923
2020/05/23,Málaga,Cádiz,799,1240155,174377,1065778,1661785,221867
2020/05/23,Málaga,Córdoba,262,782979,103048,679931,1661785,221867
2020/05/23,Málaga,Sevilla,222,1942389,274564,1667825,1661785,221867
2020/05/23,Málaga,Málaga,187029,1661785,222854,1438931,1661785,221867
2020/05/23,Málaga,Granada,180,914678,128732,785946,1661785,221867
2020/05/23,Melilla,Melilla,11954,86487,12159,74328,86487,12205
2020/05/23,Murcia,Murcia,169486,1493898,209037,1284861,1493898,205891
2020/05/23,Murcia,Alicante,2363,1858683,266206,1592477,1493898,205891
2020/05/23,Murcia,Almería,894,716820,86652,630168,1493898,205891
2020/05/23,Murcia,Albacete,385,388167,34912,353255,1493898,205891
2020/05/23,Navarra,Navarra,67464,654183,89907,564276,654183,90314
2020/05/23,Navarra,Araba,41,331549,46038,285511,654183,90314
2020/05/23,Navarra,Rioja,1323,316798,42132,274666,654183,90314
2020/05/23,Navarra,Zaragoza,457,964724,144663,820061,654183,90314
2020/05/23,Navarra,Gipuzkoa,216,723576,78885,644691,654183,90314
2020/05/23,Ourense,Zamora,35,172539,16153,156386,307651,46770
2020/05/23,Ourense,Lugo,220,329587,40147,289440,307651,46770
2020/05/23,Ourense,Ourense,38689,307651,46574,261077,307651,46770
2020/05/23,Ourense,León,108,460001,51310,408691,307651,46770
2020/05/23,Ourense,Pontevedra,187,942665,138969,803696,307651,46770
2020/05/23,Palencia,Palencia,11880,160866,16061,144805,160866,16280
2020/05/23,Palencia,Cantabria,65,580795,73889,506906,160866,16280
2020/05/23,Palencia,Burgos,160,357072,30522,326550,160866,16280
2020/05/23,Palencia,Valladolid,100,519546,56104,463442,160866,16280
2020/05/23,Pontevedra,Coruña,3918,1119596,158802,960794,942665,138716
2020/05/23,Pontevedra,Ourense,140,307651,46574,261077,942665,138716
2020/05/23,Pontevedra,Pontevedra,109566,942665,138969,803696,942665,138716
2020/05/23,Rioja,Rioja,33971,316798,42132,274666,316798,41460
2020/05/23,Rioja,Navarra,1330,654183,89907,564276,316798,41460
2020/05/23,Rioja,Araba,534,331549,46038,285511,316798,41460
2020/05/23,Salamanca,Zamora,61,172539,16153,156386,330119,34554
2020/05/23,Salamanca,Salamanca,28308,330119,34765,295354,330119,34554
2020/05/23,Salamanca,Ávila,195,157640,12738,144902,330119,34554
2020/05/23,Santa Cruz de Tenerife,Santa Cruz de Tenerife,120130,1032983,134665,898318,1032983,134764
2020/05/23,Santa Cruz de Tenerife,Las Palmas de Gran Canaria,24,1120406,143338,977068,1032983,134764
2020/05/23,Segovia,Burgos,87,357072,30522,326550,153129,15068
2020/05/23,Segovia,Soria,22,88636,5457,83179,153129,15068
2020/05/23,Segovia,Valladolid,209,519546,56104,463442,153129,15068
2020/05/23,Segovia,Ávila,42,157640,12738,144902,153129,15068
2020/05/23,Segovia,Segovia,10417,153129,14419,138710,153129,15068
2020/05/23,Sevilla,Cádiz,844,1240155,174377,1065778,1942389,271532
2020/05/23,Sevilla,Málaga,67,1661785,222854,1438931,1942389,271532
2020/05/23,Sevilla,Sevilla,199137,1942389,274564,1667825,1942389,271532
2020/05/23,Sevilla,Huelva,598,521870,65413,456457,1942389,271532
2020/05/23,Sevilla,Badajoz,56,673559,80353,593206,1942389,271532
2020/05/23,Sevilla,Córdoba,2082,782979,103048,679931,1942389,271532
2020/05/23,Soria,Burgos,34,357072,30522,326550,88636,5794
2020/05/23,Soria,Valladolid,32,519546,56104,463442,88636,5794
2020/05/23,Soria,Segovia,19,153129,14419,138710,88636,5794
2020/05/23,Soria,Soria,4084,88636,5457,83179,88636,5794
2020/05/23,Soria,Zaragoza,63,964724,144663,820061,88636,5794
2020/05/23,Tarragona,Zaragoza,68,964724,144663,820061,804664,103744
2020/05/23,Tarragona,Lleida,19,434930,59161,375769,804664,103744
2020/05/23,Tarragona,Castellón,567,579962,69406,510556,804664,103744
2020/05/23,Tarragona,Barcelona,1192,5664579,737407,4927172,804664,103744
2020/05/23,Tarragona,Tarragona,76815,804664,103791,700873,804664,103744
2020/05/23,Tarragona,Teruel,66,134137,9167,124970,804664,103744
2020/05/23,Teruel,Castellón,91,579962,69406,510556,134137,10399
2020/05/23,Teruel,Teruel,5959,134137,9167,124970,134137,10399
2020/05/23,Teruel,Valencia,154,2565124,411020,2154104,134137,10399
2020/05/23,Teruel,Cuenca,22,196329,18634,177695,134137,10399
2020/05/23,Teruel,Zaragoza,202,964724,144663,820061,134137,10399
2020/05/23,Teruel,Tarragona,103,804664,103791,700873,134137,10399
2020/05/23,Toledo,Cáceres,178,394151,41334,352817,694844,71571
2020/05/23,Toledo,Ciudad Real,200,495761,41611,454150,694844,71571
2020/05/23,Toledo,Ávila,275,157640,12738,144902,694844,71571
2020/05/23,Toledo,Toledo,41534,694844,70926,623918,694844,71571
2020/05/23,Toledo,Cuenca,101,196329,18634,177695,694844,71571
2020/05/23,Toledo,Madrid,2550,6663394,723486,5939908,694844,71571
2020/05/23,Valencia,Albacete,281,388167,34912,353255,2565124,407130
2020/05/23,Valencia,Alicante,906,1858683,266206,1592477,2565124,407130
2020/05/23,Valencia,Cuenca,136,196329,18634,177695,2565124,407130
2020/05/23,Valencia,Castellón,569,579962,69406,510556,2565124,407130
2020/05/23,Valencia,Valencia,298692,2565124,411020,2154104,2565124,407130
2020/05/23,Valladolid,Ávila,59,157640,12738,144902,519546,54886
2020/05/23,Valladolid,León,45,460001,51310,408691,519546,54886
2020/05/23,Valladolid,Zamora,137,172539,16153,156386,519546,54886
2020/05/23,Valladolid,Segovia,201,153129,14419,138710,519546,54886
2020/05/23,Valladolid,Soria,33,88636,5457,83179,519546,54886
2020/05/23,Valladolid,Valladolid,41188,519546,56104,463442,519546,54886
2020/05/23,Valladolid,Palencia,43,160866,16061,144805,519546,54886
2020/05/23,Valladolid,Burgos,103,357072,30522,326550,519546,54886
2020/05/23,Zamora,León,38,460001,51310,408691,172539,16343
2020/05/23,Zamora,Valladolid,104,519546,56104,463442,172539,16343
2020/05/23,Zamora,Salamanca,16,330119,34765,295354,172539,16343
2020/05/23,Zamora,Zamora,12069,172539,16153,156386,172539,16343
2020/05/23,Zaragoza,Teruel,136,134137,9167,124970,964724,139988
2020/05/23,Zaragoza,Soria,66,88636,5457,83179,964724,139988
2020/05/23,Zaragoza,Zaragoza,112845,964724,144663,820061,964724,139988
2020/05/23,Zaragoza,Navarra,423,654183,89907,564276,964724,139988
2020/05/23,Zaragoza,Lleida,95,434930,59161,375769,964724,139988
2020/05/23,Zaragoza,Huesca,295,220461,25265,195196,964724,139988
2020/05/24,Albacete,Alicante,224,1858683,232641,1626042,388167,27564
2020/05/24,Albacete,Albacete,18839,388167,27631,360536,388167,27564
2020/05/24,Albacete,Valencia,285,2565124,354773,2210351,388167,27564
2020/05/24,Albacete,Ciudad Real,325,495761,32934,462827,388167,27564
2020/05/24,Albacete,Cuenca,335,196329,14478,181851,388167,27564
2020/05/24,Albacete,Jaén,21,633564,55904,577660,388167,27564
2020/05/24,Albacete,Murcia,381,1493898,174101,1319797,388167,27564
2020/05/24,Alicante,Albacete,294,388167,27631,360536,1858683,232543
2020/05/24,Alicante,Valencia,1021,2565124,354773,2210351,1858683,232543
2020/05/24,Alicante,Alicante,187629,1858683,232641,1626042,1858683,232543
2020/05/24,Alicante,Murcia,2222,1493898,174101,1319797,1858683,232543
2020/05/24,Almería,Murcia,776,1493898,174101,1319797,716820,67471
2020/05/24,Almería,Almería,56372,716820,69399,647421,716820,67471
2020/05/24,Almería,Granada,416,914678,108944,805734,716820,67471
2020/05/24,Araba,Rioja,906,316798,36203,280595,331549,41899
2020/05/24,Araba,Bizkaia,590,1152934,152476,1000458,331549,41899
2020/05/24,Araba,Navarra,62,654183,75688,578495,331549,41899
2020/05/24,Araba,Araba,34087,331549,40414,291135,331549,41899
2020/05/24,Araba,Burgos,700,357072,21882,335190,331549,41899
2020/05/24,Araba,Gipuzkoa,92,723576,73711,649865,331549,41899
2020/05/24,Asturias,León,29,460001,40093,419908,1022800,123997
2020/05/24,Asturias,Cantabria,228,580795,71069,509726,1022800,123997
2020/05/24,Asturias,Lugo,679,329587,34953,294634,1022800,123997
2020/05/24,Asturias,Asturias,99759,1022800,124065,898735,1022800,123997
2020/05/24,Ávila,Cáceres,137,394151,34247,359904,157640,10582
2020/05/24,Ávila,Segovia,60,153129,10786,142343,157640,10582
2020/05/24,Ávila,Valladolid,38,519546,40584,478962,157640,10582
2020/05/24,Ávila,Ávila,7238,157640,10238,147402,157640,10582
2020/05/24,Ávila,Madrid,158,6663394,561413,6101981,157640,10582
2020/05/24,Ávila,Salamanca,244,330119,26756,303363,157640,10582
2020/05/24,Ávila,Toledo,174,694844,55455,639389,157640,10582
2020/05/24,Badajoz,Ciudad Real,53,495761,32934,462827,673559,67213
2020/05/24,Badajoz,Córdoba,93,782979,88687,694292,673559,67213
2020/05/24,Badajoz,Badajoz,52576,673559,67878,605681,673559,67213
2020/05/24,Badajoz,Sevilla,33,1942389,226707,1715682,673559,67213
2020/05/24,Badajoz,Huelva,177,521870,54839,467031,673559,67213
2020/05/24,Badajoz,Cáceres,875,394151,34247,359904,673559,67213
2020/05/24,Balears,Balears,117357,1149460,134217,1015243,1149460,134082
2020/05/24,Barcelona,Tarragona,866,804664,90434,714230,5664579,581736
2020/05/24,Barcelona,Barcelona,423169,5664579,578557,5086022,5664579,581736
2020/05/24,Barcelona,Lleida,210,434930,48621,386309,5664579,581736
2020/05/24,Barcelona,Girona,2241,771044,78926,692118,5664579,581736
2020/05/24,Bizkaia,Bizkaia,120669,1152934,152476,1000458,1152934,150522
2020/05/24,Bizkaia,Cantabria,609,580795,71069,509726,1152934,150522
2020/05/24,Bizkaia,Gipuzkoa,549,723576,73711,649865,1152934,150522
2020/05/24,Bizkaia,Burgos,19,357072,21882,335190,1152934,150522
2020/05/24,Bizkaia,Araba,618,331549,40414,291135,1152934,150522
2020/05/24,Burgos,Segovia,18,153129,10786,142343,357072,23656
2020/05/24,Burgos,Burgos,16528,357072,21882,335190,357072,23656
2020/05/24,Burgos,Bizkaia,72,1152934,152476,1000458,357072,23656
2020/05/24,Burgos,Cantabria,31,580795,71069,509726,357072,23656
2020/05/24,Burgos,Araba,1549,331549,40414,291135,357072,23656
2020/05/24,Burgos,Palencia,115,160866,12168,148698,357072,23656
2020/05/24,Burgos,Valladolid,57,519546,40584,478962,357072,23656
2020/05/24,Cáceres,Badajoz,827,673559,67878,605681,394151,33684
2020/05/24,Cáceres,Toledo,110,694844,55455,639389,394151,33684
2020/05/24,Cáceres,Ávila,125,157640,10238,147402,394151,33684
2020/05/24,Cáceres,Cáceres,24606,394151,34247,359904,394151,33684
2020/05/24,Cádiz,Ceuta,52,84777,10310,74467,1240155,148332
2020/05/24,Cádiz,Málaga,790,1661785,183203,1478582,1240155,148332
2020/05/24,Cádiz,Sevilla,810,1942389,226707,1715682,1240155,148332
2020/05/24,Cádiz,Cádiz,126456,1240155,147371,1092784,1240155,148332
2020/05/24,Cádiz,Huelva,688,521870,54839,467031,1240155,148332
2020/05/24,Cantabria,Palencia,38,160866,12168,148698,580795,70359
2020/05/24,Cantabria,Asturias,167,1022800,124065,898735,580795,70359
2020/05/24,Cantabria,Cantabria,54119,580795,71069,509726,580795,70359
2020/05/24,Cantabria,Bizkaia,598,1152934,152476,1000458,580795,70359
2020/05/24,Cantabria,Burgos,18,357072,21882,335190,580795,70359
2020/05/24,Castellón,Valencia,743,2565124,354773,2210351,579962,62850
2020/05/24,Castellón,Castellón,49490,579962,61866,518096,579962,62850
2020/05/24,Castellón,Teruel,72,134137,7072,127065,579962,62850
2020/05/24,Castellón,Tarragona,680,804664,90434,714230,579962,62850
2020/05/24,Ceuta,Cádiz,38,1240155,147371,1092784,84777,10317
2020/05/24,Ceuta,Ceuta,9853,84777,10310,74467,84777,10317
2020/05/24,Ciudad Real,Ciudad Real,21719,495761,32934,462827,495761,32033
2020/05/24,Ciudad Real,Jaén,17,633564,55904,577660,495761,32033
2020/05/24,Ciudad Real,Badajoz,62,673559,67878,605681,495761,32033
2020/05/24,Ciudad Real,Albacete,320,388167,27631,360536,495761,32033
2020/05/24,Ciudad Real,Toledo,127,694844,55455,639389,495761,32033
2020/05/24,Ciudad Real,Córdoba,375,782979,88687,694292,495761,32033
2020/05/24,Ciudad Real,Cuenca,39,196329,14478,181851,495761,32033
2020/05/24,Córdoba,Ciudad Real,593,495761,32934,462827,782979,87697
2020/05/24,Córdoba,Córdoba,66409,782979,88687,694292,782979,87697
2020/05/24,Córdoba,Sevilla,1350,1942389,226707,1715682,782979,87697
2020/05/24,Córdoba,Jaén,564,633564,55904,577660,782979,87697
2020/05/24,Córdoba,Melilla,350,86487,12091,74396,782979,87697
2020/05/24,Córdoba,Granada,115,914678,108944,805734,782979,87697
2020/05/24,Córdoba,Badajoz,200,673559,67878,605681,782979,87697
2020/05/24,Córdoba,Málaga,88,1661785,183203,1478582,782979,87697
2020/05/24,Coruña,Lugo,446,329587,34953,294634,1119596,136847
2020/05/24,Coruña,Coruña,104710,1119596,136449,983147,1119596,136847
2020/05/24,Coruña,Pontevedra,3845,942665,119999,822666,1119596,136847
2020/05/24,Cuenca,Ciudad Real,53,495761,32934,462827,196329,14651
2020/05/24,Cuenca,Cuenca,9140,196329,14478,181851,196329,14651
2020/05/24,Cuenca,Madrid,29,6663394,561413,6101981,196329,14651
2020/05/24,Cuenca,Albacete,571,388167,27631,360536,196329,14651
2020/05/24,Cuenca,Valencia,49,2565124,354773,2210351,196329,14651
2020/05/24,Cuenca,Guadalajara,56,257762,24146,233616,196329,14651
2020/05/24,Cuenca,Toledo,46,694844,55455,639389,196329,14651
2020/05/24,Gipuzkoa,Araba,69,331549,40414,291135,723576,74531
2020/05/24,Gipuzkoa,Navarra,108,654183,75688,578495,723576,74531
2020/05/24,Gipuzkoa,Gipuzkoa,57946,723576,73711,649865,723576,74531
2020/05/24,Gipuzkoa,Bizkaia,620,1152934,152476,1000458,723576,74531
2020/05/24,Girona,Lleida,150,434930,48621,386309,771044,79928
2020/05/24,Girona,Barcelona,1886,5664579,578557,5086022,771044,79928
2020/05/24,Girona,Girona,53897,771044,78926,692118,771044,79928
2020/05/24,Granada,Murcia,34,1493898,174101,1319797,914678,109268
2020/05/24,Granada,Almería,580,716820,69399,647421,914678,109268
2020/05/24,Granada,Córdoba,278,782979,88687,694292,914678,109268
2020/05/24,Granada,Jaén,482,633564,55904,577660,914678,109268
2020/05/24,Granada,Granada,81186,914678,108944,805734,914678,109268
2020/05/24,Granada,Málaga,204,1661785,183203,1478582,914678,109268
2020/05/24,Guadalajara,Cuenca,78,196329,14478,181851,257762,23649
2020/05/24,Guadalajara,Guadalajara,16713,257762,24146,233616,257762,23649
2020/05/24,Guadalajara,Madrid,1015,6663394,561413,6101981,257762,23649
2020/05/24,Huelva,Huelva,43223,521870,54839,467031,521870,54687
2020/05/24,Huelva,Sevilla,591,1942389,226707,1715682,521870,54687
2020/05/24,Huelva,Cádiz,714,1240155,147371,1092784,521870,54687
2020/05/24,Huelva,Badajoz,235,673559,67878,605681,521870,54687
2020/05/24,Huesca,Lleida,623,434930,48621,386309,220461,21948
2020/05/24,Huesca,Huesca,15306,220461,20780,199681,220461,21948
2020/05/24,Huesca,Zaragoza,232,964724,118530,846194,220461,21948
2020/05/24,Jaén,Córdoba,625,782979,88687,694292,633564,55396
2020/05/24,Jaén,Granada,264,914678,108944,805734,633564,55396
2020/05/24,Jaén,Jaén,41913,633564,55904,577660,633564,55396
2020/05/24,Jaén,Albacete,36,388167,27631,360536,633564,55396
2020/05/24,Las Palmas de Gran Canaria,Las Palmas de Gran Canaria,107126,1120406,119100,1001306,1120406,117888
2020/05/24,Las Palmas de Gran Canaria,Santa Cruz de Tenerife,21,1032983,110635,922348,1120406,117888
2020/05/24,León,Zamora,118,172539,11694,160845,460001,40022
2020/05/24,León,Valladolid,31,519546,40584,478962,460001,40022
2020/05/24,León,Asturias,40,1022800,124065,898735,460001,40022
2020/05/24,León,Ourense,75,307651,38320,269331,460001,40022
2020/05/24,León,León,31066,460001,40093,419908,460001,40022
2020/05/24,Lleida,Barcelona,309,5664579,578557,5086022,434930,47914
2020/05/24,Lleida,Lleida,34655,434930,48621,386309,434930,47914
2020/05/24,Lleida,Huesca,545,220461,20780,199681,434930,47914
2020/05/24,Lleida,Tarragona,86,804664,90434,714230,434930,47914
2020/05/24,Lleida,Girona,187,771044,78926,692118,434930,47914
2020/05/24,Lleida,Zaragoza,98,964724,118530,846194,434930,47914
2020/05/24,Lugo,Asturias,618,1022800,124065,898735,329587,35391
2020/05/24,Lugo,Coruña,493,1119596,136449,983147,329587,35391
2020/05/24,Lugo,Ourense,160,307651,38320,269331,329587,35391
2020/05/24,Lugo,Lugo,26152,329587,34953,294634,329587,35391
2020/05/24,Madrid,Toledo,1763,694844,55455,639389,6663394,566516
2020/05/24,Madrid,Madrid,395276,6663394,561413,6101981,6663394,566516
2020/05/24,Madrid,Albacete,20,388167,27631,360536,6663394,566516
2020/05/24,Madrid,Guadalajara,1086,257762,24146,233616,6663394,566516
2020/05/24,Madrid,Ávila,170,157640,10238,147402,6663394,566516
2020/05/24,Madrid,Cuenca,64,196329,14478,181851,6663394,566516
2020/05/24,Málaga,Sevilla,108,1942389,226707,1715682,1661785,182406
2020/05/24,Málaga,Málaga,149996,1661785,183203,1478582,1661785,182406
2020/05/24,Málaga,Córdoba,242,782979,88687,694292,1661785,182406
2020/05/24,Málaga,Cádiz,704,1240155,147371,1092784,1661785,182406
2020/05/24,Málaga,Granada,209,914678,108944,805734,1661785,182406
2020/05/24,Melilla,Melilla,11685,86487,12091,74396,86487,11919
2020/05/24,Murcia,Albacete,154,388167,27631,360536,1493898,171872
2020/05/24,Murcia,Almería,686,716820,69399,647421,1493898,171872
2020/05/24,Murcia,Alicante,1752,1858683,232641,1626042,1493898,171872
2020/05/24,Murcia,Murcia,140957,1493898,174101,1319797,1493898,171872
2020/05/24,Murcia,Granada,29,914678,108944,805734,1493898,171872
2020/05/24,Navarra,Navarra,57194,654183,75688,578495,654183,76255
2020/05/24,Navarra,Zaragoza,341,964724,118530,846194,654183,76255
2020/05/24,Navarra,Rioja,958,316798,36203,280595,654183,76255
2020/05/24,Navarra,Gipuzkoa,181,723576,73711,649865,654183,76255
2020/05/24,Navarra,Araba,61,331549,40414,291135,654183,76255
2020/05/24,Ourense,Pontevedra,174,942665,119999,822666,307651,38171
2020/05/24,Ourense,Ourense,31126,307651,38320,269331,307651,38171
2020/05/24,Ourense,Lugo,201,329587,34953,294634,307651,38171
2020/05/24,Ourense,Zamora,23,172539,11694,160845,307651,38171
2020/05/24,Ourense,León,104,460001,40093,419908,307651,38171
2020/05/24,Palencia,Cantabria,45,580795,71069,509726,160866,12502
2020/05/24,Palencia,Palencia,9190,160866,12168,148698,160866,12502
2020/05/24,Palencia,Valladolid,50,519546,40584,478962,160866,12502
2020/05/24,Palencia,Burgos,119,357072,21882,335190,160866,12502
2020/05/24,Pontevedra,Ourense,233,307651,38320,269331,942665,119839
2020/05/24,Pontevedra,Pontevedra,93561,942665,119999,822666,942665,119839
2020/05/24,Pontevedra,Coruña,3558,1119596,136449,983147,942665,119839
2020/05/24,Rioja,Navarra,898,654183,75688,578495,316798,35337
2020/05/24,Rioja,Rioja,29519,316798,36203,280595,316798,35337
2020/05/24,Rioja,Araba,400,331549,40414,291135,316798,35337
2020/05/24,Salamanca,Ávila,140,157640,10238,147402,330119,26650
2020/05/24,Salamanca,Salamanca,21109,330119,26756,303363,330119,26650
2020/05/24,Santa Cruz de Tenerife,Las Palmas de Gran Canaria,116,1120406,119100,1001306,1032983,110769
2020/05/24,Santa Cruz de Tenerife,Santa Cruz de Tenerife,95576,1032983,110635,922348,1032983,110769
2020/05/24,Segovia,Segovia,7589,153129,10786,142343,153129,10972
2020/05/24,Segovia,Valladolid,195,519546,40584,478962,153129,10972
2020/05/24,Segovia,Ávila,54,157640,10238,147402,153129,10972
2020/05/24,Segovia,Burgos,84,357072,21882,335190,153129,10972
2020/05/24,Sevilla,Málaga,53,1661785,183203,1478582,1942389,226169
2020/05/24,Sevilla,Cádiz,859,1240155,147371,1092784,1942389,226169
2020/05/24,Sevilla,Huelva,424,521870,54839,467031,1942389,226169
2020/05/24,Sevilla,Sevilla,163213,1942389,226707,1715682,1942389,226169
2020/05/24,Sevilla,Badajoz,66,673559,67878,605681,1942389,226169
2020/05/24,Sevilla,Córdoba,1837,782979,88687,694292,1942389,226169
2020/05/24,Soria,Valladolid,49,519546,40584,478962,88636,4483
2020/05/24,Soria,Burgos,32,357072,21882,335190,88636,4483
2020/05/24,Soria,Soria,3194,88636,4257,84379,88636,4483
2020/05/24,Tarragona,Teruel,34,134137,7072,127065,804664,89647
2020/05/24,Tarragona,Tarragona,67387,804664,90434,714230,804664,89647
2020/05/24,Tarragona,Castellón,538,579962,61866,518096,804664,89647
2020/05/24,Tarragona,Barcelona,953,5664579,578557,5086022,804664,89647
2020/05/24,Tarragona,Lleida,38,434930,48621,386309,804664,89647
2020/05/24,Tarragona,Zaragoza,37,964724,118530,846194,804664,89647
2020/05/24,Teruel,Castellón,59,579962,61866,518096,134137,7771
2020/05/24,Teruel,Teruel,4755,134137,7072,127065,134137,7771
2020/05/24,Teruel,Zaragoza,84,964724,118530,846194,134137,7771
2020/05/24,Toledo,Madrid,1770,6663394,561413,6101981,694844,55403
2020/05/24,Toledo,Cáceres,129,394151,34247,359904,694844,55403
2020/05/24,Toledo,Ciudad Real,113,495761,32934,462827,694844,55403
2020/05/24,Toledo,Toledo,32596,694844,55455,639389,694844,55403
2020/05/24,Toledo,Ávila,206,157640,10238,147402,694844,55403
2020/05/24,Toledo,Cuenca,34,196329,14478,181851,694844,55403
2020/05/24,Valencia,Albacete,252,388167,27631,360536,2565124,353249
2020/05/24,Valencia,Alicante,920,1858683,232641,1626042,2565124,353249
2020/05/24,Valencia,Cuenca,111,196329,14478,181851,2565124,353249
2020/05/24,Valencia,Valencia,252823,2565124,354773,2210351,2565124,353249
2020/05/24,Valencia,Castellón,531,579962,61866,518096,2565124,353249
2020/05/24,Valladolid,Valladolid,29286,519546,40584,478962,519546,40311
2020/05/24,Valladolid,Ávila,26,157640,10238,147402,519546,40311
2020/05/24,Valladolid,Zamora,63,172539,11694,160845,519546,40311
2020/05/24,Valladolid,Segovia,162,153129,10786,142343,519546,40311
2020/05/24,Valladolid,Burgos,103,357072,21882,335190,519546,40311
2020/05/24,Valladolid,Palencia,23,160866,12168,148698,519546,40311
2020/05/24,Zamora,Zamora,8838,172539,11694,160845,172539,11849
2020/05/24,Zamora,Salamanca,20,330119,26756,303363,172539,11849
2020/05/24,Zamora,Valladolid,66,519546,40584,478962,172539,11849
2020/05/24,Zamora,Ourense,28,307651,38320,269331,172539,11849
2020/05/24,Zamora,León,28,460001,40093,419908,172539,11849
2020/05/24,Zaragoza,Huesca,198,220461,20780,199681,964724,116972
2020/05/24,Zaragoza,Zaragoza,90028,964724,118530,846194,964724,116972
2020/05/24,Zaragoza,Navarra,372,654183,75688,578495,964724,116972
2020/05/24,Zaragoza,Teruel,119,134137,7072,127065,964724,116972
2020/05/24,Zaragoza,Lleida,121,434930,48621,386309,964724,116972
2020/05/25,Albacete,Valencia,360,2565124,485585,2079539,388167,42904
2020/05/25,Albacete,Murcia,755,1493898,252229,1241669,388167,42904
2020/05/25,Albacete,Ciudad Real,578,495761,53802,441959,388167,42904
2020/05/25,Albacete,Albacete,26666,388167,42857,345310,388167,42904
2020/05/25,Albacete,Alicante,181,1858683,303732,1554951,388167,42904
2020/05/25,Albacete,Jaén,61,633564,80185,553379,388167,42904
2020/05/25,Albacete,Cuenca,739,196329,23547,172782,388167,42904
2020/05/25,Albacete,Madrid,17,6663394,1142033,5521361,388167,42904
2020/05/25,Alicante,Murcia,3449,1493898,252229,1241669,1858683,306977
2020/05/25,Alicante,Valencia,1399,2565124,485585,2079539,1858683,306977
2020/05/25,Alicante,Alicante,236326,1858683,303732,1554951,1858683,306977
2020/05/25,Alicante,Albacete,403,388167,42857,345310,1858683,306977
2020/05/25,Almería,Granada,533,914678,144693,769985,716820,107880
2020/05/25,Almería,Murcia,1878,1493898,252229,1241669,716820,107880
2020/05/25,Almería,Almería,87620,716820,105354,611466,716820,107880
2020/05/25,Araba,Araba,53379,331549,64454,267095,331549,73950
2020/05/25,Araba,Bizkaia,1628,1152934,241435,911499,331549,73950
2020/05/25,Araba,Gipuzkoa,285,723576,120253,603323,331549,73950
2020/05/25,Araba,Rioja,2502,316798,55338,261460,331549,73950
2020/05/25,Araba,Burgos,2208,357072,52928,304144,331549,73950
2020/05/25,Araba,Navarra,252,654183,116553,537630,331549,73950
2020/05/25,Araba,Cantabria,18,580795,106377,474418,331549,73950
2020/05/25,Asturias,Cantabria,389,580795,106377,474418,1022800,181900
2020/05/25,Asturias,Asturias,148670,1022800,183309,839491,1022800,181900
2020/05/25,Asturias,Lugo,1041,329587,51318,278269,1022800,181900
2020/05/25,Asturias,León,41,460001,76328,383673,1022800,181900
2020/05/25,Ávila,Toledo,249,694844,100290,594554,157640,20977
2020/05/25,Ávila,Segovia,84,153129,21937,131192,157640,20977
2020/05/25,Ávila,Valladolid,28,519546,93092,426454,157640,20977
2020/05/25,Ávila,Cáceres,141,394151,52919,341232,157640,20977
2020/05/25,Ávila,Madrid,170,6663394,1142033,5521361,157640,20977
2020/05/25,Ávila,Salamanca,276,330119,52995,277124,157640,20977
2020/05/25,Ávila,Ávila,13282,157640,20304,137336,157640,20977
2020/05/25,Badajoz,Cáceres,1254,394151,52919,341232,673559,96730
2020/05/25,Badajoz,Córdoba,62,782979,123909,659070,673559,96730
2020/05/25,Badajoz,Ciudad Real,52,495761,53802,441959,673559,96730
2020/05/25,Badajoz,Badajoz,72269,673559,98406,575153,673559,96730
2020/05/25,Badajoz,Huelva,206,521870,84547,437323,673559,96730
2020/05/25,Badajoz,Sevilla,46,1942389,343976,1598413,673559,96730
2020/05/25,Balears,Valencia,24,2565124,485585,2079539,1149460,191018
2020/05/25,Balears,Balears,170295,1149460,190467,958993,1149460,191018
2020/05/25,Barcelona,Girona,2854,771044,107161,663883,5664579,1025799
2020/05/25,Barcelona,Tarragona,2222,804664,120530,684134,5664579,1025799
2020/05/25,Barcelona,Lleida,221,434930,69457,365473,5664579,1025799
2020/05/25,Barcelona,Barcelona,648363,5664579,1024747,4639832,5664579,1025799
2020/05/25,Bizkaia,Burgos,70,357072,52928,304144,1152934,237260
2020/05/25,Bizkaia,Cantabria,3092,580795,106377,474418,1152934,237260
2020/05/25,Bizkaia,Araba,890,331549,64454,267095,1152934,237260
2020/05/25,Bizkaia,Bizkaia,186278,1152934,241435,911499,1152934,237260
2020/05/25,Bizkaia,Gipuzkoa,1175,723576,120253,603323,1152934,237260
2020/05/25,Burgos,Rioja,76,316798,55338,261460,357072,55020
2020/05/25,Burgos,Cantabria,26,580795,106377,474418,357072,55020
2020/05/25,Burgos,Segovia,73,153129,21937,131192,357072,55020
2020/05/25,Burgos,Valladolid,120,519546,93092,426454,357072,55020
2020/05/25,Burgos,Burgos,39803,357072,52928,304144,357072,55020
2020/05/25,Burgos,Araba,1085,331549,64454,267095,357072,55020
2020/05/25,Burgos,Soria,41,88636,9156,79480,357072,55020
2020/05/25,Burgos,Palencia,226,160866,25320,135546,357072,55020
2020/05/25,Burgos,Bizkaia,192,1152934,241435,911499,357072,55020
2020/05/25,Cáceres,Ávila,160,157640,20304,137336,394151,52731
2020/05/25,Cáceres,Cáceres,36848,394151,52919,341232,394151,52731
2020/05/25,Cáceres,Toledo,179,694844,100290,594554,394151,52731
2020/05/25,Cáceres,Badajoz,1395,673559,98406,575153,394151,52731
2020/05/25,Cádiz,Málaga,1414,1661785,263580,1398205,1240155,208635
2020/05/25,Cádiz,Cádiz,172696,1240155,206618,1033537,1240155,208635
2020/05/25,Cádiz,Huelva,907,521870,84547,437323,1240155,208635
2020/05/25,Cádiz,Ceuta,21,84777,12719,72058,1240155,208635
2020/05/25,Cádiz,Sevilla,1552,1942389,343976,1598413,1240155,208635
2020/05/25,Cantabria,Asturias,212,1022800,183309,839491,580795,100100
2020/05/25,Cantabria,Palencia,71,160866,25320,135546,580795,100100
2020/05/25,Cantabria,Bizkaia,972,1152934,241435,911499,580795,100100
2020/05/25,Cantabria,Cantabria,77878,580795,106377,474418,580795,100100
2020/05/25,Castellón,Castellón,64180,579962,84688,495274,579962,89702
2020/05/25,Castellón,Tarragona,854,804664,120530,684134,579962,89702
2020/05/25,Castellón,Teruel,87,134137,11527,122610,579962,89702
2020/05/25,Castellón,Valencia,776,2565124,485585,2079539,579962,89702
2020/05/25,Ceuta,Cádiz,44,1240155,206618,1033537,84777,12680
2020/05/25,Ceuta,Ceuta,12133,84777,12719,72058,84777,12680
2020/05/25,Ciudad Real,Albacete,467,388167,42857,345310,495761,49221
2020/05/25,Ciudad Real,Ciudad Real,32366,495761,53802,441959,495761,49221
2020/05/25,Ciudad Real,Cuenca,57,196329,23547,172782,495761,49221
2020/05/25,Ciudad Real,Toledo,441,694844,100290,594554,495761,49221
2020/05/25,Ciudad Real,Córdoba,355,782979,123909,659070,495761,49221
2020/05/25,Ciudad Real,Badajoz,64,673559,98406,575153,495761,49221
2020/05/25,Córdoba,Jaén,730,633564,80185,553379,782979,118833
2020/05/25,Córdoba,Badajoz,72,673559,98406,575153,782979,118833
2020/05/25,Córdoba,Málaga,190,1661785,263580,1398205,782979,118833
2020/05/25,Córdoba,Córdoba,86613,782979,123909,659070,782979,118833
2020/05/25,Córdoba,Granada,171,914678,144693,769985,782979,118833
2020/05/25,Córdoba,Ciudad Real,323,495761,53802,441959,782979,118833
2020/05/25,Córdoba,Sevilla,1981,1942389,343976,1598413,782979,118833
2020/05/25,Coruña,Coruña,162044,1119596,210582,909014,1119596,210286
2020/05/25,Coruña,Lugo,660,329587,51318,278269,1119596,210286
2020/05/25,Coruña,Pontevedra,5815,942665,185262,757403,1119596,210286
2020/05/25,Cuenca,Valencia,87,2565124,485585,2079539,196329,24981
2020/05/25,Cuenca,Madrid,54,6663394,1142033,5521361,196329,24981
2020/05/25,Cuenca,Albacete,752,388167,42857,345310,196329,24981
2020/05/25,Cuenca,Toledo,215,694844,100290,594554,196329,24981
2020/05/25,Cuenca,Ciudad Real,119,495761,53802,441959,196329,24981
2020/05/25,Cuenca,Cuenca,13169,196329,23547,172782,196329,24981
2020/05/25,Cuenca,Guadalajara,37,257762,41727,216035,196329,24981
2020/05/25,Gipuzkoa,Araba,292,331549,64454,267095,723576,126863
2020/05/25,Gipuzkoa,Gipuzkoa,93087,723576,120253,603323,723576,126863
2020/05/25,Gipuzkoa,Navarra,447,654183,116553,537630,723576,126863
2020/05/25,Gipuzkoa,Bizkaia,1873,1152934,241435,911499,723576,126863
2020/05/25,Girona,Barcelona,2863,5664579,1024747,4639832,771044,111690
2020/05/25,Girona,Tarragona,17,804664,120530,684134,771044,111690
2020/05/25,Girona,Lleida,191,434930,69457,365473,771044,111690
2020/05/25,Girona,Girona,71893,771044,107161,663883,771044,111690
2020/05/25,Granada,Jaén,338,633564,80185,553379,914678,141282
2020/05/25,Granada,Granada,104653,914678,144693,769985,914678,141282
2020/05/25,Granada,Málaga,242,1661785,263580,1398205,914678,141282
2020/05/25,Granada,Córdoba,265,782979,123909,659070,914678,141282
2020/05/25,Granada,Almería,550,716820,105354,611466,914678,141282
2020/05/25,Granada,Murcia,83,1493898,252229,1241669,914678,141282
2020/05/25,Guadalajara,Guadalajara,24704,257762,41727,216035,257762,44768
2020/05/25,Guadalajara,Madrid,2462,6663394,1142033,5521361,257762,44768
2020/05/25,Guadalajara,Teruel,30,134137,11527,122610,257762,44768
2020/05/25,Guadalajara,Cuenca,46,196329,23547,172782,257762,44768
2020/05/25,Huelva,Huelva,66515,521870,84547,437323,521870,88171
2020/05/25,Huelva,Badajoz,390,673559,98406,575153,521870,88171
2020/05/25,Huelva,Sevilla,1417,1942389,343976,1598413,521870,88171
2020/05/25,Huelva,Cádiz,705,1240155,206618,1033537,521870,88171
2020/05/25,Huesca,Zaragoza,377,964724,178086,786638,220461,34880
2020/05/25,Huesca,Lleida,1188,434930,69457,365473,220461,34880
2020/05/25,Huesca,Huesca,21301,220461,31295,189166,220461,34880
2020/05/25,Jaén,Granada,421,914678,144693,769985,633564,76894
2020/05/25,Jaén,Albacete,28,388167,42857,345310,633564,76894
2020/05/25,Jaén,Córdoba,878,782979,123909,659070,633564,76894
2020/05/25,Jaén,Murcia,16,1493898,252229,1241669,633564,76894
2020/05/25,Jaén,Jaén,55495,633564,80185,553379,633564,76894
2020/05/25,Las Palmas de Gran Canaria,Las Palmas de Gran Canaria,186753,1120406,198713,921693,1120406,198604
2020/05/25,Las Palmas de Gran Canaria,Santa Cruz de Tenerife,16,1032983,175247,857736,1120406,198604
2020/05/25,León,Ourense,306,307651,57318,250333,460001,75805
2020/05/25,León,León,57183,460001,76328,383673,460001,75805
2020/05/25,León,Lugo,57,329587,51318,278269,460001,75805
2020/05/25,León,Asturias,42,1022800,183309,839491,460001,75805
2020/05/25,León,Palencia,64,160866,25320,135546,460001,75805
2020/05/25,León,Valladolid,74,519546,93092,426454,460001,75805
2020/05/25,León,Zamora,187,172539,24621,147918,460001,75805
2020/05/25,Lleida,Barcelona,327,5664579,1024747,4639832,434930,67442
2020/05/25,Lleida,Tarragona,49,804664,120530,684134,434930,67442
2020/05/25,Lleida,Zaragoza,183,964724,178086,786638,434930,67442
2020/05/25,Lleida,Lleida,45031,434930,69457,365473,434930,67442
2020/05/25,Lleida,Huesca,981,220461,31295,189166,434930,67442
2020/05/25,Lleida,Girona,205,771044,107161,663883,434930,67442
2020/05/25,Lugo,Lugo,36209,329587,51318,278269,329587,52288
2020/05/25,Lugo,Ourense,272,307651,57318,250333,329587,52288
2020/05/25,Lugo,Asturias,863,1022800,183309,839491,329587,52288
2020/05/25,Lugo,Coruña,608,1119596,210582,909014,329587,52288
2020/05/25,Madrid,Cuenca,64,196329,23547,172782,6663394,1149304
2020/05/25,Madrid,Guadalajara,3361,257762,41727,216035,6663394,1149304
2020/05/25,Madrid,Toledo,4115,694844,100290,594554,6663394,1149304
2020/05/25,Madrid,Ávila,233,157640,20304,137336,6663394,1149304
2020/05/25,Madrid,Segovia,52,153129,21937,131192,6663394,1149304
2020/05/25,Madrid,Madrid,666393,6663394,1142033,5521361,6663394,1149304
2020/05/25,Málaga,Málaga,219850,1661785,263580,1398205,1661785,272263
2020/05/25,Málaga,Sevilla,362,1942389,343976,1598413,1661785,272263
2020/05/25,Málaga,Granada,285,914678,144693,769985,1661785,272263
2020/05/25,Málaga,Cádiz,1408,1240155,206618,1033537,1661785,272263
2020/05/25,Málaga,Córdoba,543,782979,123909,659070,1661785,272263
2020/05/25,Melilla,Melilla,13657,86487,13757,72730,86487,13926
2020/05/25,Melilla,Almería,18,716820,105354,611466,86487,13926
2020/05/25,Murcia,Albacete,643,388167,42857,345310,1493898,246998
2020/05/25,Murcia,Alicante,2983,1858683,303732,1554951,1493898,246998
2020/05/25,Murcia,Murcia,197595,1493898,252229,1241669,1493898,246998
2020/05/25,Murcia,Granada,36,914678,144693,769985,1493898,246998
2020/05/25,Murcia,Almería,1334,716820,105354,611466,1493898,246998
2020/05/25,Navarra,Alicante,16,1858683,303732,1554951,654183,119073
2020/05/25,Navarra,Zaragoza,657,964724,178086,786638,654183,119073
2020/05/25,Navarra,Gipuzkoa,376,723576,120253,603323,654183,119073
2020/05/25,Navarra,Araba,119,331549,64454,267095,654183,119073
2020/05/25,Navarra,Rioja,2786,316798,55338,261460,654183,119073
2020/05/25,Navarra,Navarra,86071,654183,116553,537630,654183,119073
2020/05/25,Ourense,Lugo,185,329587,51318,278269,307651,57478
2020/05/25,Ourense,Zamora,31,172539,24621,147918,307651,57478
2020/05/25,Ourense,Ourense,44169,307651,57318,250333,307651,57478
2020/05/25,Ourense,León,333,460001,76328,383673,307651,57478
2020/05/25,Ourense,Pontevedra,220,942665,185262,757403,307651,57478
2020/05/25,Palencia,Burgos,268,357072,52928,304144,160866,27146
2020/05/25,Palencia,Valladolid,256,519546,93092,426454,160866,27146
2020/05/25,Palencia,Cantabria,169,580795,106377,474418,160866,27146
2020/05/25,Palencia,León,30,460001,76328,383673,160866,27146
2020/05/25,Palencia,Palencia,18563,160866,25320,135546,160866,27146
2020/05/25,Pontevedra,Lugo,53,329587,51318,278269,942665,182413
2020/05/25,Pontevedra,Ourense,233,307651,57318,250333,942665,182413
2020/05/25,Pontevedra,Coruña,4258,1119596,210582,909014,942665,182413
2020/05/25,Pontevedra,Pontevedra,145126,942665,185262,757403,942665,182413
2020/05/25,Rioja,Burgos,82,357072,52928,304144,316798,52789
2020/05/25,Rioja,Rioja,40857,316798,55338,261460,316798,52789
2020/05/25,Rioja,Araba,866,331549,64454,267095,316798,52789
2020/05/25,Rioja,Navarra,1961,654183,116553,537630,316798,52789
2020/05/25,Salamanca,Salamanca,41766,330119,52995,277124,330119,52601
2020/05/25,Salamanca,Ávila,192,157640,20304,137336,330119,52601
2020/05/25,Salamanca,Cáceres,38,394151,52919,341232,330119,52601
2020/05/25,Salamanca,Zamora,90,172539,24621,147918,330119,52601
2020/05/25,Santa Cruz de Tenerife,Las Palmas de Gran Canaria,94,1120406,198713,921693,1032983,174688
2020/05/25,Santa Cruz de Tenerife,Santa Cruz de Tenerife,160448,1032983,175247,857736,1032983,174688
2020/05/25,Segovia,Soria,27,88636,9156,79480,153129,24112
2020/05/25,Segovia,Burgos,146,357072,52928,304144,153129,24112
2020/05/25,Segovia,Madrid,23,6663394,1142033,5521361,153129,24112
2020/05/25,Segovia,Ávila,92,157640,20304,137336,153129,24112
2020/05/25,Segovia,Valladolid,320,519546,93092,426454,153129,24112
2020/05/25,Segovia,Segovia,14472,153129,21937,131192,153129,24112
2020/05/25,Sevilla,Cádiz,1114,1240155,206618,1033537,1942389,336207
2020/05/25,Sevilla,Málaga,157,1661785,263580,1398205,1942389,336207
2020/05/25,Sevilla,Huelva,565,521870,84547,437323,1942389,336207
2020/05/25,Sevilla,Sevilla,246588,1942389,343976,1598413,1942389,336207
2020/05/25,Sevilla,Badajoz,25,673559,98406,575153,1942389,336207
2020/05/25,Sevilla,Córdoba,2168,782979,123909,659070,1942389,336207
2020/05/25,Soria,Segovia,21,153129,21937,131192,88636,10889
2020/05/25,Soria,Zaragoza,128,964724,178086,786638,88636,10889
2020/05/25,Soria,Soria,7188,88636,9156,79480,88636,10889
2020/05/25,Soria,Valladolid,39,519546,93092,426454,88636,10889
2020/05/25,Soria,Navarra,24,654183,116553,537630,88636,10889
2020/05/25,Tarragona,Teruel,22,134137,11527,122610,804664,120334
2020/05/25,Tarragona,Lleida,25,434930,69457,365473,804664,120334
2020/05/25,Tarragona,Barcelona,1248,5664579,1024747,4639832,804664,120334
2020/05/25,Tarragona,Tarragona,80659,804664,120530,684134,804664,120334
2020/05/25,Tarragona,Castellón,782,579962,84688,495274,804664,120334
2020/05/25,Teruel,Castellón,52,579962,84688,495274,134137,13847
2020/05/25,Teruel,Valencia,20,2565124,485585,2079539,134137,13847
2020/05/25,Teruel,Zaragoza,222,964724,178086,786638,134137,13847
2020/05/25,Teruel,Guadalajara,24,257762,41727,216035,134137,13847
2020/05/25,Teruel,Tarragona,88,804664,120530,684134,134137,13847
2020/05/25,Teruel,Teruel,7093,134137,11527,122610,134137,13847
2020/05/25,Toledo,Cuenca,78,196329,23547,172782,694844,95369
2020/05/25,Toledo,Ávila,227,157640,20304,137336,694844,95369
2020/05/25,Toledo,Madrid,3893,6663394,1142033,5521361,694844,95369
2020/05/25,Toledo,Cáceres,294,394151,52919,341232,694844,95369
2020/05/25,Toledo,Toledo,48626,694844,100290,594554,694844,95369
2020/05/25,Toledo,Ciudad Real,336,495761,53802,441959,694844,95369
2020/05/25,Valencia,Alicante,1315,1858683,303732,1554951,2565124,472447
2020/05/25,Valencia,Cuenca,130,196329,23547,172782,2565124,472447
2020/05/25,Valencia,Valencia,343084,2565124,485585,2079539,2565124,472447
2020/05/25,Valencia,Castellón,586,579962,84688,495274,2565124,472447
2020/05/25,Valencia,Albacete,337,388167,42857,345310,2565124,472447
2020/05/25,Valencia,Cáceres,17,394151,52919,341232,2565124,472447
2020/05/25,Valladolid,Zamora,157,172539,24621,147918,519546,90010
2020/05/25,Valladolid,Valladolid,68015,519546,93092,426454,519546,90010
2020/05/25,Valladolid,Ávila,74,157640,20304,137336,519546,90010
2020/05/25,Valladolid,Palencia,115,160866,25320,135546,519546,90010
2020/05/25,Valladolid,Segovia,269,153129,21937,131192,519546,90010
2020/05/25,Valladolid,León,53,460001,76328,383673,519546,90010
2020/05/25,Valladolid,Burgos,94,357072,52928,304144,519546,90010
2020/05/25,Zamora,Ourense,55,307651,57318,250333,172539,24938
2020/05/25,Zamora,Valladolid,116,519546,93092,426454,172539,24938
2020/05/25,Zamora,León,97,460001,76328,383673,172539,24938
2020/05/25,Zamora,Zamora,17295,172539,24621,147918,172539,24938
2020/05/25,Zamora,Salamanca,16,330119,52995,277124,172539,24938
2020/05/25,Zaragoza,Lleida,96,434930,69457,365473,964724,174119
2020/05/25,Zaragoza,Teruel,164,134137,11527,122610,964724,174119
2020/05/25,Zaragoza,Huesca,439,220461,31295,189166,964724,174119
2020/05/25,Zaragoza,Navarra,533,654183,116553,537630,964724,174119
2020/05/25,Zaragoza,Soria,66,88636,9156,79480,964724,174119
2020/05/25,Zaragoza,Zaragoza,136921,964724,178086,786638,964724,174119
2020/05/26,Albacete,Cuenca,861,196329,23542,172787,388167,44120
2020/05/26,Albacete,Ciudad Real,601,495761,51745,444016,388167,44120
2020/05/26,Albacete,Albacete,28166,388167,43210,344957,388167,44120
2020/05/26,Albacete,Granada,31,914678,148100,766578,388167,44120
2020/05/26,Albacete,Valencia,402,2565124,501830,2063294,388167,44120
2020/05/26,Albacete,Jaén,35,633564,78460,555104,388167,44120
2020/05/26,Albacete,Murcia,705,1493898,260496,1233402,388167,44120
2020/05/26,Albacete,Alicante,283,1858683,313322,1545361,388167,44120
2020/05/26,Alicante,Alicante,245566,1858683,313322,1545361,1858683,317954
2020/05/26,Alicante,Albacete,365,388167,43210,344957,1858683,317954
2020/05/26,Alicante,Valencia,1351,2565124,501830,2063294,1858683,317954
2020/05/26,Alicante,Murcia,3464,1493898,260496,1233402,1858683,317954
2020/05/26,Almería,Murcia,2064,1493898,260496,1233402,716820,110508
2020/05/26,Almería,Granada,570,914678,148100,766578,716820,110508
2020/05/26,Almería,Almería,90940,716820,109249,607571,716820,110508
2020/05/26,Araba,Cantabria,19,580795,110324,470471,331549,76682
2020/05/26,Araba,Gipuzkoa,365,723576,130280,593296,331549,76682
2020/05/26,Araba,Bizkaia,2054,1152934,261858,891076,331549,76682
2020/05/26,Araba,Araba,55913,331549,67678,263871,331549,76682
2020/05/26,Araba,Navarra,230,654183,119409,534774,331549,76682
2020/05/26,Araba,Rioja,2563,316798,55474,261324,331549,76682
2020/05/26,Araba,Burgos,2272,357072,54661,302411,331549,76682
2020/05/26,Asturias,Cantabria,310,580795,110324,470471,1022800,191532
2020/05/26,Asturias,León,38,460001,77673,382328,1022800,191532
2020/05/26,Asturias,Asturias,159935,1022800,192304,830496,1022800,191532
2020/05/26,Asturias,Lugo,1066,329587,51593,277994,1022800,191532
2020/05/26,Ávila,Salamanca,328,330119,55044,275075,157640,22416
2020/05/26,Ávila,Madrid,175,6663394,1237073,5426321,157640,22416
2020/05/26,Ávila,Cáceres,107,394151,51640,342511,157640,22416
2020/05/26,Ávila,Toledo,248,694844,100897,593947,157640,22416
2020/05/26,Ávila,Segovia,95,153129,23179,129950,157640,22416
2020/05/26,Ávila,Ávila,14045,157640,21113,136527,157640,22416
2020/05/26,Badajoz,Huelva,242,521870,86300,435570,673559,98888
2020/05/26,Badajoz,Badajoz,74837,673559,100052,573507,673559,98888
2020/05/26,Badajoz,Córdoba,49,782979,126798,656181,673559,98888
2020/05/26,Badajoz,Ciudad Real,39,495761,51745,444016,673559,98888
2020/05/26,Badajoz,Sevilla,58,1942389,358137,1584252,673559,98888
2020/05/26,Badajoz,Cáceres,1237,394151,51640,342511,673559,98888
2020/05/26,Balears,Valencia,29,2565124,501830,2063294,1149460,194289
2020/05/26,Balears,Barcelona,24,5664579,1120845,4543734,1149460,194289
2020/05/26,Balears,Balears,173578,1149460,193365,956095,1149460,194289
2020/05/26,Barcelona,Huesca,18,220461,31744,188717,5664579,1118642
2020/05/26,Barcelona,Lleida,228,434930,72158,362772,5664579,1118642
2020/05/26,Barcelona,Barcelona,732733,5664579,1120845,4543734,5664579,1118642
2020/05/26,Barcelona,Tarragona,2516,804664,129719,674945,5664579,1118642
2020/05/26,Barcelona,Girona,3296,771044,111455,659589,5664579,1118642
2020/05/26,Bizkaia,Burgos,105,357072,54661,302411,1152934,256091
2020/05/26,Bizkaia,Gipuzkoa,1379,723576,130280,593296,1152934,256091
2020/05/26,Bizkaia,Bizkaia,206402,1152934,261858,891076,1152934,256091
2020/05/26,Bizkaia,Araba,1064,331549,67678,263871,1152934,256091
2020/05/26,Bizkaia,Cantabria,3290,580795,110324,470471,1152934,256091
2020/05/26,Burgos,Burgos,41218,357072,54661,302411,357072,55822
2020/05/26,Burgos,Araba,1326,331549,67678,263871,357072,55822
2020/05/26,Burgos,Segovia,51,153129,23179,129950,357072,55822
2020/05/26,Burgos,Palencia,206,160866,26344,134522,357072,55822
2020/05/26,Burgos,Bizkaia,189,1152934,261858,891076,357072,55822
2020/05/26,Burgos,Valladolid,125,519546,99762,419784,357072,55822
2020/05/26,Burgos,Cantabria,33,580795,110324,470471,357072,55822
2020/05/26,Burgos,Rioja,106,316798,55474,261324,357072,55822
2020/05/26,Cáceres,Badajoz,1303,673559,100052,573507,394151,52061
2020/05/26,Cáceres,Toledo,205,694844,100897,593947,394151,52061
2020/05/26,Cáceres,Cáceres,35923,394151,51640,342511,394151,52061
2020/05/26,Cáceres,Salamanca,46,330119,55044,275075,394151,52061
2020/05/26,Cáceres,Ávila,141,157640,21113,136527,394151,52061
2020/05/26,Cádiz,Ceuta,41,84777,13328,71449,1240155,215171
2020/05/26,Cádiz,Sevilla,1432,1942389,358137,1584252,1240155,215171
2020/05/26,Cádiz,Málaga,1471,1661785,272210,1389575,1240155,215171
2020/05/26,Cádiz,Cádiz,179185,1240155,211295,1028860,1240155,215171
2020/05/26,Cádiz,Córdoba,16,782979,126798,656181,1240155,215171
2020/05/26,Cádiz,Huelva,793,521870,86300,435570,1240155,215171
2020/05/26,Cantabria,Cantabria,82743,580795,110324,470471,580795,105124
2020/05/26,Cantabria,Bizkaia,1311,1152934,261858,891076,580795,105124
2020/05/26,Cantabria,Palencia,54,160866,26344,134522,580795,105124
2020/05/26,Cantabria,Burgos,21,357072,54661,302411,580795,105124
2020/05/26,Cantabria,Asturias,205,1022800,192304,830496,580795,105124
2020/05/26,Castellón,Castellón,66953,579962,87427,492535,579962,92860
2020/05/26,Castellón,Valencia,955,2565124,501830,2063294,579962,92860
2020/05/26,Castellón,Tarragona,934,804664,129719,674945,579962,92860
2020/05/26,Castellón,Teruel,77,134137,11649,122488,579962,92860
2020/05/26,Ceuta,Cádiz,58,1240155,211295,1028860,84777,13291
2020/05/26,Ceuta,Ceuta,12777,84777,13328,71449,84777,13291
2020/05/26,Ciudad Real,Ciudad Real,31900,495761,51745,444016,495761,48450
2020/05/26,Ciudad Real,Toledo,410,694844,100897,593947,495761,48450
2020/05/26,Ciudad Real,Badajoz,52,673559,100052,573507,495761,48450
2020/05/26,Ciudad Real,Albacete,427,388167,43210,344957,495761,48450
2020/05/26,Ciudad Real,Cuenca,84,196329,23542,172787,495761,48450
2020/05/26,Ciudad Real,Córdoba,384,782979,126798,656181,495761,48450
2020/05/26,Córdoba,Sevilla,1930,1942389,358137,1584252,782979,123779
2020/05/26,Córdoba,Granada,161,914678,148100,766578,782979,123779
2020/05/26,Córdoba,Córdoba,92273,782979,126798,656181,782979,123779
2020/05/26,Córdoba,Jaén,786,633564,78460,555104,782979,123779
2020/05/26,Córdoba,Ciudad Real,293,495761,51745,444016,782979,123779
2020/05/26,Córdoba,Málaga,274,1661785,272210,1389575,782979,123779
2020/05/26,Córdoba,Badajoz,178,673559,100052,573507,782979,123779
2020/05/26,Coruña,Lugo,710,329587,51593,277994,1119596,216873
2020/05/26,Coruña,Pontevedra,6005,942665,191939,750726,1119596,216873
2020/05/26,Coruña,Coruña,167707,1119596,214777,904819,1119596,216873
2020/05/26,Cuenca,Albacete,846,388167,43210,344957,196329,24454
2020/05/26,Cuenca,Toledo,115,694844,100897,593947,196329,24454
2020/05/26,Cuenca,Ciudad Real,132,495761,51745,444016,196329,24454
2020/05/26,Cuenca,Guadalajara,48,257762,43102,214660,196329,24454
2020/05/26,Cuenca,Cuenca,12899,196329,23542,172787,196329,24454
2020/05/26,Cuenca,Madrid,99,6663394,1237073,5426321,196329,24454
2020/05/26,Cuenca,Valencia,181,2565124,501830,2063294,196329,24454
2020/05/26,Gipuzkoa,Bizkaia,2166,1152934,261858,891076,723576,136677
2020/05/26,Gipuzkoa,Navarra,491,654183,119409,534774,723576,136677
2020/05/26,Gipuzkoa,Araba,363,331549,67678,263871,723576,136677
2020/05/26,Gipuzkoa,Gipuzkoa,102750,723576,130280,593296,723576,136677
2020/05/26,Girona,Lleida,256,434930,72158,362772,771044,119513
2020/05/26,Girona,Tarragona,27,804664,129719,674945,771044,119513
2020/05/26,Girona,Murcia,16,1493898,260496,1233402,771044,119513
2020/05/26,Girona,Barcelona,3064,5664579,1120845,4543734,771044,119513
2020/05/26,Girona,Girona,76560,771044,111455,659589,771044,119513
2020/05/26,Granada,Málaga,206,1661785,272210,1389575,914678,145251
2020/05/26,Granada,Jaén,404,633564,78460,555104,914678,145251
2020/05/26,Granada,Granada,110179,914678,148100,766578,914678,145251
2020/05/26,Granada,Murcia,143,1493898,260496,1233402,914678,145251
2020/05/26,Granada,Córdoba,182,782979,126798,656181,914678,145251
2020/05/26,Granada,Almería,521,716820,109249,607571,914678,145251
2020/05/26,Guadalajara,Madrid,3100,6663394,1237073,5426321,257762,45924
2020/05/26,Guadalajara,Guadalajara,25220,257762,43102,214660,257762,45924
2020/05/26,Guadalajara,Zaragoza,25,964724,186468,778256,257762,45924
2020/05/26,Guadalajara,Cuenca,72,196329,23542,172787,257762,45924
2020/05/26,Huelva,Huelva,68651,521870,86300,435570,521870,90190
2020/05/26,Huelva,Cádiz,614,1240155,211295,1028860,521870,90190
2020/05/26,Huelva,Córdoba,16,782979,126798,656181,521870,90190
2020/05/26,Huelva,Badajoz,413,673559,100052,573507,521870,90190
2020/05/26,Huelva,Sevilla,1419,1942389,358137,1584252,521870,90190
2020/05/26,Huesca,Lleida,1304,434930,72158,362772,220461,35469
2020/05/26,Huesca,Zaragoza,350,964724,186468,778256,220461,35469
2020/05/26,Huesca,Huesca,22037,220461,31744,188717,220461,35469
2020/05/26,Jaén,Albacete,16,388167,43210,344957,633564,77131
2020/05/26,Jaén,Granada,363,914678,148100,766578,633564,77131
2020/05/26,Jaén,Jaén,55030,633564,78460,555104,633564,77131
2020/05/26,Jaén,Córdoba,924,782979,126798,656181,633564,77131
2020/05/26,Las Palmas de Gran Canaria,Santa Cruz de Tenerife,34,1032983,184936,848047,1120406,201907
2020/05/26,Las Palmas de Gran Canaria,Las Palmas de Gran Canaria,189935,1120406,203053,917353,1120406,201907
2020/05/26,León,Zamora,184,172539,25660,146879,460001,77312
2020/05/26,León,Lugo,51,329587,51593,277994,460001,77312
2020/05/26,León,Palencia,29,160866,26344,134522,460001,77312
2020/05/26,León,Asturias,35,1022800,192304,830496,460001,77312
2020/05/26,León,León,59116,460001,77673,382328,460001,77312
2020/05/26,León,Ourense,394,307651,57844,249807,460001,77312
2020/05/26,León,Valladolid,41,519546,99762,419784,460001,77312
2020/05/26,Lleida,Lleida,48020,434930,72158,362772,434930,69947
2020/05/26,Lleida,Barcelona,332,5664579,1120845,4543734,434930,69947
2020/05/26,Lleida,Tarragona,28,804664,129719,674945,434930,69947
2020/05/26,Lleida,Girona,215,771044,111455,659589,434930,69947
2020/05/26,Lleida,Zaragoza,206,964724,186468,778256,434930,69947
2020/05/26,Lleida,Huesca,953,220461,31744,188717,434930,69947
2020/05/26,Lugo,Pontevedra,31,942665,191939,750726,329587,53263
2020/05/26,Lugo,Lugo,37392,329587,51593,277994,329587,53263
2020/05/26,Lugo,Coruña,622,1119596,214777,904819,329587,53263
2020/05/26,Lugo,Asturias,867,1022800,192304,830496,329587,53263
2020/05/26,Lugo,Ourense,266,307651,57844,249807,329587,53263
2020/05/26,Madrid,Guadalajara,3681,257762,43102,214660,6663394,1233389
2020/05/26,Madrid,Ávila,320,157640,21113,136527,6663394,1233389
2020/05/26,Madrid,Cuenca,124,196329,23542,172787,6663394,1233389
2020/05/26,Madrid,Madrid,749977,6663394,1237073,5426321,6663394,1233389
2020/05/26,Madrid,Toledo,4664,694844,100897,593947,6663394,1233389
2020/05/26,Madrid,Segovia,54,153129,23179,129950,6663394,1233389
2020/05/26,Málaga,Málaga,229163,1661785,272210,1389575,1661785,276991
2020/05/26,Málaga,Cádiz,1373,1240155,211295,1028860,1661785,276991
2020/05/26,Málaga,Sevilla,447,1942389,358137,1584252,1661785,276991
2020/05/26,Málaga,Granada,280,914678,148100,766578,1661785,276991
2020/05/26,Málaga,Córdoba,412,782979,126798,656181,1661785,276991
2020/05/26,Melilla,Melilla,14590,86487,14733,71754,86487,14789
2020/05/26,Murcia,Murcia,206679,1493898,260496,1233402,1493898,255971
2020/05/26,Murcia,Almería,1303,716820,109249,607571,1493898,255971
2020/05/26,Murcia,Granada,19,914678,148100,766578,1493898,255971
2020/05/26,Murcia,Albacete,720,388167,43210,344957,1493898,255971
2020/05/26,Murcia,Alicante,3154,1858683,313322,1545361,1493898,255971
2020/05/26,Navarra,Gipuzkoa,504,723576,130280,593296,654183,121572
2020/05/26,Navarra,Navarra,88371,654183,119409,534774,654183,121572
2020/05/26,Navarra,Rioja,2685,316798,55474,261324,654183,121572
2020/05/26,Navarra,Araba,91,331549,67678,263871,654183,121572
2020/05/26,Navarra,Zaragoza,653,964724,186468,778256,654183,121572
2020/05/26,Ourense,Ourense,45267,307651,57844,249807,307651,58246
2020/05/26,Ourense,Pontevedra,192,942665,191939,750726,307651,58246
2020/05/26,Ourense,Zamora,79,172539,25660,146879,307651,58246
2020/05/26,Ourense,León,284,460001,77673,382328,307651,58246
2020/05/26,Ourense,Lugo,205,329587,51593,277994,307651,58246
2020/05/26,Palencia,León,51,460001,77673,382328,160866,28400
2020/05/26,Palencia,Burgos,250,357072,54661,302411,160866,28400
2020/05/26,Palencia,Palencia,19377,160866,26344,134522,160866,28400
2020/05/26,Palencia,Valladolid,363,519546,99762,419784,160866,28400
2020/05/26,Palencia,Cantabria,184,580795,110324,470471,160866,28400
2020/05/26,Pontevedra,Ourense,247,307651,57844,249807,942665,191263
2020/05/26,Pontevedra,Lugo,26,329587,51593,277994,942665,191263
2020/05/26,Pontevedra,Pontevedra,153313,942665,191939,750726,942665,191263
2020/05/26,Pontevedra,Coruña,4770,1119596,214777,904819,942665,191263
2020/05/26,Rioja,Araba,811,331549,67678,263871,316798,53180
2020/05/26,Rioja,Navarra,2148,654183,119409,534774,316798,53180
2020/05/26,Rioja,Burgos,90,357072,54661,302411,316798,53180
2020/05/26,Rioja,Rioja,40939,316798,55474,261324,316798,53180
2020/05/26,Salamanca,Ávila,212,157640,21113,136527,330119,54530
2020/05/26,Salamanca,Zamora,59,172539,25660,146879,330119,54530
2020/05/26,Salamanca,Salamanca,43726,330119,55044,275075,330119,54530
2020/05/26,Santa Cruz de Tenerife,Santa Cruz de Tenerife,170947,1032983,184936,848047,1032983,184674
2020/05/26,Santa Cruz de Tenerife,Las Palmas de Gran Canaria,104,1120406,203053,917353,1032983,184674
2020/05/26,Segovia,Valladolid,407,519546,99762,419784,153129,25212
2020/05/26,Segovia,Madrid,20,6663394,1237073,5426321,153129,25212
2020/05/26,Segovia,Burgos,119,357072,54661,302411,153129,25212
2020/05/26,Segovia,Ávila,94,157640,21113,136527,153129,25212
2020/05/26,Segovia,Segovia,15736,153129,23179,129950,153129,25212
2020/05/26,Sevilla,Cádiz,976,1240155,211295,1028860,1942389,351289
2020/05/26,Sevilla,Sevilla,264022,1942389,358137,1584252,1942389,351289
2020/05/26,Sevilla,Córdoba,2379,782979,126798,656181,1942389,351289
2020/05/26,Sevilla,Badajoz,46,673559,100052,573507,1942389,351289
2020/05/26,Sevilla,Huelva,788,521870,86300,435570,1942389,351289
2020/05/26,Sevilla,Málaga,192,1661785,272210,1389575,1942389,351289
2020/05/26,Sevilla,Granada,16,914678,148100,766578,1942389,351289
2020/05/26,Soria,Valladolid,36,519546,99762,419784,88636,10807
2020/05/26,Soria,Zaragoza,93,964724,186468,778256,88636,10807
2020/05/26,Soria,Soria,7418,88636,9538,79098,88636,10807
2020/05/26,Soria,Burgos,102,357072,54661,302411,88636,10807
2020/05/26,Soria,Segovia,24,153129,23179,129950,88636,10807
2020/05/26,Tarragona,Barcelona,1515,5664579,1120845,4543734,804664,131077
2020/05/26,Tarragona,Zaragoza,36,964724,186468,778256,804664,131077
2020/05/26,Tarragona,Teruel,34,134137,11649,122488,804664,131077
2020/05/26,Tarragona,Castellón,931,579962,87427,492535,804664,131077
2020/05/26,Tarragona,Lleida,75,434930,72158,362772,804664,131077
2020/05/26,Tarragona,Tarragona,89931,804664,129719,674945,804664,131077
2020/05/26,Teruel,Tarragona,115,804664,129719,674945,134137,13846
2020/05/26,Teruel,Zaragoza,249,964724,186468,778256,134137,13846
2020/05/26,Teruel,Valencia,23,2565124,501830,2063294,134137,13846
2020/05/26,Teruel,Castellón,43,579962,87427,492535,134137,13846
2020/05/26,Teruel,Teruel,7119,134137,11649,122488,134137,13846
2020/05/26,Toledo,Toledo,49366,694844,100897,593947,694844,97636
2020/05/26,Toledo,Ciudad Real,325,495761,51745,444016,694844,97636
2020/05/26,Toledo,Cuenca,143,196329,23542,172787,694844,97636
2020/05/26,Toledo,Ávila,365,157640,21113,136527,694844,97636
2020/05/26,Toledo,Cáceres,187,394151,51640,342511,694844,97636
2020/05/26,Toledo,Madrid,4200,6663394,1237073,5426321,694844,97636
2020/05/26,Valencia,Valencia,361726,2565124,501830,2063294,2565124,488643
2020/05/26,Valencia,Albacete,347,388167,43210,344957,2565124,488643
2020/05/26,Valencia,Cuenca,114,196329,23542,172787,2565124,488643
2020/05/26,Valencia,Alicante,1145,1858683,313322,1545361,2565124,488643
2020/05/26,Valencia,Castellón,618,579962,87427,492535,2565124,488643
2020/05/26,Valladolid,Soria,22,88636,9538,79098,519546,95834
2020/05/26,Valladolid,Burgos,96,357072,54661,302411,519546,95834
2020/05/26,Valladolid,Zamora,123,172539,25660,146879,519546,95834
2020/05/26,Valladolid,Valladolid,74144,519546,99762,419784,519546,95834
2020/05/26,Valladolid,Palencia,54,160866,26344,134522,519546,95834
2020/05/26,Valladolid,Ávila,35,157640,21113,136527,519546,95834
2020/05/26,Valladolid,León,49,460001,77673,382328,519546,95834
2020/05/26,Valladolid,Segovia,378,153129,23179,129950,519546,95834
2020/05/26,Zamora,Zamora,18092,172539,25660,146879,172539,25975
2020/05/26,Zamora,León,103,460001,77673,382328,172539,25975
2020/05/26,Zamora,Valladolid,127,519546,99762,419784,172539,25975
2020/05/26,Zamora,Salamanca,54,330119,55044,275075,172539,25975
2020/05/26,Zamora,Ourense,118,307651,57844,249807,172539,25975
2020/05/26,Zaragoza,Soria,80,88636,9538,79098,964724,179839
2020/05/26,Zaragoza,Teruel,271,134137,11649,122488,964724,179839
2020/05/26,Zaragoza,Zaragoza,145894,964724,186468,778256,964724,179839
2020/05/26,Zaragoza,Lleida,131,434930,72158,362772,964724,179839
2020/05/26,Zaragoza,Huesca,332,220461,31744,188717,964724,179839
2020/05/26,Zaragoza,Navarra,604,654183,119409,534774,964724,179839
2020/05/27,Albacete,Albacete,28777,388167,44096,344071,388167,45679
2020/05/27,Albacete,Ciudad Real,647,495761,54654,441107,388167,45679
2020/05/27,Albacete,Cuenca,774,196329,24444,171885,388167,45679
2020/05/27,Albacete,Granada,33,914678,149767,764911,388167,45679
2020/05/27,Albacete,Alicante,248,1858683,330446,1528237,388167,45679
2020/05/27,Albacete,Jaén,38,633564,79970,553594,388167,45679
2020/05/27,Albacete,Valencia,441,2565124,512847,2052277,388167,45679
2020/05/27,Albacete,Murcia,807,1493898,266742,1227156,388167,45679
2020/05/27,Alicante,Valencia,1543,2565124,512847,2052277,1858683,335496
2020/05/27,Alicante,Albacete,414,388167,44096,344071,1858683,335496
2020/05/27,Alicante,Alicante,261725,1858683,330446,1528237,1858683,335496
2020/05/27,Alicante,Murcia,3530,1493898,266742,1227156,1858683,335496
2020/05/27,Almería,Almería,91749,716820,109756,607064,716820,112286
2020/05/27,Almería,Granada,576,914678,149767,764911,716820,112286
2020/05/27,Almería,Murcia,2171,1493898,266742,1227156,716820,112286
2020/05/27,Araba,Navarra,232,654183,124763,529420,331549,80787
2020/05/27,Araba,Rioja,2570,316798,58934,257864,331549,80787
2020/05/27,Araba,Gipuzkoa,445,723576,137464,586112,331549,80787
2020/05/27,Araba,Araba,59495,331549,71644,259905,331549,80787
2020/05/27,Araba,Cantabria,22,580795,115297,465498,331549,80787
2020/05/27,Araba,Bizkaia,2168,1152934,272571,880363,331549,80787
2020/05/27,Araba,Burgos,2230,357072,55718,301354,331549,80787
2020/05/27,Asturias,Cantabria,284,580795,115297,465498,1022800,197592
2020/05/27,Asturias,Asturias,165596,1022800,198522,824278,1022800,197592
2020/05/27,Asturias,Lugo,1171,329587,52767,276820,1022800,197592
2020/05/27,Asturias,León,39,460001,78788,381213,1022800,197592
2020/05/27,Ávila,Ávila,13640,157640,20666,136974,157640,22123
2020/05/27,Ávila,Madrid,148,6663394,1241264,5422130,157640,22123
2020/05/27,Ávila,Toledo,299,694844,101593,593251,157640,22123
2020/05/27,Ávila,Valladolid,64,519546,99876,419670,157640,22123
2020/05/27,Ávila,Cáceres,132,394151,51816,342335,157640,22123
2020/05/27,Ávila,Salamanca,322,330119,54746,275373,157640,22123
2020/05/27,Ávila,Segovia,82,153129,23204,129925,157640,22123
2020/05/27,Badajoz,Huelva,236,521870,87792,434078,673559,101614
2020/05/27,Badajoz,Sevilla,84,1942389,364217,1578172,673559,101614
2020/05/27,Badajoz,Córdoba,116,782979,131349,651630,673559,101614
2020/05/27,Badajoz,Badajoz,77481,673559,102099,571460,673559,101614
2020/05/27,Badajoz,Ciudad Real,43,495761,54654,441107,673559,101614
2020/05/27,Badajoz,Cáceres,1281,394151,51816,342335,673559,101614
2020/05/27,Balears,Balears,182402,1149460,200763,948697,1149460,201642
2020/05/27,Balears,Valencia,25,2565124,512847,2052277,1149460,201642
2020/05/27,Balears,Barcelona,35,5664579,1127218,4537361,1149460,201642
2020/05/27,Barcelona,Girona,3425,771044,114629,656415,5664579,1124303
2020/05/27,Barcelona,Barcelona,737214,5664579,1127218,4537361,5664579,1124303
2020/05/27,Barcelona,Lleida,271,434930,73470,361460,5664579,1124303
2020/05/27,Barcelona,Tarragona,2403,804664,133059,671605,5664579,1124303
2020/05/27,Bizkaia,Cantabria,3732,580795,115297,465498,1152934,265406
2020/05/27,Bizkaia,Burgos,98,357072,55718,301354,1152934,265406
2020/05/27,Bizkaia,Bizkaia,215069,1152934,272571,880363,1152934,265406
2020/05/27,Bizkaia,Gipuzkoa,1442,723576,137464,586112,1152934,265406
2020/05/27,Bizkaia,Araba,1082,331549,71644,259905,1152934,265406
2020/05/27,Burgos,Burgos,42139,357072,55718,301354,357072,57029
2020/05/27,Burgos,Valladolid,153,519546,99876,419670,357072,57029
2020/05/27,Burgos,Segovia,53,153129,23204,129925,357072,57029
2020/05/27,Burgos,Araba,1483,331549,71644,259905,357072,57029
2020/05/27,Burgos,Bizkaia,190,1152934,272571,880363,357072,57029
2020/05/27,Burgos,Soria,88,88636,10211,78425,357072,57029
2020/05/27,Burgos,Cantabria,28,580795,115297,465498,357072,57029
2020/05/27,Burgos,Palencia,271,160866,26421,134445,357072,57029
2020/05/27,Burgos,Rioja,110,316798,58934,257864,357072,57029
2020/05/27,Cáceres,Badajoz,1346,673559,102099,571460,394151,52038
2020/05/27,Cáceres,Toledo,171,694844,101593,593251,394151,52038
2020/05/27,Cáceres,Ávila,128,157640,20666,136974,394151,52038
2020/05/27,Cáceres,Cáceres,36132,394151,51816,342335,394151,52038
2020/05/27,Cádiz,Cádiz,178337,1240155,211048,1029107,1240155,214660
2020/05/27,Cádiz,Ceuta,59,84777,12650,72127,1240155,214660
2020/05/27,Cádiz,Sevilla,1344,1942389,364217,1578172,1240155,214660
2020/05/27,Cádiz,Málaga,1549,1661785,279551,1382234,1240155,214660
2020/05/27,Cádiz,Huelva,729,521870,87792,434078,1240155,214660
2020/05/27,Cantabria,Palencia,71,160866,26421,134445,580795,110238
2020/05/27,Cantabria,Burgos,18,357072,55718,301354,580795,110238
2020/05/27,Cantabria,Bizkaia,1807,1152934,272571,880363,580795,110238
2020/05/27,Cantabria,Asturias,200,1022800,198522,824278,580795,110238
2020/05/27,Cantabria,Cantabria,87195,580795,115297,465498,580795,110238
2020/05/27,Castellón,Teruel,145,134137,12564,121573,579962,96920
2020/05/27,Castellón,Tarragona,942,804664,133059,671605,579962,96920
2020/05/27,Castellón,Castellón,70323,579962,91399,488563,579962,96920
2020/05/27,Castellón,Valencia,884,2565124,512847,2052277,579962,96920
2020/05/27,Ceuta,Cádiz,98,1240155,211048,1029107,84777,12621
2020/05/27,Ceuta,Ceuta,12029,84777,12650,72127,84777,12621
2020/05/27,Ciudad Real,Albacete,435,388167,44096,344071,495761,51227
2020/05/27,Ciudad Real,Córdoba,453,782979,131349,651630,495761,51227
2020/05/27,Ciudad Real,Ciudad Real,34482,495761,54654,441107,495761,51227
2020/05/27,Ciudad Real,Cuenca,28,196329,24444,171885,495761,51227
2020/05/27,Ciudad Real,Badajoz,59,673559,102099,571460,495761,51227
2020/05/27,Ciudad Real,Toledo,360,694844,101593,593251,495761,51227
2020/05/27,Córdoba,Jaén,785,633564,79970,553594,782979,128569
2020/05/27,Córdoba,Málaga,603,1661785,279551,1382234,782979,128569
2020/05/27,Córdoba,Córdoba,96534,782979,131349,651630,782979,128569
2020/05/27,Córdoba,Ciudad Real,370,495761,54654,441107,782979,128569
2020/05/27,Córdoba,Sevilla,2044,1942389,364217,1578172,782979,128569
2020/05/27,Córdoba,Badajoz,83,673559,102099,571460,782979,128569
2020/05/27,Córdoba,Granada,199,914678,149767,764911,782979,128569
2020/05/27,Coruña,Coruña,174823,1119596,222463,897133,1119596,224933
2020/05/27,Coruña,Lugo,704,329587,52767,276820,1119596,224933
2020/05/27,Coruña,Pontevedra,6083,942665,196585,746080,1119596,224933
2020/05/27,Cuenca,Albacete,859,388167,44096,344071,196329,25672
2020/05/27,Cuenca,Guadalajara,82,257762,44196,213566,196329,25672
2020/05/27,Cuenca,Toledo,161,694844,101593,593251,196329,25672
2020/05/27,Cuenca,Madrid,72,6663394,1241264,5422130,196329,25672
2020/05/27,Cuenca,Valencia,138,2565124,512847,2052277,196329,25672
2020/05/27,Cuenca,Ciudad Real,159,495761,54654,441107,196329,25672
2020/05/27,Cuenca,Cuenca,13619,196329,24444,171885,196329,25672
2020/05/27,Gipuzkoa,Navarra,479,654183,124763,529420,723576,143671
2020/05/27,Gipuzkoa,Araba,323,331549,71644,259905,723576,143671
2020/05/27,Gipuzkoa,Bizkaia,2675,1152934,272571,880363,723576,143671
2020/05/27,Gipuzkoa,Gipuzkoa,109110,723576,137464,586112,723576,143671
2020/05/27,Girona,Barcelona,3337,5664579,1127218,4537361,771044,122310
2020/05/27,Girona,Lleida,249,434930,73470,361460,771044,122310
2020/05/27,Girona,Girona,79143,771044,114629,656415,771044,122310
2020/05/27,Granada,Córdoba,234,782979,131349,651630,914678,147533
2020/05/27,Granada,Murcia,76,1493898,266742,1227156,914678,147533
2020/05/27,Granada,Málaga,191,1661785,279551,1382234,914678,147533
2020/05/27,Granada,Granada,111253,914678,149767,764911,914678,147533
2020/05/27,Granada,Almería,672,716820,109756,607064,914678,147533
2020/05/27,Granada,Jaén,364,633564,79970,553594,914678,147533
2020/05/27,Guadalajara,Cuenca,72,196329,24444,171885,257762,47667
2020/05/27,Guadalajara,Teruel,30,134137,12564,121573,257762,47667
2020/05/27,Guadalajara,Madrid,3151,6663394,1241264,5422130,257762,47667
2020/05/27,Guadalajara,Toledo,18,694844,101593,593251,257762,47667
2020/05/27,Guadalajara,Guadalajara,26173,257762,44196,213566,257762,47667
2020/05/27,Huelva,Huelva,70394,521870,87792,434078,521870,91827
2020/05/27,Huelva,Cádiz,661,1240155,211048,1029107,521870,91827
2020/05/27,Huelva,Sevilla,1591,1942389,364217,1578172,521870,91827
2020/05/27,Huelva,Badajoz,380,673559,102099,571460,521870,91827
2020/05/27,Huesca,Lleida,1283,434930,73470,361460,220461,36363
2020/05/27,Huesca,Huesca,22464,220461,32453,188008,220461,36363
2020/05/27,Huesca,Zaragoza,383,964724,197429,767295,220461,36363
2020/05/27,Jaén,Jaén,56607,633564,79970,553594,633564,78826
2020/05/27,Jaén,Córdoba,868,782979,131349,651630,633564,78826
2020/05/27,Jaén,Albacete,30,388167,44096,344071,633564,78826
2020/05/27,Jaén,Granada,317,914678,149767,764911,633564,78826
2020/05/27,Las Palmas de Gran Canaria,Las Palmas de Gran Canaria,197101,1120406,209369,911037,1120406,208508
2020/05/27,Las Palmas de Gran Canaria,Santa Cruz de Tenerife,37,1032983,190608,842375,1120406,208508
2020/05/27,León,Asturias,47,1022800,198522,824278,460001,79067
2020/05/27,León,León,60484,460001,78788,381213,460001,79067
2020/05/27,León,Zamora,213,172539,25455,147084,460001,79067
2020/05/27,León,Palencia,65,160866,26421,134445,460001,79067
2020/05/27,León,Lugo,39,329587,52767,276820,460001,79067
2020/05/27,León,Valladolid,23,519546,99876,419670,460001,79067
2020/05/27,León,Ourense,391,307651,59040,248611,460001,79067
2020/05/27,Lleida,Zaragoza,215,964724,197429,767295,434930,71704
2020/05/27,Lleida,Huesca,926,220461,32453,188008,434930,71704
2020/05/27,Lleida,Tarragona,27,804664,133059,671605,434930,71704
2020/05/27,Lleida,Lleida,49071,434930,73470,361460,434930,71704
2020/05/27,Lleida,Barcelona,325,5664579,1127218,4537361,434930,71704
2020/05/27,Lleida,Girona,210,771044,114629,656415,434930,71704
2020/05/27,Lugo,Pontevedra,27,942665,196585,746080,329587,54396
2020/05/27,Lugo,Coruña,631,1119596,222463,897133,329587,54396
2020/05/27,Lugo,Asturias,825,1022800,198522,824278,329587,54396
2020/05/27,Lugo,Lugo,38226,329587,52767,276820,329587,54396
2020/05/27,Lugo,Ourense,238,307651,59040,248611,329587,54396
2020/05/27,Madrid,Cuenca,107,196329,24444,171885,6663394,1237468
2020/05/27,Madrid,Madrid,749310,6663394,1241264,5422130,6663394,1237468
2020/05/27,Madrid,Guadalajara,3649,257762,44196,213566,6663394,1237468
2020/05/27,Madrid,Ávila,260,157640,20666,136974,6663394,1237468
2020/05/27,Madrid,Segovia,55,153129,23204,129925,6663394,1237468
2020/05/27,Madrid,Toledo,4826,694844,101593,593251,6663394,1237468
2020/05/27,Málaga,Granada,300,914678,149767,764911,1661785,283262
2020/05/27,Málaga,Cádiz,1628,1240155,211048,1029107,1661785,283262
2020/05/27,Málaga,Málaga,235798,1661785,279551,1382234,1661785,283262
2020/05/27,Málaga,Sevilla,380,1942389,364217,1578172,1661785,283262
2020/05/27,Málaga,Córdoba,405,782979,131349,651630,1661785,283262
2020/05/27,Melilla,Melilla,14555,86487,14717,71770,86487,14741
2020/05/27,Murcia,Almería,1413,716820,109756,607064,1493898,261364
2020/05/27,Murcia,Alicante,3127,1858683,330446,1528237,1493898,261364
2020/05/27,Murcia,Albacete,590,388167,44096,344071,1493898,261364
2020/05/27,Murcia,Granada,16,914678,149767,764911,1493898,261364
2020/05/27,Murcia,Murcia,210830,1493898,266742,1227156,1493898,261364
2020/05/27,Navarra,Zaragoza,690,964724,197429,767295,654183,126763
2020/05/27,Navarra,Navarra,93104,654183,124763,529420,654183,126763
2020/05/27,Navarra,Gipuzkoa,454,723576,137464,586112,654183,126763
2020/05/27,Navarra,Araba,115,331549,71644,259905,654183,126763
2020/05/27,Navarra,Rioja,2974,316798,58934,257864,654183,126763
2020/05/27,Ourense,León,343,460001,78788,381213,307651,59947
2020/05/27,Ourense,Zamora,92,172539,25455,147084,307651,59947
2020/05/27,Ourense,Lugo,268,329587,52767,276820,307651,59947
2020/05/27,Ourense,Pontevedra,204,942665,196585,746080,307651,59947
2020/05/27,Ourense,Ourense,46748,307651,59040,248611,307651,59947
2020/05/27,Palencia,Cantabria,164,580795,115297,465498,160866,28165
2020/05/27,Palencia,Burgos,243,357072,55718,301354,160866,28165
2020/05/27,Palencia,Palencia,19620,160866,26421,134445,160866,28165
2020/05/27,Palencia,Valladolid,421,519546,99876,419670,160866,28165
2020/05/27,Palencia,León,30,460001,78788,381213,160866,28165
2020/05/27,Pontevedra,Ourense,287,307651,59040,248611,942665,194632
2020/05/27,Pontevedra,Lugo,52,329587,52767,276820,942665,194632
2020/05/27,Pontevedra,Pontevedra,156817,942665,196585,746080,942665,194632
2020/05/27,Pontevedra,Coruña,4571,1119596,222463,897133,942665,194632
2020/05/27,Rioja,Rioja,44143,316798,58934,257864,316798,56432
2020/05/27,Rioja,Araba,841,331549,71644,259905,316798,56432
2020/05/27,Rioja,Burgos,127,357072,55718,301354,316798,56432
2020/05/27,Rioja,Navarra,2107,654183,124763,529420,316798,56432
2020/05/27,Salamanca,Zamora,94,172539,25455,147084,330119,54500
2020/05/27,Salamanca,Ávila,218,157640,20666,136974,330119,54500
2020/05/27,Salamanca,Valladolid,33,519546,99876,419670,330119,54500
2020/05/27,Salamanca,Salamanca,43488,330119,54746,275373,330119,54500
2020/05/27,Santa Cruz de Tenerife,Las Palmas de Gran Canaria,190,1120406,209369,911037,1032983,190350
2020/05/27,Santa Cruz de Tenerife,Santa Cruz de Tenerife,176079,1032983,190608,842375,1032983,190350
2020/05/27,Segovia,Soria,24,88636,10211,78425,153129,25484
2020/05/27,Segovia,Burgos,124,357072,55718,301354,153129,25484
2020/05/27,Segovia,Segovia,15857,153129,23204,129925,153129,25484
2020/05/27,Segovia,Ávila,85,157640,20666,136974,153129,25484
2020/05/27,Segovia,Valladolid,383,519546,99876,419670,153129,25484
2020/05/27,Sevilla,Huelva,750,521870,87792,434078,1942389,356888
2020/05/27,Sevilla,Badajoz,55,673559,102099,571460,1942389,356888
2020/05/27,Sevilla,Cádiz,971,1240155,211048,1029107,1942389,356888
2020/05/27,Sevilla,Málaga,65,1661785,279551,1382234,1942389,356888
2020/05/27,Sevilla,Jaén,21,633564,79970,553594,1942389,356888
2020/05/27,Sevilla,Sevilla,267894,1942389,364217,1578172,1942389,356888
2020/05/27,Sevilla,Córdoba,2277,782979,131349,651630,1942389,356888
2020/05/27,Soria,Soria,7917,88636,10211,78425,88636,11800
2020/05/27,Soria,Burgos,156,357072,55718,301354,88636,11800
2020/05/27,Soria,Valladolid,53,519546,99876,419670,88636,11800
2020/05/27,Soria,Zaragoza,180,964724,197429,767295,88636,11800
2020/05/27,Soria,Segovia,17,153129,23204,129925,88636,11800
2020/05/27,Soria,Guadalajara,18,257762,44196,213566,88636,11800
2020/05/27,Tarragona,Zaragoza,77,964724,197429,767295,804664,133581
2020/05/27,Tarragona,Lleida,26,434930,73470,361460,804664,133581
2020/05/27,Tarragona,Tarragona,92143,804664,133059,671605,804664,133581
2020/05/27,Tarragona,Castellón,910,579962,91399,488563,804664,133581
2020/05/27,Tarragona,Barcelona,1517,5664579,1127218,4537361,804664,133581
2020/05/27,Tarragona,Teruel,86,134137,12564,121573,804664,133581
2020/05/27,Teruel,Tarragona,91,804664,133059,671605,134137,14670
2020/05/27,Teruel,Castellón,50,579962,91399,488563,134137,14670
2020/05/27,Teruel,Teruel,7787,134137,12564,121573,134137,14670
2020/05/27,Teruel,Zaragoza,382,964724,197429,767295,134137,14670
2020/05/27,Toledo,Ciudad Real,386,495761,54654,441107,694844,99759
2020/05/27,Toledo,Toledo,49727,694844,101593,593251,694844,99759
2020/05/27,Toledo,Cuenca,158,196329,24444,171885,694844,99759
2020/05/27,Toledo,Ávila,331,157640,20666,136974,694844,99759
2020/05/27,Toledo,Madrid,4572,6663394,1241264,5422130,694844,99759
2020/05/27,Toledo,Cáceres,283,394151,51816,342335,694844,99759
2020/05/27,Valencia,Cuenca,123,196329,24444,171885,2565124,498997
2020/05/27,Valencia,Valencia,370850,2565124,512847,2052277,2565124,498997
2020/05/27,Valencia,Castellón,778,579962,91399,488563,2565124,498997
2020/05/27,Valencia,Alicante,1345,1858683,330446,1528237,2565124,498997
2020/05/27,Valencia,Albacete,359,388167,44096,344071,2565124,498997
2020/05/27,Valencia,Teruel,22,134137,12564,121573,2565124,498997
2020/05/27,Valladolid,Segovia,326,153129,23204,129925,519546,95878
2020/05/27,Valladolid,Palencia,90,160866,26421,134445,519546,95878
2020/05/27,Valladolid,Burgos,108,357072,55718,301354,519546,95878
2020/05/27,Valladolid,Zamora,192,172539,25455,147084,519546,95878
2020/05/27,Valladolid,Ávila,32,157640,20666,136974,519546,95878
2020/05/27,Valladolid,Valladolid,74500,519546,99876,419670,519546,95878
2020/05/27,Valladolid,León,42,460001,78788,381213,519546,95878
2020/05/27,Zamora,Zamora,17509,172539,25455,147084,172539,25265
2020/05/27,Zamora,León,58,460001,78788,381213,172539,25265
2020/05/27,Zamora,Ourense,82,307651,59040,248611,172539,25265
2020/05/27,Zamora,Valladolid,133,519546,99876,419670,172539,25265
2020/05/27,Zamora,Salamanca,56,330119,54746,275373,172539,25265
2020/05/27,Zaragoza,Zaragoza,155666,964724,197429,767295,964724,190439
2020/05/27,Zaragoza,Teruel,252,134137,12564,121573,964724,190439
2020/05/27,Zaragoza,Lleida,118,434930,73470,361460,964724,190439
2020/05/27,Zaragoza,Huesca,409,220461,32453,188008,964724,190439
2020/05/27,Zaragoza,Soria,56,88636,10211,78425,964724,190439
2020/05/27,Zaragoza,Navarra,667,654183,124763,529420,964724,190439
2020/05/28,Albacete,Albacete,29774,388167,45233,342934,388167,46417
2020/05/28,Albacete,Cuenca,853,196329,24504,171825,388167,46417
2020/05/28,Albacete,Jaén,54,633564,81358,552206,388167,46417
2020/05/28,Albacete,Valencia,442,2565124,517304,2047820,388167,46417
2020/05/28,Albacete,Alicante,243,1858683,325429,1533254,388167,46417
2020/05/28,Albacete,Murcia,777,1493898,266424,1227474,388167,46417
2020/05/28,Albacete,Ciudad Real,715,495761,55806,439955,388167,46417
2020/05/28,Alicante,Murcia,3598,1493898,266424,1227474,1858683,331222
2020/05/28,Alicante,Valencia,1491,2565124,517304,2047820,1858683,331222
2020/05/28,Alicante,Albacete,433,388167,45233,342934,1858683,331222
2020/05/28,Alicante,Alicante,256466,1858683,325429,1533254,1858683,331222
2020/05/28,Almería,Granada,576,914678,151501,763177,716820,113241
2020/05/28,Almería,Almería,92685,716820,110670,606150,716820,113241
2020/05/28,Almería,Murcia,2188,1493898,266424,1227474,716820,113241
2020/05/28,Araba,Burgos,2293,357072,55968,301104,331549,82085
2020/05/28,Araba,Cantabria,18,580795,119955,460840,331549,82085
2020/05/28,Araba,Araba,60754,331549,73145,258404,331549,82085
2020/05/28,Araba,Bizkaia,2215,1152934,278675,874259,331549,82085
2020/05/28,Araba,Gipuzkoa,351,723576,141694,581882,331549,82085
2020/05/28,Araba,Navarra,216,654183,126013,528170,331549,82085
2020/05/28,Araba,Rioja,2469,316798,59506,257292,331549,82085
2020/05/28,Asturias,Asturias,171840,1022800,205004,817796,1022800,204646
2020/05/28,Asturias,Cantabria,327,580795,119955,460840,1022800,204646
2020/05/28,Asturias,León,27,460001,79385,380616,1022800,204646
2020/05/28,Asturias,Lugo,1023,329587,54118,275469,1022800,204646
2020/05/28,Ávila,Ávila,13971,157640,21112,136528,157640,22554
2020/05/28,Ávila,Salamanca,430,330119,56053,274066,157640,22554
2020/05/28,Ávila,Toledo,268,694844,103670,591174,157640,22554
2020/05/28,Ávila,Segovia,118,153129,23888,129241,157640,22554
2020/05/28,Ávila,Valladolid,29,519546,100943,418603,157640,22554
2020/05/28,Ávila,Cáceres,120,394151,52842,341309,157640,22554
2020/05/28,Ávila,Madrid,209,6663394,1258543,5404851,157640,22554
2020/05/28,Badajoz,Ciudad Real,42,495761,55806,439955,673559,102990
2020/05/28,Badajoz,Córdoba,95,782979,129559,653420,673559,102990
2020/05/28,Badajoz,Huelva,266,521870,88391,433479,673559,102990
2020/05/28,Badajoz,Cáceres,1395,394151,52842,341309,673559,102990
2020/05/28,Badajoz,Sevilla,92,1942389,367088,1575301,673559,102990
2020/05/28,Badajoz,Badajoz,78951,673559,103901,569658,673559,102990
2020/05/28,Balears,Balears,185670,1149460,205106,944354,1149460,206466
2020/05/28,Balears,Valencia,71,2565124,517304,2047820,1149460,206466
2020/05/28,Balears,Barcelona,58,5664579,1141271,4523308,1149460,206466
2020/05/28,Barcelona,Tarragona,2587,804664,135262,669402,5664579,1137892
2020/05/28,Barcelona,Lleida,270,434930,74071,360859,5664579,1137892
2020/05/28,Barcelona,Girona,3602,771044,115798,655246,5664579,1137892
2020/05/28,Barcelona,Barcelona,749670,5664579,1141271,4523308,5664579,1137892
2020/05/28,Bizkaia,Burgos,118,357072,55968,301104,1152934,271343
2020/05/28,Bizkaia,Gipuzkoa,1443,723576,141694,581882,1152934,271343
2020/05/28,Bizkaia,Bizkaia,219684,1152934,278675,874259,1152934,271343
2020/05/28,Bizkaia,Cantabria,3780,580795,119955,460840,1152934,271343
2020/05/28,Bizkaia,Araba,1196,331549,73145,258404,1152934,271343
2020/05/28,Burgos,Araba,1494,331549,73145,258404,357072,57297
2020/05/28,Burgos,Rioja,84,316798,59506,257292,357072,57297
2020/05/28,Burgos,Palencia,237,160866,27121,133745,357072,57297
2020/05/28,Burgos,Burgos,42209,357072,55968,301104,357072,57297
2020/05/28,Burgos,Cantabria,30,580795,119955,460840,357072,57297
2020/05/28,Burgos,Valladolid,94,519546,100943,418603,357072,57297
2020/05/28,Burgos,Soria,26,88636,9801,78835,357072,57297
2020/05/28,Burgos,Segovia,67,153129,23888,129241,357072,57297
2020/05/28,Burgos,Bizkaia,208,1152934,278675,874259,357072,57297
2020/05/28,Cáceres,Ávila,115,157640,21112,136528,394151,53142
2020/05/28,Cáceres,Valencia,22,2565124,517304,2047820,394151,53142
2020/05/28,Cáceres,Badajoz,1418,673559,103901,569658,394151,53142
2020/05/28,Cáceres,Toledo,272,694844,103670,591174,394151,53142
2020/05/28,Cáceres,Cáceres,36856,394151,52842,341309,394151,53142
2020/05/28,Cádiz,Málaga,1648,1661785,281799,1379986,1240155,216206
2020/05/28,Cádiz,Sevilla,1142,1942389,367088,1575301,1240155,216206
2020/05/28,Cádiz,Cádiz,179066,1240155,211781,1028374,1240155,216206
2020/05/28,Cádiz,Huelva,730,521870,88391,433479,1240155,216206
2020/05/28,Cantabria,Palencia,88,160866,27121,133745,580795,115347
2020/05/28,Cantabria,Cantabria,91322,580795,119955,460840,580795,115347
2020/05/28,Cantabria,Bizkaia,2450,1152934,278675,874259,580795,115347
2020/05/28,Cantabria,Asturias,259,1022800,205004,817796,580795,115347
2020/05/28,Castellón,Tarragona,1096,804664,135262,669402,579962,98359
2020/05/28,Castellón,Castellón,70980,579962,92342,487620,579962,98359
2020/05/28,Castellón,Teruel,85,134137,12610,121527,579962,98359
2020/05/28,Castellón,Valencia,980,2565124,517304,2047820,579962,98359
2020/05/28,Ceuta,Ceuta,11568,84777,12133,72644,84777,12211
2020/05/28,Ceuta,Cádiz,93,1240155,211781,1028374,84777,12211
2020/05/28,Ciudad Real,Albacete,522,388167,45233,342934,495761,51752
2020/05/28,Ciudad Real,Ciudad Real,35075,495761,55806,439955,495761,51752
2020/05/28,Ciudad Real,Cuenca,78,196329,24504,171825,495761,51752
2020/05/28,Ciudad Real,Toledo,512,694844,103670,591174,495761,51752
2020/05/28,Ciudad Real,Córdoba,354,782979,129559,653420,495761,51752
2020/05/28,Ciudad Real,Badajoz,54,673559,103901,569658,495761,51752
2020/05/28,Córdoba,Sevilla,1986,1942389,367088,1575301,782979,126879
2020/05/28,Córdoba,Jaén,773,633564,81358,552206,782979,126879
2020/05/28,Córdoba,Badajoz,136,673559,103901,569658,782979,126879
2020/05/28,Córdoba,Málaga,350,1661785,281799,1379986,782979,126879
2020/05/28,Córdoba,Ciudad Real,305,495761,55806,439955,782979,126879
2020/05/28,Córdoba,Córdoba,94266,782979,129559,653420,782979,126879
2020/05/28,Córdoba,Granada,147,914678,151501,763177,782979,126879
2020/05/28,Coruña,Lugo,699,329587,54118,275469,1119596,227763
2020/05/28,Coruña,Coruña,176856,1119596,225414,894182,1119596,227763
2020/05/28,Coruña,Pontevedra,6189,942665,198080,744585,1119596,227763
2020/05/28,Cuenca,Cuenca,13657,196329,24504,171825,196329,25844
2020/05/28,Cuenca,Ciudad Real,187,495761,55806,439955,196329,25844
2020/05/28,Cuenca,Toledo,181,694844,103670,591174,196329,25844
2020/05/28,Cuenca,Madrid,77,6663394,1258543,5404851,196329,25844
2020/05/28,Cuenca,Albacete,842,388167,45233,342934,196329,25844
2020/05/28,Cuenca,Valencia,103,2565124,517304,2047820,196329,25844
2020/05/28,Cuenca,Guadalajara,47,257762,44609,213153,196329,25844
2020/05/28,Gipuzkoa,Araba,364,331549,73145,258404,723576,146205
2020/05/28,Gipuzkoa,Gipuzkoa,112286,723576,141694,581882,723576,146205
2020/05/28,Gipuzkoa,Bizkaia,2260,1152934,278675,874259,723576,146205
2020/05/28,Gipuzkoa,Navarra,523,654183,126013,528170,723576,146205
2020/05/28,Girona,Girona,79772,771044,115798,655246,771044,123304
2020/05/28,Girona,Barcelona,3241,5664579,1141271,4523308,771044,123304
2020/05/28,Girona,Lleida,219,434930,74071,360859,771044,123304
2020/05/28,Granada,Almería,533,716820,110670,606150,914678,148655
2020/05/28,Granada,Málaga,226,1661785,281799,1379986,914678,148655
2020/05/28,Granada,Córdoba,237,782979,129559,653420,914678,148655
2020/05/28,Granada,Jaén,389,633564,81358,552206,914678,148655
2020/05/28,Granada,Granada,112737,914678,151501,763177,914678,148655
2020/05/28,Granada,Murcia,116,1493898,266424,1227474,914678,148655
2020/05/28,Guadalajara,Madrid,2818,6663394,1258543,5404851,257762,47855
2020/05/28,Guadalajara,Guadalajara,26562,257762,44609,213153,257762,47855
2020/05/28,Guadalajara,Cuenca,38,196329,24504,171825,257762,47855
2020/05/28,Huelva,Sevilla,1500,1942389,367088,1575301,521870,92665
2020/05/28,Huelva,Huelva,71121,521870,88391,433479,521870,92665
2020/05/28,Huelva,Badajoz,395,673559,103901,569658,521870,92665
2020/05/28,Huelva,Cádiz,563,1240155,211781,1028374,521870,92665
2020/05/28,Huesca,Zaragoza,479,964724,200681,764043,220461,37074
2020/05/28,Huesca,Lleida,1376,434930,74071,360859,220461,37074
2020/05/28,Huesca,Huesca,23041,220461,33367,187094,220461,37074
2020/05/28,Jaén,Albacete,16,388167,45233,342934,633564,80252
2020/05/28,Jaén,Jaén,57762,633564,81358,552206,633564,80252
2020/05/28,Jaén,Córdoba,895,782979,129559,653420,633564,80252
2020/05/28,Jaén,Granada,316,914678,151501,763177,633564,80252
2020/05/28,Las Palmas de Gran Canaria,Santa Cruz de Tenerife,17,1032983,193909,839074,1120406,210759
2020/05/28,Las Palmas de Gran Canaria,Las Palmas de Gran Canaria,198493,1120406,211440,908966,1120406,210759
2020/05/28,León,Palencia,74,160866,27121,133745,460001,79504
2020/05/28,León,Zamora,181,172539,25978,146561,460001,79504
2020/05/28,León,León,60976,460001,79385,380616,460001,79504
2020/05/28,León,Lugo,29,329587,54118,275469,460001,79504
2020/05/28,León,Ourense,403,307651,58758,248893,460001,79504
2020/05/28,León,Valladolid,27,519546,100943,418603,460001,79504
2020/05/28,León,Asturias,40,1022800,205004,817796,460001,79504
2020/05/28,Lleida,Tarragona,73,804664,135262,669402,434930,71605
2020/05/28,Lleida,Girona,215,771044,115798,655246,434930,71605
2020/05/28,Lleida,Barcelona,299,5664579,1141271,4523308,434930,71605
2020/05/28,Lleida,Zaragoza,179,964724,200681,764043,434930,71605
2020/05/28,Lleida,Lleida,49222,434930,74071,360859,434930,71605
2020/05/28,Lleida,Huesca,825,220461,33367,187094,434930,71605
2020/05/28,Lugo,Coruña,646,1119596,225414,894182,329587,55770
2020/05/28,Lugo,Asturias,895,1022800,205004,817796,329587,55770
2020/05/28,Lugo,Pontevedra,33,942665,198080,744585,329587,55770
2020/05/28,Lugo,Ourense,239,307651,58758,248893,329587,55770
2020/05/28,Lugo,Lugo,39250,329587,54118,275469,329587,55770
2020/05/28,Madrid,Toledo,5034,694844,103670,591174,6663394,1255058
2020/05/28,Madrid,Ávila,355,157640,21112,136528,6663394,1255058
2020/05/28,Madrid,Guadalajara,3748,257762,44609,213153,6663394,1255058
2020/05/28,Madrid,Madrid,765401,6663394,1258543,5404851,6663394,1255058
2020/05/28,Madrid,Segovia,28,153129,23888,129241,6663394,1255058
2020/05/28,Madrid,Cuenca,79,196329,24504,171825,6663394,1255058
2020/05/28,Madrid,Ciudad Real,32,495761,55806,439955,6663394,1255058
2020/05/28,Málaga,Cádiz,1552,1240155,211781,1028374,1661785,286870
2020/05/28,Málaga,Almería,32,716820,110670,606150,1661785,286870
2020/05/28,Málaga,Málaga,237943,1661785,281799,1379986,1661785,286870
2020/05/28,Málaga,Sevilla,341,1942389,367088,1575301,1661785,286870
2020/05/28,Málaga,Melilla,17,86487,14915,71572,1661785,286870
2020/05/28,Málaga,Granada,365,914678,151501,763177,1661785,286870
2020/05/28,Málaga,Córdoba,388,782979,129559,653420,1661785,286870
2020/05/28,Melilla,Melilla,14610,86487,14915,71572,86487,14737
2020/05/28,Murcia,Alicante,2938,1858683,325429,1533254,1493898,262312
2020/05/28,Murcia,Murcia,211724,1493898,266424,1227474,1493898,262312
2020/05/28,Murcia,Almería,1417,716820,110670,606150,1493898,262312
2020/05/28,Murcia,Albacete,685,388167,45233,342934,1493898,262312
2020/05/28,Navarra,Gipuzkoa,486,723576,141694,581882,654183,127142
2020/05/28,Navarra,Araba,102,331549,73145,258404,654183,127142
2020/05/28,Navarra,Rioja,2800,316798,59506,257292,654183,127142
2020/05/28,Navarra,Navarra,94171,654183,126013,528170,654183,127142
2020/05/28,Navarra,Zaragoza,795,964724,200681,764043,654183,127142
2020/05/28,Ourense,Zamora,53,172539,25978,146561,307651,59005
2020/05/28,Ourense,Pontevedra,196,942665,198080,744585,307651,59005
2020/05/28,Ourense,León,315,460001,79385,380616,307651,59005
2020/05/28,Ourense,Ourense,45532,307651,58758,248893,307651,59005
2020/05/28,Ourense,Lugo,218,329587,54118,275469,307651,59005
2020/05/28,Palencia,Palencia,19934,160866,27121,133745,160866,28658
2020/05/28,Palencia,Cantabria,145,580795,119955,460840,160866,28658
2020/05/28,Palencia,Valladolid,376,519546,100943,418603,160866,28658
2020/05/28,Palencia,León,24,460001,79385,380616,160866,28658
2020/05/28,Palencia,Burgos,312,357072,55968,301104,160866,28658
2020/05/28,Pontevedra,Ourense,266,307651,58758,248893,942665,196752
2020/05/28,Pontevedra,Coruña,4812,1119596,225414,894182,942665,196752
2020/05/28,Pontevedra,Lugo,28,329587,54118,275469,942665,196752
2020/05/28,Pontevedra,Pontevedra,157737,942665,198080,744585,942665,196752
2020/05/28,Rioja,Navarra,2096,654183,126013,528170,316798,57154
2020/05/28,Rioja,Rioja,44538,316798,59506,257292,316798,57154
2020/05/28,Rioja,Burgos,90,357072,55968,301104,316798,57154
2020/05/28,Rioja,Bizkaia,19,1152934,278675,874259,316798,57154
2020/05/28,Rioja,Araba,930,331549,73145,258404,316798,57154
2020/05/28,Salamanca,Salamanca,44537,330119,56053,274066,330119,55461
2020/05/28,Salamanca,Zamora,144,172539,25978,146561,330119,55461
2020/05/28,Salamanca,Ávila,226,157640,21112,136528,330119,55461
2020/05/28,Salamanca,Valladolid,27,519546,100943,418603,330119,55461
2020/05/28,Santa Cruz de Tenerife,Santa Cruz de Tenerife,179922,1032983,193909,839074,1032983,193575
2020/05/28,Santa Cruz de Tenerife,Las Palmas de Gran Canaria,85,1120406,211440,908966,1032983,193575
2020/05/28,Segovia,Madrid,26,6663394,1258543,5404851,153129,26703
2020/05/28,Segovia,Ávila,179,157640,21112,136528,153129,26703
2020/05/28,Segovia,Valladolid,473,519546,100943,418603,153129,26703
2020/05/28,Segovia,Burgos,168,357072,55968,301104,153129,26703
2020/05/28,Segovia,Segovia,16288,153129,23888,129241,153129,26703
2020/05/28,Sevilla,Huelva,653,521870,88391,433479,1942389,359976
2020/05/28,Sevilla,Badajoz,74,673559,103901,569658,1942389,359976
2020/05/28,Sevilla,Córdoba,2114,782979,129559,653420,1942389,359976
2020/05/28,Sevilla,Sevilla,270928,1942389,367088,1575301,1942389,359976
2020/05/28,Sevilla,Cádiz,980,1240155,211781,1028374,1942389,359976
2020/05/28,Sevilla,Málaga,175,1661785,281799,1379986,1942389,359976
2020/05/28,Soria,Burgos,104,357072,55968,301104,88636,11163
2020/05/28,Soria,Zaragoza,151,964724,200681,764043,88636,11163
2020/05/28,Soria,Soria,7369,88636,9801,78835,88636,11163
2020/05/28,Soria,Segovia,17,153129,23888,129241,88636,11163
2020/05/28,Soria,Valladolid,32,519546,100943,418603,88636,11163
2020/05/28,Tarragona,Tarragona,93908,804664,135262,669402,804664,136233
2020/05/28,Tarragona,Barcelona,1598,5664579,1141271,4523308,804664,136233
2020/05/28,Tarragona,Teruel,87,134137,12610,121527,804664,136233
2020/05/28,Tarragona,Castellón,884,579962,92342,487620,804664,136233
2020/05/28,Teruel,Teruel,7795,134137,12610,121527,134137,14769
2020/05/28,Teruel,Castellón,81,579962,92342,487620,134137,14769
2020/05/28,Teruel,Tarragona,103,804664,135262,669402,134137,14769
2020/05/28,Teruel,Zaragoza,399,964724,200681,764043,134137,14769
2020/05/28,Toledo,Ávila,250,157640,21112,136528,694844,100297
2020/05/28,Toledo,Cuenca,133,196329,24504,171825,694844,100297
2020/05/28,Toledo,Ciudad Real,525,495761,55806,439955,694844,100297
2020/05/28,Toledo,Cáceres,223,394151,52842,341309,694844,100297
2020/05/28,Toledo,Madrid,4139,6663394,1258543,5404851,694844,100297
2020/05/28,Toledo,Toledo,50196,694844,103670,591174,694844,100297
2020/05/28,Valencia,Girona,41,771044,115798,655246,2565124,503658
2020/05/28,Valencia,Cáceres,18,394151,52842,341309,2565124,503658
2020/05/28,Valencia,Valencia,373484,2565124,517304,2047820,2565124,503658
2020/05/28,Valencia,Cuenca,105,196329,24504,171825,2565124,503658
2020/05/28,Valencia,Alicante,1133,1858683,325429,1533254,2565124,503658
2020/05/28,Valencia,Albacete,394,388167,45233,342934,2565124,503658
2020/05/28,Valencia,Castellón,616,579962,92342,487620,2565124,503658
2020/05/28,Valladolid,Segovia,360,153129,23888,129241,519546,97348
2020/05/28,Valladolid,Burgos,83,357072,55968,301104,519546,97348
2020/05/28,Valladolid,Soria,28,88636,9801,78835,519546,97348
2020/05/28,Valladolid,Valladolid,76143,519546,100943,418603,519546,97348
2020/05/28,Valladolid,Palencia,27,160866,27121,133745,519546,97348
2020/05/28,Valladolid,León,32,460001,79385,380616,519546,97348
2020/05/28,Valladolid,Zamora,159,172539,25978,146561,519546,97348
2020/05/28,Valladolid,Salamanca,83,330119,56053,274066,519546,97348
2020/05/28,Valladolid,Ávila,29,157640,21112,136528,519546,97348
2020/05/28,Zamora,Zamora,18218,172539,25978,146561,172539,25893
2020/05/28,Zamora,Ourense,83,307651,58758,248893,172539,25893
2020/05/28,Zamora,León,90,460001,79385,380616,172539,25893
2020/05/28,Zamora,Salamanca,29,330119,56053,274066,172539,25893
2020/05/28,Zamora,Valladolid,114,519546,100943,418603,172539,25893
2020/05/28,Zaragoza,Huesca,354,220461,33367,187094,964724,193880
2020/05/28,Zaragoza,Soria,106,88636,9801,78835,964724,193880
2020/05/28,Zaragoza,Zaragoza,158432,964724,200681,764043,964724,193880
2020/05/28,Zaragoza,Teruel,395,134137,12610,121527,964724,193880
2020/05/28,Zaragoza,Lleida,121,434930,74071,360859,964724,193880
2020/05/28,Zaragoza,Navarra,623,654183,126013,528170,964724,193880
2020/05/29,Albacete,Murcia,722,1493898,267269,1226629,388167,47264
2020/05/29,Albacete,Ciudad Real,670,495761,54130,441631,388167,47264
2020/05/29,Albacete,Cuenca,994,196329,24796,171533,388167,47264
2020/05/29,Albacete,Valencia,390,2565124,519872,2045252,388167,47264
2020/05/29,Albacete,Alicante,250,1858683,324088,1534595,388167,47264
2020/05/29,Albacete,Jaén,44,633564,79756,553808,388167,47264
2020/05/29,Albacete,Albacete,31498,388167,46325,341842,388167,47264
2020/05/29,Albacete,Granada,25,914678,152134,762544,388167,47264
2020/05/29,Alicante,Albacete,406,388167,46325,341842,1858683,329502
2020/05/29,Alicante,Alicante,257970,1858683,324088,1534595,1858683,329502
2020/05/29,Alicante,Murcia,3534,1493898,267269,1226629,1858683,329502
2020/05/29,Alicante,Valencia,1617,2565124,519872,2045252,1858683,329502
2020/05/29,Almería,Almería,93410,716820,111119,605701,716820,112742
2020/05/29,Almería,Murcia,2160,1493898,267269,1226629,716820,112742
2020/05/29,Almería,Granada,609,914678,152134,762544,716820,112742
2020/05/29,Araba,Rioja,2482,316798,59904,256894,331549,81160
2020/05/29,Araba,Gipuzkoa,421,723576,139422,584154,331549,81160
2020/05/29,Araba,Burgos,2220,357072,55471,301601,331549,81160
2020/05/29,Araba,Araba,60993,331549,73127,258422,331549,81160
2020/05/29,Araba,Bizkaia,2127,1152934,275992,876942,331549,81160
2020/05/29,Araba,Navarra,205,654183,127873,526310,331549,81160
2020/05/29,Asturias,Cantabria,248,580795,117554,463241,1022800,204677
2020/05/29,Asturias,Asturias,174064,1022800,205651,817149,1022800,204677
2020/05/29,Asturias,León,45,460001,78267,381734,1022800,204677
2020/05/29,Asturias,Lugo,1107,329587,53467,276120,1022800,204677
2020/05/29,Ávila,Ávila,14005,157640,20605,137035,157640,22192
2020/05/29,Ávila,Toledo,319,694844,102895,591949,157640,22192
2020/05/29,Ávila,Madrid,235,6663394,1234277,5429117,157640,22192
2020/05/29,Ávila,Segovia,83,153129,23197,129932,157640,22192
2020/05/29,Ávila,Valladolid,50,519546,101324,418222,157640,22192
2020/05/29,Ávila,Salamanca,337,330119,54692,275427,157640,22192
2020/05/29,Ávila,Cáceres,163,394151,48907,345244,157640,22192
2020/05/29,Badajoz,Cáceres,1235,394151,48907,345244,673559,100303
2020/05/29,Badajoz,Sevilla,84,1942389,365664,1576725,673559,100303
2020/05/29,Badajoz,Ciudad Real,78,495761,54130,441631,673559,100303
2020/05/29,Badajoz,Córdoba,129,782979,128085,654894,673559,100303
2020/05/29,Badajoz,Huelva,231,521870,87071,434799,673559,100303
2020/05/29,Badajoz,Badajoz,77383,673559,101281,572278,673559,100303
2020/05/29,Balears,Valencia,49,2565124,519872,2045252,1149460,207083
2020/05/29,Balears,Balears,188271,1149460,206486,942974,1149460,207083
2020/05/29,Balears,Barcelona,22,5664579,1130995,4533584,1149460,207083
2020/05/29,Barcelona,Girona,3429,771044,116436,654608,5664579,1128631
2020/05/29,Barcelona,Tarragona,2696,804664,135055,669609,5664579,1128631
2020/05/29,Barcelona,Lleida,290,434930,73932,360998,5664579,1128631
2020/05/29,Barcelona,Barcelona,745863,5664579,1130995,4533584,5664579,1128631
2020/05/29,Bizkaia,Gipuzkoa,1256,723576,139422,584154,1152934,269085
2020/05/29,Bizkaia,Burgos,108,357072,55471,301601,1152934,269085
2020/05/29,Bizkaia,Cantabria,3576,580795,117554,463241,1152934,269085
2020/05/29,Bizkaia,Bizkaia,219358,1152934,275992,876942,1152934,269085
2020/05/29,Bizkaia,Araba,1118,331549,73127,258422,1152934,269085
2020/05/29,Burgos,Burgos,42443,357072,55471,301601,357072,56592
2020/05/29,Burgos,Segovia,97,153129,23197,129932,357072,56592
2020/05/29,Burgos,Palencia,218,160866,26873,133993,357072,56592
2020/05/29,Burgos,Cantabria,22,580795,117554,463241,357072,56592
2020/05/29,Burgos,Araba,1488,331549,73127,258422,357072,56592
2020/05/29,Burgos,Bizkaia,195,1152934,275992,876942,357072,56592
2020/05/29,Burgos,Soria,54,88636,9930,78706,357072,56592
2020/05/29,Burgos,Valladolid,119,519546,101324,418222,357072,56592
2020/05/29,Burgos,Rioja,58,316798,59904,256894,357072,56592
2020/05/29,Cáceres,Cáceres,33534,394151,48907,345244,394151,48363
2020/05/29,Cáceres,Ávila,134,157640,20605,137035,394151,48363
2020/05/29,Cáceres,Toledo,254,694844,102895,591949,394151,48363
2020/05/29,Cáceres,Badajoz,1402,673559,101281,572278,394151,48363
2020/05/29,Cádiz,Sevilla,1441,1942389,365664,1576725,1240155,220443
2020/05/29,Cádiz,Huelva,676,521870,87071,434799,1240155,220443
2020/05/29,Cádiz,Málaga,1578,1661785,281784,1380001,1240155,220443
2020/05/29,Cádiz,Cádiz,185088,1240155,217782,1022373,1240155,220443
2020/05/29,Cádiz,Ceuta,80,84777,12161,72616,1240155,220443
2020/05/29,Cantabria,Bizkaia,2140,1152934,275992,876942,580795,113799
2020/05/29,Cantabria,Cantabria,90325,580795,117554,463241,580795,113799
2020/05/29,Cantabria,Asturias,262,1022800,205651,817149,580795,113799
2020/05/29,Cantabria,Palencia,48,160866,26873,133993,580795,113799
2020/05/29,Castellón,Teruel,105,134137,12650,121487,579962,98433
2020/05/29,Castellón,Tarragona,1016,804664,135055,669609,579962,98433
2020/05/29,Castellón,Castellón,72185,579962,93461,486501,579962,98433
2020/05/29,Castellón,Valencia,887,2565124,519872,2045252,579962,98433
2020/05/29,Ceuta,Ceuta,11502,84777,12161,72616,84777,11993
2020/05/29,Ceuta,Cádiz,47,1240155,217782,1022373,84777,11993
2020/05/29,Ciudad Real,Córdoba,403,782979,128085,654894,495761,51678
2020/05/29,Ciudad Real,Cuenca,23,196329,24796,171533,495761,51678
2020/05/29,Ciudad Real,Ciudad Real,34735,495761,54130,441631,495761,51678
2020/05/29,Ciudad Real,Albacete,493,388167,46325,341842,495761,51678
2020/05/29,Ciudad Real,Toledo,522,694844,102895,591949,495761,51678
2020/05/29,Ciudad Real,Badajoz,67,673559,101281,572278,495761,51678
2020/05/29,Córdoba,Sevilla,1930,1942389,365664,1576725,782979,125571
2020/05/29,Córdoba,Málaga,218,1661785,281784,1380001,782979,125571
2020/05/29,Córdoba,Ciudad Real,295,495761,54130,441631,782979,125571
2020/05/29,Córdoba,Granada,118,914678,152134,762544,782979,125571
2020/05/29,Córdoba,Jaén,725,633564,79756,553808,782979,125571
2020/05/29,Córdoba,Córdoba,94283,782979,128085,654894,782979,125571
2020/05/29,Córdoba,Badajoz,99,673559,101281,572278,782979,125571
2020/05/29,Coruña,Lugo,677,329587,53467,276120,1119596,226313
2020/05/29,Coruña,Pontevedra,6243,942665,197496,745169,1119596,226313
2020/05/29,Coruña,Coruña,175653,1119596,223078,896518,1119596,226313
2020/05/29,Cuenca,Cuenca,14061,196329,24796,171533,196329,25400
2020/05/29,Cuenca,Toledo,251,694844,102895,591949,196329,25400
2020/05/29,Cuenca,Madrid,93,6663394,1234277,5429117,196329,25400
2020/05/29,Cuenca,Ciudad Real,105,495761,54130,441631,196329,25400
2020/05/29,Cuenca,Albacete,890,388167,46325,341842,196329,25400
2020/05/29,Cuenca,Guadalajara,57,257762,44177,213585,196329,25400
2020/05/29,Cuenca,Valencia,95,2565124,519872,2045252,196329,25400
2020/05/29,Gipuzkoa,Bizkaia,2314,1152934,275992,876942,723576,143282
2020/05/29,Gipuzkoa,Araba,387,331549,73127,258422,723576,143282
2020/05/29,Gipuzkoa,Navarra,508,654183,127873,526310,723576,143282
2020/05/29,Gipuzkoa,Gipuzkoa,110941,723576,139422,584154,723576,143282
2020/05/29,Girona,Girona,81276,771044,116436,654608,771044,122357
2020/05/29,Girona,Barcelona,3182,5664579,1130995,4533584,771044,122357
2020/05/29,Girona,Lleida,255,434930,73932,360998,771044,122357
2020/05/29,Granada,Murcia,101,1493898,267269,1226629,914678,150597
2020/05/29,Granada,Almería,564,716820,111119,605701,914678,150597
2020/05/29,Granada,Jaén,366,633564,79756,553808,914678,150597
2020/05/29,Granada,Córdoba,232,782979,128085,654894,914678,150597
2020/05/29,Granada,Granada,114640,914678,152134,762544,914678,150597
2020/05/29,Granada,Málaga,242,1661785,281784,1380001,914678,150597
2020/05/29,Guadalajara,Madrid,2879,6663394,1234277,5429117,257762,47496
2020/05/29,Guadalajara,Teruel,22,134137,12650,121487,257762,47496
2020/05/29,Guadalajara,Zaragoza,16,964724,200621,764103,257762,47496
2020/05/29,Guadalajara,Guadalajara,27101,257762,44177,213585,257762,47496
2020/05/29,Guadalajara,Cuenca,50,196329,24796,171533,257762,47496
2020/05/29,Huelva,Sevilla,1455,1942389,365664,1576725,521870,90786
2020/05/29,Huelva,Cádiz,572,1240155,217782,1022373,521870,90786
2020/05/29,Huelva,Badajoz,335,673559,101281,572278,521870,90786
2020/05/29,Huelva,Huelva,70128,521870,87071,434799,521870,90786
2020/05/29,Huesca,Zaragoza,418,964724,200621,764103,220461,36496
2020/05/29,Huesca,Huesca,23167,220461,32827,187634,220461,36496
2020/05/29,Huesca,Lleida,1549,434930,73932,360998,220461,36496
2020/05/29,Jaén,Granada,319,914678,152134,762544,633564,79297
2020/05/29,Jaén,Jaén,56832,633564,79756,553808,633564,79297
2020/05/29,Jaén,Córdoba,898,782979,128085,654894,633564,79297
2020/05/29,Jaén,Albacete,34,388167,46325,341842,633564,79297
2020/05/29,Las Palmas de Gran Canaria,Las Palmas de Gran Canaria,197182,1120406,209239,911167,1120406,208465
2020/05/29,León,León,60225,460001,78267,381734,460001,78278
2020/05/29,León,Zamora,153,172539,25657,146882,460001,78278
2020/05/29,León,Ourense,373,307651,58368,249283,460001,78278
2020/05/29,León,Lugo,32,329587,53467,276120,460001,78278
2020/05/29,León,Valladolid,69,519546,101324,418222,460001,78278
2020/05/29,León,Palencia,115,160866,26873,133993,460001,78278
2020/05/29,León,Asturias,87,1022800,205651,817149,460001,78278
2020/05/29,Lleida,Girona,226,771044,116436,654608,434930,70827
2020/05/29,Lleida,Tarragona,58,804664,135055,669609,434930,70827
2020/05/29,Lleida,Zaragoza,213,964724,200621,764103,434930,70827
2020/05/29,Lleida,Barcelona,400,5664579,1130995,4533584,434930,70827
2020/05/29,Lleida,Huesca,760,220461,32827,187634,434930,70827
2020/05/29,Lleida,Lleida,50074,434930,73932,360998,434930,70827
2020/05/29,Lugo,Coruña,731,1119596,223078,896518,329587,55203
2020/05/29,Lugo,Lugo,39169,329587,53467,276120,329587,55203
2020/05/29,Lugo,Asturias,865,1022800,205651,817149,329587,55203
2020/05/29,Lugo,Ourense,280,307651,58368,249283,329587,55203
2020/05/29,Madrid,Segovia,56,153129,23197,129932,6663394,1232515
2020/05/29,Madrid,Ávila,272,157640,20605,137035,6663394,1232515
2020/05/29,Madrid,Toledo,4627,694844,102895,591949,6663394,1232515
2020/05/29,Madrid,Albacete,18,388167,46325,341842,6663394,1232515
2020/05/29,Madrid,Guadalajara,3603,257762,44177,213585,6663394,1232515
2020/05/29,Madrid,Madrid,752120,6663394,1234277,5429117,6663394,1232515
2020/05/29,Madrid,Ciudad Real,30,495761,54130,441631,6663394,1232515
2020/05/29,Madrid,Cuenca,111,196329,24796,171533,6663394,1232515
2020/05/29,Málaga,Granada,301,914678,152134,762544,1661785,285136
2020/05/29,Málaga,Málaga,238947,1661785,281784,1380001,1661785,285136
2020/05/29,Málaga,Córdoba,397,782979,128085,654894,1661785,285136
2020/05/29,Málaga,Cádiz,1723,1240155,217782,1022373,1661785,285136
2020/05/29,Málaga,Sevilla,434,1942389,365664,1576725,1661785,285136
2020/05/29,Melilla,Melilla,14880,86487,15115,71372,86487,15109
2020/05/29,Murcia,Albacete,553,388167,46325,341842,1493898,262875
2020/05/29,Murcia,Alicante,3072,1858683,324088,1534595,1493898,262875
2020/05/29,Murcia,Almería,1401,716820,111119,605701,1493898,262875
2020/05/29,Murcia,Murcia,214569,1493898,267269,1226629,1493898,262875
2020/05/29,Navarra,Navarra,96308,654183,127873,526310,654183,128250
2020/05/29,Navarra,Gipuzkoa,439,723576,139422,584154,654183,128250
2020/05/29,Navarra,Zaragoza,713,964724,200621,764103,654183,128250
2020/05/29,Navarra,Araba,115,331549,73127,258422,654183,128250
2020/05/29,Navarra,Rioja,2849,316798,59904,256894,654183,128250
2020/05/29,Ourense,León,371,460001,78267,381734,307651,58598
2020/05/29,Ourense,Zamora,48,172539,25657,146882,307651,58598
2020/05/29,Ourense,Ourense,45611,307651,58368,249283,307651,58598
2020/05/29,Ourense,Lugo,226,329587,53467,276120,307651,58598
2020/05/29,Ourense,Pontevedra,195,942665,197496,745169,307651,58598
2020/05/29,Palencia,Burgos,267,357072,55471,301601,160866,28317
2020/05/29,Palencia,Cantabria,167,580795,117554,463241,160866,28317
2020/05/29,Palencia,Valladolid,336,519546,101324,418222,160866,28317
2020/05/29,Palencia,Palencia,19917,160866,26873,133993,160866,28317
2020/05/29,Palencia,León,54,460001,78267,381734,160866,28317
2020/05/29,Pontevedra,Lugo,68,329587,53467,276120,942665,196654
2020/05/29,Pontevedra,Coruña,4641,1119596,223078,896518,942665,196654
2020/05/29,Pontevedra,Ourense,188,307651,58368,249283,942665,196654
2020/05/29,Pontevedra,Pontevedra,158603,942665,197496,745169,942665,196654
2020/05/29,Rioja,Navarra,2057,654183,127873,526310,316798,56860
2020/05/29,Rioja,Rioja,45154,316798,59904,256894,316798,56860
2020/05/29,Rioja,Araba,884,331549,73127,258422,316798,56860
2020/05/29,Rioja,Burgos,74,357072,55471,301601,316798,56860
2020/05/29,Salamanca,Salamanca,43913,330119,54692,275427,330119,54397
2020/05/29,Salamanca,Zamora,118,172539,25657,146882,330119,54397
2020/05/29,Salamanca,Ávila,215,157640,20605,137035,330119,54397
2020/05/29,Santa Cruz de Tenerife,Santa Cruz de Tenerife,176838,1032983,192429,840554,1032983,191975
2020/05/29,Santa Cruz de Tenerife,Las Palmas de Gran Canaria,109,1120406,209239,911167,1032983,191975
2020/05/29,Segovia,Ávila,132,157640,20605,137035,153129,25171
2020/05/29,Segovia,Segovia,15939,153129,23197,129932,153129,25171
2020/05/29,Segovia,Burgos,139,357072,55471,301601,153129,25171
2020/05/29,Segovia,Soria,23,88636,9930,78706,153129,25171
2020/05/29,Segovia,Valladolid,310,519546,101324,418222,153129,25171
2020/05/29,Sevilla,Sevilla,272492,1942389,365664,1576725,1942389,361391
2020/05/29,Sevilla,Badajoz,110,673559,101281,572278,1942389,361391
2020/05/29,Sevilla,Huelva,579,521870,87071,434799,1942389,361391
2020/05/29,Sevilla,Cádiz,942,1240155,217782,1022373,1942389,361391
2020/05/29,Sevilla,Málaga,74,1661785,281784,1380001,1942389,361391
2020/05/29,Sevilla,Córdoba,2307,782979,128085,654894,1942389,361391
2020/05/29,Sevilla,Madrid,16,6663394,1234277,5429117,1942389,361391
2020/05/29,Soria,Segovia,20,153129,23197,129932,88636,10822
2020/05/29,Soria,Soria,7600,88636,9930,78706,88636,10822
2020/05/29,Soria,Valladolid,32,519546,101324,418222,88636,10822
2020/05/29,Soria,Zaragoza,130,964724,200621,764103,88636,10822
2020/05/29,Soria,Burgos,116,357072,55471,301601,88636,10822
2020/05/29,Tarragona,Teruel,62,134137,12650,121487,804664,135596
2020/05/29,Tarragona,Lleida,23,434930,73932,360998,804664,135596
2020/05/29,Tarragona,Zaragoza,84,964724,200621,764103,804664,135596
2020/05/29,Tarragona,Barcelona,1463,5664579,1130995,4533584,804664,135596
2020/05/29,Tarragona,Tarragona,95330,804664,135055,669609,804664,135596
2020/05/29,Tarragona,Castellón,922,579962,93461,486501,804664,135596
2020/05/29,Teruel,Tarragona,108,804664,135055,669609,134137,14060
2020/05/29,Teruel,Guadalajara,28,257762,44177,213585,134137,14060
2020/05/29,Teruel,Valencia,26,2565124,519872,2045252,134137,14060
2020/05/29,Teruel,Teruel,7742,134137,12650,121487,134137,14060
2020/05/29,Teruel,Zaragoza,286,964724,200621,764103,134137,14060
2020/05/29,Teruel,Castellón,81,579962,93461,486501,134137,14060
2020/05/29,Toledo,Albacete,16,388167,46325,341842,694844,100865
2020/05/29,Toledo,Toledo,51989,694844,102895,591949,694844,100865
2020/05/29,Toledo,Madrid,4430,6663394,1234277,5429117,694844,100865
2020/05/29,Toledo,Ávila,296,157640,20605,137035,694844,100865
2020/05/29,Toledo,Ciudad Real,500,495761,54130,441631,694844,100865
2020/05/29,Toledo,Córdoba,16,782979,128085,654894,694844,100865
2020/05/29,Toledo,Cuenca,144,196329,24796,171533,694844,100865
2020/05/29,Toledo,Cáceres,244,394151,48907,345244,694844,100865
2020/05/29,Valencia,Teruel,132,134137,12650,121487,2565124,509732
2020/05/29,Valencia,Alicante,1204,1858683,324088,1534595,2565124,509732
2020/05/29,Valencia,Valencia,380935,2565124,519872,2045252,2565124,509732
2020/05/29,Valencia,Albacete,329,388167,46325,341842,2565124,509732
2020/05/29,Valencia,Cuenca,117,196329,24796,171533,2565124,509732
2020/05/29,Valencia,Castellón,826,579962,93461,486501,2565124,509732
2020/05/29,Valladolid,Burgos,115,357072,55471,301601,519546,98123
2020/05/29,Valladolid,Ávila,47,157640,20605,137035,519546,98123
2020/05/29,Valladolid,Zamora,199,172539,25657,146882,519546,98123
2020/05/29,Valladolid,Segovia,396,153129,23197,129932,519546,98123
2020/05/29,Valladolid,Soria,31,88636,9930,78706,519546,98123
2020/05/29,Valladolid,Palencia,58,160866,26873,133993,519546,98123
2020/05/29,Valladolid,León,35,460001,78267,381734,519546,98123
2020/05/29,Valladolid,Valladolid,77056,519546,101324,418222,519546,98123
2020/05/29,Zamora,Ourense,64,307651,58368,249283,172539,25621
2020/05/29,Zamora,Valladolid,144,519546,101324,418222,172539,25621
2020/05/29,Zamora,Zamora,18069,172539,25657,146882,172539,25621
2020/05/29,Zamora,León,58,460001,78267,381734,172539,25621
2020/05/29,Zaragoza,Zaragoza,159200,964724,200621,764103,964724,194387
2020/05/29,Zaragoza,Soria,87,88636,9930,78706,964724,194387
2020/05/29,Zaragoza,Huesca,349,220461,32827,187634,964724,194387
2020/05/29,Zaragoza,Teruel,295,134137,12650,121487,964724,194387
2020/05/29,Zaragoza,Lleida,153,434930,73932,360998,964724,194387
2020/05/29,Zaragoza,Navarra,591,654183,127873,526310,964724,194387
2020/05/30,Albacete,Jaén,96,633564,70706,562858,388167,40395
2020/05/30,Albacete,Murcia,614,1493898,234444,1259454,388167,40395
2020/05/30,Albacete,Alicante,192,1858683,275413,1583270,388167,40395
2020/05/30,Albacete,Albacete,27772,388167,38692,349475,388167,40395
2020/05/30,Albacete,Valencia,340,2565124,428158,2136966,388167,40395
2020/05/30,Albacete,Ciudad Real,518,495761,44421,451340,388167,40395
2020/05/30,Albacete,Cuenca,601,196329,20732,175597,388167,40395
2020/05/30,Alicante,Albacete,267,388167,38692,349475,1858683,278103
2020/05/30,Alicante,Murcia,3014,1493898,234444,1259454,1858683,278103
2020/05/30,Alicante,Valencia,1242,2565124,428158,2136966,1858683,278103
2020/05/30,Alicante,Alicante,223110,1858683,275413,1583270,1858683,278103
2020/05/30,Almería,Murcia,1235,1493898,234444,1259454,716820,95823
2020/05/30,Almería,Granada,391,914678,134651,780027,716820,95823
2020/05/30,Almería,Almería,79551,716820,95558,621262,716820,95823
2020/05/30,Araba,Gipuzkoa,388,723576,124551,599025,331549,69359
2020/05/30,Araba,Bizkaia,1615,1152934,245332,907602,331549,69359
2020/05/30,Araba,Burgos,1117,357072,49090,307982,331549,69359
2020/05/30,Araba,Rioja,1416,316798,51463,265335,331549,69359
2020/05/30,Araba,Araba,55857,331549,66534,265015,331549,69359
2020/05/30,Araba,Navarra,236,654183,113540,540643,331549,69359
2020/05/30,Asturias,Lugo,959,329587,45649,283938,1022800,187284
2020/05/30,Asturias,Cantabria,298,580795,107420,473375,1022800,187284
2020/05/30,Asturias,León,27,460001,69256,390745,1022800,187284
2020/05/30,Asturias,Asturias,159573,1022800,186967,835833,1022800,187284
2020/05/30,Ávila,Segovia,106,153129,19745,133384,157640,19670
2020/05/30,Ávila,Madrid,295,6663394,1044609,5618785,157640,19670
2020/05/30,Ávila,Toledo,281,694844,76739,618105,157640,19670
2020/05/30,Ávila,Ávila,12748,157640,17698,139942,157640,19670
2020/05/30,Ávila,Valladolid,32,519546,81686,437860,157640,19670
2020/05/30,Ávila,Cáceres,162,394151,44136,350015,157640,19670
2020/05/30,Ávila,Salamanca,336,330119,47258,282861,157640,19670
2020/05/30,Badajoz,Huelva,214,521870,74525,447345,673559,86533
2020/05/30,Badajoz,Córdoba,111,782979,110723,672256,673559,86533
2020/05/30,Badajoz,Badajoz,66946,673559,86940,586619,673559,86533
2020/05/30,Badajoz,Sevilla,68,1942389,308526,1633863,673559,86533
2020/05/30,Badajoz,Ciudad Real,54,495761,44421,451340,673559,86533
2020/05/30,Badajoz,Cáceres,1145,394151,44136,350015,673559,86533
2020/05/30,Balears,Balears,173285,1149460,191356,958104,1149460,192413
2020/05/30,Balears,Valencia,18,2565124,428158,2136966,1149460,192413
2020/05/30,Barcelona,Lleida,195,434930,60205,374725,5664579,885748
2020/05/30,Barcelona,Barcelona,606852,5664579,889024,4775555,5664579,885748
2020/05/30,Barcelona,Tarragona,1619,804664,118480,686184,5664579,885748
2020/05/30,Barcelona,Girona,2715,771044,98662,672382,5664579,885748
2020/05/30,Bizkaia,Bizkaia,201004,1152934,245332,907602,1152934,238735
2020/05/30,Bizkaia,Cantabria,1505,580795,107420,473375,1152934,238735
2020/05/30,Bizkaia,Burgos,67,357072,49090,307982,1152934,238735
2020/05/30,Bizkaia,Araba,1088,331549,66534,265015,1152934,238735
2020/05/30,Bizkaia,Gipuzkoa,947,723576,124551,599025,1152934,238735
2020/05/30,Burgos,Cantabria,61,580795,107420,473375,357072,52051
2020/05/30,Burgos,Bizkaia,280,1152934,245332,907602,357072,52051
2020/05/30,Burgos,Segovia,45,153129,19745,133384,357072,52051
2020/05/30,Burgos,Valladolid,106,519546,81686,437860,357072,52051
2020/05/30,Burgos,Palencia,198,160866,23023,137843,357072,52051
2020/05/30,Burgos,Soria,41,88636,9004,79632,357072,52051
2020/05/30,Burgos,Burgos,39797,357072,49090,307982,357072,52051
2020/05/30,Burgos,Araba,2743,331549,66534,265015,357072,52051
2020/05/30,Cáceres,Toledo,222,694844,76739,618105,394151,44178
2020/05/30,Cáceres,Cáceres,32138,394151,44136,350015,394151,44178
2020/05/30,Cáceres,Ávila,95,157640,17698,139942,394151,44178
2020/05/30,Cáceres,Badajoz,1086,673559,86940,586619,394151,44178
2020/05/30,Cádiz,Ceuta,72,84777,10422,74355,1240155,199074
2020/05/30,Cádiz,Cádiz,170829,1240155,197240,1042915,1240155,199074
2020/05/30,Cádiz,Málaga,1036,1661785,232864,1428921,1240155,199074
2020/05/30,Cádiz,Sevilla,847,1942389,308526,1633863,1240155,199074
2020/05/30,Cádiz,Huelva,686,521870,74525,447345,1240155,199074
2020/05/30,Cantabria,Asturias,267,1022800,186967,835833,580795,107863
2020/05/30,Cantabria,Burgos,17,357072,49090,307982,580795,107863
2020/05/30,Cantabria,Bizkaia,2785,1152934,245332,907602,580795,107863
2020/05/30,Cantabria,Palencia,52,160866,23023,137843,580795,107863
2020/05/30,Cantabria,Cantabria,87847,580795,107420,473375,580795,107863
2020/05/30,Castellón,Teruel,75,134137,10341,123796,579962,76554
2020/05/30,Castellón,Castellón,59019,579962,75146,504816,579962,76554
2020/05/30,Castellón,Tarragona,826,804664,118480,686184,579962,76554
2020/05/30,Castellón,Valencia,844,2565124,428158,2136966,579962,76554
2020/05/30,Ceuta,Ceuta,9798,84777,10422,74355,84777,10413
2020/05/30,Ceuta,Cádiz,166,1240155,197240,1042915,84777,10413
2020/05/30,Ciudad Real,Albacete,485,388167,38692,349475,495761,44346
2020/05/30,Ciudad Real,Ciudad Real,30881,495761,44421,451340,495761,44346
2020/05/30,Ciudad Real,Cuenca,47,196329,20732,175597,495761,44346
2020/05/30,Ciudad Real,Toledo,228,694844,76739,618105,495761,44346
2020/05/30,Ciudad Real,Córdoba,350,782979,110723,672256,495761,44346
2020/05/30,Ciudad Real,Badajoz,73,673559,86940,586619,495761,44346
2020/05/30,Córdoba,Jaén,643,633564,70706,562858,782979,109734
2020/05/30,Córdoba,Badajoz,136,673559,86940,586619,782979,109734
2020/05/30,Córdoba,Málaga,218,1661785,232864,1428921,782979,109734
2020/05/30,Córdoba,Córdoba,83600,782979,110723,672256,782979,109734
2020/05/30,Córdoba,Sevilla,1834,1942389,308526,1633863,782979,109734
2020/05/30,Córdoba,Ciudad Real,240,495761,44421,451340,782979,109734
2020/05/30,Córdoba,Granada,158,914678,134651,780027,782979,109734
2020/05/30,Coruña,Pontevedra,4946,942665,160049,782616,1119596,189736
2020/05/30,Coruña,Lugo,592,329587,45649,283938,1119596,189736
2020/05/30,Coruña,Coruña,146421,1119596,187493,932103,1119596,189736
2020/05/30,Cuenca,Guadalajara,41,257762,36747,221015,196329,21573
2020/05/30,Cuenca,Valencia,62,2565124,428158,2136966,196329,21573
2020/05/30,Cuenca,Madrid,28,6663394,1044609,5618785,196329,21573
2020/05/30,Cuenca,Cuenca,13095,196329,20732,175597,196329,21573
2020/05/30,Cuenca,Albacete,819,388167,38692,349475,196329,21573
2020/05/30,Cuenca,Toledo,130,694844,76739,618105,196329,21573
2020/05/30,Cuenca,Ciudad Real,92,495761,44421,451340,196329,21573
2020/05/30,Gipuzkoa,Bizkaia,1332,1152934,245332,907602,723576,124385
2020/05/30,Gipuzkoa,Araba,98,331549,66534,265015,723576,124385
2020/05/30,Gipuzkoa,Gipuzkoa,100058,723576,124551,599025,723576,124385
2020/05/30,Gipuzkoa,Navarra,364,654183,113540,540643,723576,124385
2020/05/30,Girona,Lleida,203,434930,60205,374725,771044,102622
2020/05/30,Girona,Barcelona,2557,5664579,889024,4775555,771044,102622
2020/05/30,Girona,Girona,69495,771044,98662,672382,771044,102622
2020/05/30,Granada,Almería,557,716820,95558,621262,914678,135647
2020/05/30,Granada,Jaén,469,633564,70706,562858,914678,135647
2020/05/30,Granada,Córdoba,266,782979,110723,672256,914678,135647
2020/05/30,Granada,Murcia,56,1493898,234444,1259454,914678,135647
2020/05/30,Granada,Granada,103829,914678,134651,780027,914678,135647
2020/05/30,Granada,Málaga,220,1661785,232864,1428921,914678,135647
2020/05/30,Guadalajara,Madrid,1946,6663394,1044609,5618785,257762,39821
2020/05/30,Guadalajara,Guadalajara,26041,257762,36747,221015,257762,39821
2020/05/30,Guadalajara,Cuenca,45,196329,20732,175597,257762,39821
2020/05/30,Huelva,Cádiz,645,1240155,197240,1042915,521870,76153
2020/05/30,Huelva,Huelva,61028,521870,74525,447345,521870,76153
2020/05/30,Huelva,Sevilla,969,1942389,308526,1633863,521870,76153
2020/05/30,Huelva,Badajoz,311,673559,86940,586619,521870,76153
2020/05/30,Huesca,Huesca,21637,220461,29084,191377,220461,31374
2020/05/30,Huesca,Lleida,920,434930,60205,374725,220461,31374
2020/05/30,Huesca,Zaragoza,426,964724,172014,792710,220461,31374
2020/05/30,Jaén,Córdoba,708,782979,110723,672256,633564,70651
2020/05/30,Jaén,Jaén,52033,633564,70706,562858,633564,70651
2020/05/30,Jaén,Granada,288,914678,134651,780027,633564,70651
2020/05/30,Las Palmas de Gran Canaria,Las Palmas de Gran Canaria,158172,1120406,170699,949707,1120406,169143
2020/05/30,Las Palmas de Gran Canaria,Santa Cruz de Tenerife,48,1032983,156421,876562,1120406,169143
2020/05/30,León,Valladolid,26,519546,81686,437860,460001,69591
2020/05/30,León,Asturias,52,1022800,186967,835833,460001,69591
2020/05/30,León,León,54747,460001,69256,390745,460001,69591
2020/05/30,León,Ourense,148,307651,49445,258206,460001,69591
2020/05/30,León,Palencia,37,160866,23023,137843,460001,69591
2020/05/30,León,Zamora,114,172539,21591,150948,460001,69591
2020/05/30,Lleida,Tarragona,38,804664,118480,686184,434930,58947
2020/05/30,Lleida,Huesca,654,220461,29084,191377,434930,58947
2020/05/30,Lleida,Girona,267,771044,98662,672382,434930,58947
2020/05/30,Lleida,Barcelona,325,5664579,889024,4775555,434930,58947
2020/05/30,Lleida,Lleida,42261,434930,60205,374725,434930,58947
2020/05/30,Lleida,Zaragoza,156,964724,172014,792710,434930,58947
2020/05/30,Lugo,Coruña,586,1119596,187493,932103,329587,46960
2020/05/30,Lugo,Ourense,182,307651,49445,258206,329587,46960
2020/05/30,Lugo,Asturias,710,1022800,186967,835833,329587,46960
2020/05/30,Lugo,Lugo,34408,329587,45649,283938,329587,46960
2020/05/30,Madrid,Guadalajara,1957,257762,36747,221015,6663394,1034730
2020/05/30,Madrid,Toledo,3033,694844,76739,618105,6663394,1034730
2020/05/30,Madrid,Ávila,395,157640,17698,139942,6663394,1034730
2020/05/30,Madrid,Madrid,616100,6663394,1044609,5618785,6663394,1034730
2020/05/30,Madrid,Balears,19,1149460,191356,958104,6663394,1034730
2020/05/30,Madrid,Cuenca,106,196329,20732,175597,6663394,1034730
2020/05/30,Málaga,Sevilla,249,1942389,308526,1633863,1661785,232659
2020/05/30,Málaga,Córdoba,306,782979,110723,672256,1661785,232659
2020/05/30,Málaga,Granada,206,914678,134651,780027,1661785,232659
2020/05/30,Málaga,Málaga,196152,1661785,232864,1428921,1661785,232659
2020/05/30,Málaga,Cádiz,989,1240155,197240,1042915,1661785,232659
2020/05/30,Melilla,Melilla,13395,86487,13639,72848,86487,13640
2020/05/30,Murcia,Albacete,379,388167,38692,349475,1493898,231584
2020/05/30,Murcia,Alicante,2423,1858683,275413,1583270,1493898,231584
2020/05/30,Murcia,Murcia,193348,1493898,234444,1259454,1493898,231584
2020/05/30,Murcia,Almería,1057,716820,95558,621262,1493898,231584
2020/05/30,Murcia,Granada,30,914678,134651,780027,1493898,231584
2020/05/30,Navarra,Gipuzkoa,509,723576,124551,599025,654183,113988
2020/05/30,Navarra,Araba,99,331549,66534,265015,654183,113988
2020/05/30,Navarra,Zaragoza,605,964724,172014,792710,654183,113988
2020/05/30,Navarra,Navarra,88296,654183,113540,540643,654183,113988
2020/05/30,Navarra,Rioja,1488,316798,51463,265335,654183,113988
2020/05/30,Ourense,Pontevedra,192,942665,160049,782616,307651,50352
2020/05/30,Ourense,León,127,460001,69256,390745,307651,50352
2020/05/30,Ourense,Ourense,40770,307651,49445,258206,307651,50352
2020/05/30,Ourense,Lugo,170,329587,45649,283938,307651,50352
2020/05/30,Palencia,Burgos,227,357072,49090,307982,160866,23846
2020/05/30,Palencia,Palencia,17746,160866,23023,137843,160866,23846
2020/05/30,Palencia,León,22,460001,69256,390745,160866,23846
2020/05/30,Palencia,Valladolid,181,519546,81686,437860,160866,23846
2020/05/30,Palencia,Cantabria,33,580795,107420,473375,160866,23846
2020/05/30,Pontevedra,Pontevedra,126768,942665,160049,782616,942665,159432
2020/05/30,Pontevedra,Lugo,16,329587,45649,283938,942665,159432
2020/05/30,Pontevedra,Coruña,4366,1119596,187493,932103,942665,159432
2020/05/30,Pontevedra,Ourense,213,307651,49445,258206,942665,159432
2020/05/30,Rioja,Araba,674,331549,66534,265015,316798,50692
2020/05/30,Rioja,Navarra,1492,654183,113540,540643,316798,50692
2020/05/30,Rioja,Rioja,42339,316798,51463,265335,316798,50692
2020/05/30,Salamanca,Ávila,232,157640,17698,139942,330119,47165
2020/05/30,Salamanca,Zamora,98,172539,21591,150948,330119,47165
2020/05/30,Salamanca,Salamanca,38704,330119,47258,282861,330119,47165
2020/05/30,Santa Cruz de Tenerife,Las Palmas de Gran Canaria,78,1120406,170699,949707,1032983,156607
2020/05/30,Santa Cruz de Tenerife,Santa Cruz de Tenerife,142071,1032983,156421,876562,1032983,156607
2020/05/30,Segovia,Segovia,14662,153129,19745,133384,153129,21018
2020/05/30,Segovia,Ávila,40,157640,17698,139942,153129,21018
2020/05/30,Segovia,Valladolid,342,519546,81686,437860,153129,21018
2020/05/30,Segovia,Burgos,169,357072,49090,307982,153129,21018
2020/05/30,Sevilla,Badajoz,96,673559,86940,586619,1942389,306333
2020/05/30,Sevilla,Huelva,640,521870,74525,447345,1942389,306333
2020/05/30,Sevilla,Córdoba,2110,782979,110723,672256,1942389,306333
2020/05/30,Sevilla,Sevilla,231686,1942389,308526,1633863,1942389,306333
2020/05/30,Sevilla,Cádiz,903,1240155,197240,1042915,1942389,306333
2020/05/30,Sevilla,Málaga,57,1661785,232864,1428921,1942389,306333
2020/05/30,Soria,Segovia,19,153129,19745,133384,88636,9500
2020/05/30,Soria,Valladolid,27,519546,81686,437860,88636,9500
2020/05/30,Soria,Burgos,93,357072,49090,307982,88636,9500
2020/05/30,Soria,Soria,7433,88636,9004,79632,88636,9500
2020/05/30,Soria,Zaragoza,31,964724,172014,792710,88636,9500
2020/05/30,Tarragona,Barcelona,1511,5664579,889024,4775555,804664,119282
2020/05/30,Tarragona,Zaragoza,57,964724,172014,792710,804664,119282
2020/05/30,Tarragona,Tarragona,87649,804664,118480,686184,804664,119282
2020/05/30,Tarragona,Teruel,61,134137,10341,123796,804664,119282
2020/05/30,Tarragona,Castellón,655,579962,75146,504816,804664,119282
2020/05/30,Teruel,Tarragona,101,804664,118480,686184,134137,11478
2020/05/30,Teruel,Castellón,67,579962,75146,504816,134137,11478
2020/05/30,Teruel,Zaragoza,291,964724,172014,792710,134137,11478
2020/05/30,Teruel,Teruel,6782,134137,10341,123796,134137,11478
2020/05/30,Toledo,Cuenca,47,196329,20732,175597,694844,79815
2020/05/30,Toledo,Madrid,2715,6663394,1044609,5618785,694844,79815
2020/05/30,Toledo,Ciudad Real,227,495761,44421,451340,694844,79815
2020/05/30,Toledo,Toledo,44368,694844,76739,618105,694844,79815
2020/05/30,Toledo,Melilla,17,86487,13639,72848,694844,79815
2020/05/30,Toledo,Ávila,328,157640,17698,139942,694844,79815
2020/05/30,Toledo,Cáceres,226,394151,44136,350015,694844,79815
2020/05/30,Valencia,Albacete,222,388167,38692,349475,2565124,423345
2020/05/30,Valencia,Cuenca,79,196329,20732,175597,2565124,423345
2020/05/30,Valencia,Alicante,967,1858683,275413,1583270,2565124,423345
2020/05/30,Valencia,Valencia,312442,2565124,428158,2136966,2565124,423345
2020/05/30,Valencia,Cáceres,18,394151,44136,350015,2565124,423345
2020/05/30,Valencia,Teruel,30,134137,10341,123796,2565124,423345
2020/05/30,Valencia,Castellón,621,579962,75146,504816,2565124,423345
2020/05/30,Valladolid,Valladolid,64222,519546,81686,437860,519546,79143
2020/05/30,Valladolid,Ávila,33,157640,17698,139942,519546,79143
2020/05/30,Valladolid,Segovia,326,153129,19745,133384,519546,79143
2020/05/30,Valladolid,Soria,28,88636,9004,79632,519546,79143
2020/05/30,Valladolid,León,42,460001,69256,390745,519546,79143
2020/05/30,Valladolid,Palencia,54,160866,23023,137843,519546,79143
2020/05/30,Valladolid,Burgos,116,357072,49090,307982,519546,79143
2020/05/30,Valladolid,Zamora,110,172539,21591,150948,519546,79143
2020/05/30,Zamora,Ourense,19,307651,49445,258206,172539,21812
2020/05/30,Zamora,Zamora,16092,172539,21591,150948,172539,21812
2020/05/30,Zamora,León,70,460001,69256,390745,172539,21812
2020/05/30,Zamora,Salamanca,42,330119,47258,282861,172539,21812
2020/05/30,Zamora,Valladolid,184,519546,81686,437860,172539,21812
2020/05/30,Zaragoza,Navarra,593,654183,113540,540643,964724,166813
2020/05/30,Zaragoza,Soria,77,88636,9004,79632,964724,166813
2020/05/30,Zaragoza,Lleida,130,434930,60205,374725,964724,166813
2020/05/30,Zaragoza,Teruel,126,134137,10341,123796,964724,166813
2020/05/30,Zaragoza,Huesca,348,220461,29084,191377,964724,166813
2020/05/30,Zaragoza,Zaragoza,137121,964724,172014,792710,964724,166813
2020/05/31,Albacete,Albacete,20257,388167,29110,359057,388167,29696
2020/05/31,Albacete,Murcia,309,1493898,193415,1300483,388167,29696
2020/05/31,Albacete,Cuenca,325,196329,15910,180419,388167,29696
2020/05/31,Albacete,Valencia,304,2565124,371474,2193650,388167,29696
2020/05/31,Albacete,Jaén,73,633564,60009,573555,388167,29696
2020/05/31,Albacete,Alicante,251,1858683,239401,1619282,388167,29696
2020/05/31,Albacete,Ciudad Real,354,495761,34254,461507,388167,29696
2020/05/31,Alicante,Alicante,192781,1858683,239401,1619282,1858683,240600
2020/05/31,Alicante,Albacete,281,388167,29110,359057,1858683,240600
2020/05/31,Alicante,Murcia,2293,1493898,193415,1300483,1858683,240600
2020/05/31,Alicante,Valencia,1128,2565124,371474,2193650,1858683,240600
2020/05/31,Almería,Murcia,818,1493898,193415,1300483,716820,74810
2020/05/31,Almería,Almería,62796,716820,77077,639743,716820,74810
2020/05/31,Almería,Granada,365,914678,110465,804213,716820,74810
2020/05/31,Araba,Burgos,976,357072,34443,322629,331549,55914
2020/05/31,Araba,Araba,44760,331549,52637,278912,331549,55914
2020/05/31,Araba,Bizkaia,1170,1152934,199343,953591,331549,55914
2020/05/31,Araba,Navarra,225,654183,92525,561658,331549,55914
2020/05/31,Araba,Gipuzkoa,241,723576,107218,616358,331549,55914
2020/05/31,Araba,Rioja,996,316798,39786,277012,331549,55914
2020/05/31,Asturias,Cantabria,256,580795,81868,498927,1022800,129333
2020/05/31,Asturias,León,32,460001,50407,409594,1022800,129333
2020/05/31,Asturias,Lugo,831,329587,35830,293757,1022800,129333
2020/05/31,Asturias,Asturias,102582,1022800,129518,893282,1022800,129333
2020/05/31,Ávila,Toledo,272,694844,58912,635932,157640,14245
2020/05/31,Ávila,Ávila,9760,157640,13783,143857,157640,14245
2020/05/31,Ávila,Valladolid,29,519546,59838,459708,157640,14245
2020/05/31,Ávila,Salamanca,183,330119,36040,294079,157640,14245
2020/05/31,Ávila,Madrid,185,6663394,850544,5812850,157640,14245
2020/05/31,Ávila,Segovia,50,153129,14212,138917,157640,14245
2020/05/31,Ávila,Cáceres,122,394151,36225,357926,157640,14245
2020/05/31,Badajoz,Ciudad Real,77,495761,34254,461507,673559,69505
2020/05/31,Badajoz,Huelva,193,521870,56665,465205,673559,69505
2020/05/31,Badajoz,Cáceres,856,394151,36225,357926,673559,69505
2020/05/31,Badajoz,Córdoba,147,782979,92020,690959,673559,69505
2020/05/31,Badajoz,Badajoz,54174,673559,70489,603070,673559,69505
2020/05/31,Badajoz,Sevilla,56,1942389,249017,1693372,673559,69505
2020/05/31,Balears,Balears,153262,1149460,169327,980133,1149460,169854
2020/05/31,Barcelona,Barcelona,529596,5664579,767715,4896864,5664579,768520
2020/05/31,Barcelona,Lleida,208,434930,49478,385452,5664579,768520
2020/05/31,Barcelona,Tarragona,1270,804664,102101,702563,5664579,768520
2020/05/31,Barcelona,Girona,2652,771044,88317,682727,5664579,768520
2020/05/31,Bizkaia,Cantabria,985,580795,81868,498927,1152934,195232
2020/05/31,Bizkaia,Gipuzkoa,817,723576,107218,616358,1152934,195232
2020/05/31,Bizkaia,Bizkaia,159856,1152934,199343,953591,1152934,195232
2020/05/31,Bizkaia,Araba,800,331549,52637,278912,1152934,195232
2020/05/31,Burgos,Rioja,16,316798,39786,277012,357072,36670
2020/05/31,Burgos,Palencia,122,160866,16612,144254,357072,36670
2020/05/31,Burgos,Soria,24,88636,6732,81904,357072,36670
2020/05/31,Burgos,Burgos,27274,357072,34443,322629,357072,36670
2020/05/31,Burgos,Valladolid,126,519546,59838,459708,357072,36670
2020/05/31,Burgos,Segovia,23,153129,14212,138917,357072,36670
2020/05/31,Burgos,Cantabria,32,580795,81868,498927,357072,36670
2020/05/31,Burgos,Araba,1956,331549,52637,278912,357072,36670
2020/05/31,Burgos,Bizkaia,195,1152934,199343,953591,357072,36670
2020/05/31,Cáceres,Toledo,109,694844,58912,635932,394151,35931
2020/05/31,Cáceres,Cáceres,25674,394151,36225,357926,394151,35931
2020/05/31,Cáceres,Ávila,109,157640,13783,143857,394151,35931
2020/05/31,Cáceres,Badajoz,764,673559,70489,603070,394151,35931
2020/05/31,Cádiz,Huelva,563,521870,56665,465205,1240155,151434
2020/05/31,Cádiz,Málaga,765,1661785,184705,1477080,1240155,151434
2020/05/31,Cádiz,Ceuta,106,84777,8541,76236,1240155,151434
2020/05/31,Cádiz,Cádiz,127735,1240155,150493,1089662,1240155,151434
2020/05/31,Cádiz,Sevilla,874,1942389,249017,1693372,1240155,151434
2020/05/31,Cantabria,Burgos,39,357072,34443,322629,580795,81585
2020/05/31,Cantabria,Palencia,53,160866,16612,144254,580795,81585
2020/05/31,Cantabria,Cantabria,64560,580795,81868,498927,580795,81585
2020/05/31,Cantabria,Asturias,181,1022800,129518,893282,580795,81585
2020/05/31,Cantabria,Bizkaia,1791,1152934,199343,953591,580795,81585
2020/05/31,Castellón,Castellón,51230,579962,64410,515552,579962,65653
2020/05/31,Castellón,Teruel,27,134137,7900,126237,579962,65653
2020/05/31,Castellón,Valencia,819,2565124,371474,2193650,579962,65653
2020/05/31,Castellón,Tarragona,735,804664,102101,702563,579962,65653
2020/05/31,Ceuta,Cádiz,46,1240155,150493,1089662,84777,8452
2020/05/31,Ceuta,Ceuta,7997,84777,8541,76236,84777,8452
2020/05/31,Ciudad Real,Badajoz,75,673559,70489,603070,495761,33909
2020/05/31,Ciudad Real,Córdoba,314,782979,92020,690959,495761,33909
2020/05/31,Ciudad Real,Ciudad Real,23295,495761,34254,461507,495761,33909
2020/05/31,Ciudad Real,Jaén,16,633564,60009,573555,495761,33909
2020/05/31,Ciudad Real,Cuenca,42,196329,15910,180419,495761,33909
2020/05/31,Ciudad Real,Albacete,367,388167,29110,359057,495761,33909
2020/05/31,Ciudad Real,Toledo,152,694844,58912,635932,495761,33909
2020/05/31,Córdoba,Sevilla,1492,1942389,249017,1693372,782979,90567
2020/05/31,Córdoba,Granada,130,914678,110465,804213,782979,90567
2020/05/31,Córdoba,Ciudad Real,194,495761,34254,461507,782979,90567
2020/05/31,Córdoba,Córdoba,68615,782979,92020,690959,782979,90567
2020/05/31,Córdoba,Jaén,593,633564,60009,573555,782979,90567
2020/05/31,Córdoba,Badajoz,135,673559,70489,603070,782979,90567
2020/05/31,Córdoba,Málaga,177,1661785,184705,1477080,782979,90567
2020/05/31,Coruña,Lugo,420,329587,35830,293757,1119596,145120
2020/05/31,Coruña,Pontevedra,3935,942665,125714,816951,1119596,145120
2020/05/31,Coruña,Coruña,107994,1119596,144408,975188,1119596,145120
2020/05/31,Cuenca,Valencia,98,2565124,371474,2193650,196329,16626
2020/05/31,Cuenca,Albacete,530,388167,29110,359057,196329,16626
2020/05/31,Cuenca,Guadalajara,58,257762,27837,229925,196329,16626
2020/05/31,Cuenca,Toledo,36,694844,58912,635932,196329,16626
2020/05/31,Cuenca,Madrid,30,6663394,850544,5812850,196329,16626
2020/05/31,Cuenca,Cuenca,10581,196329,15910,180419,196329,16626
2020/05/31,Cuenca,Ciudad Real,47,495761,34254,461507,196329,16626
2020/05/31,Gipuzkoa,Gipuzkoa,85965,723576,107218,616358,723576,106594
2020/05/31,Gipuzkoa,Bizkaia,840,1152934,199343,953591,723576,106594
2020/05/31,Gipuzkoa,Navarra,286,654183,92525,561658,723576,106594
2020/05/31,Gipuzkoa,Araba,105,331549,52637,278912,723576,106594
2020/05/31,Girona,Barcelona,2114,5664579,767715,4896864,771044,89482
2020/05/31,Girona,Lleida,196,434930,49478,385452,771044,89482
2020/05/31,Girona,Girona,59885,771044,88317,682727,771044,89482
2020/05/31,Granada,Jaén,369,633564,60009,573555,914678,111124
2020/05/31,Granada,Málaga,125,1661785,184705,1477080,914678,111124
2020/05/31,Granada,Córdoba,282,782979,92020,690959,914678,111124
2020/05/31,Granada,Murcia,37,1493898,193415,1300483,914678,111124
2020/05/31,Granada,Almería,791,716820,77077,639743,914678,111124
2020/05/31,Granada,Granada,82203,914678,110465,804213,914678,111124
2020/05/31,Guadalajara,Cuenca,78,196329,15910,180419,257762,28391
2020/05/31,Guadalajara,Teruel,19,134137,7900,126237,257762,28391
2020/05/31,Guadalajara,Guadalajara,19122,257762,27837,229925,257762,28391
2020/05/31,Guadalajara,Madrid,1136,6663394,850544,5812850,257762,28391
2020/05/31,Huelva,Huelva,44814,521870,56665,465205,521870,56842
2020/05/31,Huelva,Sevilla,476,1942389,249017,1693372,521870,56842
2020/05/31,Huelva,Cádiz,526,1240155,150493,1089662,521870,56842
2020/05/31,Huelva,Badajoz,247,673559,70489,603070,521870,56842
2020/05/31,Huesca,Huesca,18182,220461,24057,196404,220461,25999
2020/05/31,Huesca,Lleida,854,434930,49478,385452,220461,25999
2020/05/31,Huesca,Zaragoza,362,964724,137524,827200,220461,25999
2020/05/31,Jaén,Granada,221,914678,110465,804213,633564,59347
2020/05/31,Jaén,Córdoba,618,782979,92020,690959,633564,59347
2020/05/31,Jaén,Albacete,28,388167,29110,359057,633564,59347
2020/05/31,Jaén,Jaén,44002,633564,60009,573555,633564,59347
2020/05/31,Las Palmas de Gran Canaria,Las Palmas de Gran Canaria,129170,1120406,140940,979466,1120406,140047
2020/05/31,León,León,38111,460001,50407,409594,460001,50213
2020/05/31,León,Lugo,29,329587,35830,293757,460001,50213
2020/05/31,León,Zamora,68,172539,15788,156751,460001,50213
2020/05/31,León,Valladolid,37,519546,59838,459708,460001,50213
2020/05/31,León,Asturias,56,1022800,129518,893282,460001,50213
2020/05/31,León,Ourense,114,307651,40711,266940,460001,50213
2020/05/31,León,Palencia,30,160866,16612,144254,460001,50213
2020/05/31,Lleida,Tarragona,55,804664,102101,702563,434930,48819
2020/05/31,Lleida,Lleida,34793,434930,49478,385452,434930,48819
2020/05/31,Lleida,Barcelona,325,5664579,767715,4896864,434930,48819
2020/05/31,Lleida,Zaragoza,127,964724,137524,827200,434930,48819
2020/05/31,Lleida,Girona,269,771044,88317,682727,434930,48819
2020/05/31,Lleida,Huesca,425,220461,24057,196404,434930,48819
2020/05/31,Lugo,Ourense,148,307651,40711,266940,329587,36353
2020/05/31,Lugo,Coruña,518,1119596,144408,975188,329587,36353
2020/05/31,Lugo,Asturias,663,1022800,129518,893282,329587,36353
2020/05/31,Lugo,Lugo,25813,329587,35830,293757,329587,36353
2020/05/31,Madrid,Guadalajara,1356,257762,27837,229925,6663394,851624
2020/05/31,Madrid,Madrid,507669,6663394,850544,5812850,6663394,851624
2020/05/31,Madrid,Ávila,279,157640,13783,143857,6663394,851624
2020/05/31,Madrid,Cuenca,71,196329,15910,180419,6663394,851624
2020/05/31,Madrid,Toledo,2085,694844,58912,635932,6663394,851624
2020/05/31,Málaga,Málaga,153369,1661785,184705,1477080,1661785,184356
2020/05/31,Málaga,Granada,168,914678,110465,804213,1661785,184356
2020/05/31,Málaga,Córdoba,172,782979,92020,690959,1661785,184356
2020/05/31,Málaga,Cádiz,688,1240155,150493,1089662,1661785,184356
2020/05/31,Málaga,Sevilla,82,1942389,249017,1693372,1661785,184356
2020/05/31,Melilla,Melilla,11145,86487,11296,75191,86487,11355
2020/05/31,Murcia,Almería,841,716820,77077,639743,1493898,190352
2020/05/31,Murcia,Alicante,1721,1858683,239401,1619282,1493898,190352
2020/05/31,Murcia,Albacete,189,388167,29110,359057,1493898,190352
2020/05/31,Murcia,Murcia,159294,1493898,193415,1300483,1493898,190352
2020/05/31,Navarra,Gipuzkoa,476,723576,107218,616358,654183,93443
2020/05/31,Navarra,Zaragoza,398,964724,137524,827200,654183,93443
2020/05/31,Navarra,Navarra,71461,654183,92525,561658,654183,93443
2020/05/31,Navarra,Araba,64,331549,52637,278912,654183,93443
2020/05/31,Navarra,Rioja,817,316798,39786,277012,654183,93443
2020/05/31,Ourense,Lugo,263,329587,35830,293757,307651,40711
2020/05/31,Ourense,Pontevedra,201,942665,125714,816951,307651,40711
2020/05/31,Ourense,León,77,460001,50407,409594,307651,40711
2020/05/31,Ourense,Ourense,33084,307651,40711,266940,307651,40711
2020/05/31,Palencia,Palencia,12336,160866,16612,144254,160866,16894
2020/05/31,Palencia,Burgos,168,357072,34443,322629,160866,16894
2020/05/31,Palencia,Valladolid,100,519546,59838,459708,160866,16894
2020/05/31,Palencia,Cantabria,51,580795,81868,498927,160866,16894
2020/05/31,Palencia,León,27,460001,50407,409594,160866,16894
2020/05/31,Pontevedra,Coruña,3709,1119596,144408,975188,942665,126154
2020/05/31,Pontevedra,Ourense,189,307651,40711,266940,942665,126154
2020/05/31,Pontevedra,Pontevedra,96626,942665,125714,816951,942665,126154
2020/05/31,Rioja,Rioja,32572,316798,39786,277012,316798,39204
2020/05/31,Rioja,Araba,422,331549,52637,278912,316798,39204
2020/05/31,Rioja,Navarra,1007,654183,92525,561658,316798,39204
2020/05/31,Salamanca,Ávila,187,157640,13783,143857,330119,36045
2020/05/31,Salamanca,Salamanca,28702,330119,36040,294079,330119,36045
2020/05/31,Salamanca,Valladolid,16,519546,59838,459708,330119,36045
2020/05/31,Salamanca,Zamora,48,172539,15788,156751,330119,36045
2020/05/31,Santa Cruz de Tenerife,Las Palmas de Gran Canaria,53,1120406,140940,979466,1032983,127011
2020/05/31,Santa Cruz de Tenerife,Santa Cruz de Tenerife,113036,1032983,127230,905753,1032983,127011
2020/05/31,Segovia,Ávila,49,157640,13783,143857,153129,14715
2020/05/31,Segovia,Burgos,96,357072,34443,322629,153129,14715
2020/05/31,Segovia,Valladolid,235,519546,59838,459708,153129,14715
2020/05/31,Segovia,Segovia,10262,153129,14212,138917,153129,14715
2020/05/31,Sevilla,Badajoz,91,673559,70489,603070,1942389,248018
2020/05/31,Sevilla,Córdoba,1860,782979,92020,690959,1942389,248018
2020/05/31,Sevilla,Cádiz,756,1240155,150493,1089662,1942389,248018
2020/05/31,Sevilla,Sevilla,179878,1942389,249017,1693372,1942389,248018
2020/05/31,Sevilla,Huelva,360,521870,56665,465205,1942389,248018
2020/05/31,Sevilla,Málaga,29,1661785,184705,1477080,1942389,248018
2020/05/31,Soria,Burgos,26,357072,34443,322629,88636,7053
2020/05/31,Soria,Soria,5586,88636,6732,81904,88636,7053
2020/05/31,Soria,Valladolid,49,519546,59838,459708,88636,7053
2020/05/31,Tarragona,Zaragoza,43,964724,137524,827200,804664,102102
2020/05/31,Tarragona,Teruel,74,134137,7900,126237,804664,102102
2020/05/31,Tarragona,Barcelona,1296,5664579,767715,4896864,804664,102102
2020/05/31,Tarragona,Lleida,17,434930,49478,385452,804664,102102
2020/05/31,Tarragona,Castellón,496,579962,64410,515552,804664,102102
2020/05/31,Tarragona,Tarragona,76182,804664,102101,702563,804664,102102
2020/05/31,Teruel,Castellón,27,579962,64410,515552,134137,8880
2020/05/31,Teruel,Tarragona,63,804664,102101,702563,134137,8880
2020/05/31,Teruel,Zaragoza,134,964724,137524,827200,134137,8880
2020/05/31,Teruel,Teruel,5242,134137,7900,126237,134137,8880
2020/05/31,Toledo,Ávila,303,157640,13783,143857,694844,60289
2020/05/31,Toledo,Toledo,34097,694844,58912,635932,694844,60289
2020/05/31,Toledo,Cáceres,227,394151,36225,357926,694844,60289
2020/05/31,Toledo,Ciudad Real,177,495761,34254,461507,694844,60289
2020/05/31,Toledo,Madrid,1985,6663394,850544,5812850,694844,60289
2020/05/31,Valencia,Cuenca,93,196329,15910,180419,2565124,369234
2020/05/31,Valencia,Albacete,168,388167,29110,359057,2565124,369234
2020/05/31,Valencia,Alicante,891,1858683,239401,1619282,2565124,369234
2020/05/31,Valencia,Valencia,266043,2565124,371474,2193650,2565124,369234
2020/05/31,Valencia,Castellón,633,579962,64410,515552,2565124,369234
2020/05/31,Valladolid,Zamora,145,172539,15788,156751,519546,59001
2020/05/31,Valladolid,Salamanca,16,330119,36040,294079,519546,59001
2020/05/31,Valladolid,Palencia,38,160866,16612,144254,519546,59001
2020/05/31,Valladolid,Ávila,62,157640,13783,143857,519546,59001
2020/05/31,Valladolid,Burgos,125,357072,34443,322629,519546,59001
2020/05/31,Valladolid,Segovia,223,153129,14212,138917,519546,59001
2020/05/31,Valladolid,Valladolid,44748,519546,59838,459708,519546,59001
2020/05/31,Valladolid,León,45,460001,50407,409594,519546,59001
2020/05/31,Valladolid,Soria,40,88636,6732,81904,519546,59001
2020/05/31,Zamora,Ourense,31,307651,40711,266940,172539,15914
2020/05/31,Zamora,Salamanca,39,330119,36040,294079,172539,15914
2020/05/31,Zamora,Zamora,11675,172539,15788,156751,172539,15914
2020/05/31,Zamora,Valladolid,55,519546,59838,459708,172539,15914
2020/05/31,Zaragoza,Zaragoza,106961,964724,137524,827200,964724,135074
2020/05/31,Zaragoza,Navarra,392,654183,92525,561658,964724,135074
2020/05/31,Zaragoza,Tarragona,39,804664,102101,702563,964724,135074
2020/05/31,Zaragoza,Lleida,82,434930,49478,385452,964724,135074
2020/05/31,Zaragoza,Huesca,274,220461,24057,196404,964724,135074
2020/05/31,Zaragoza,Teruel,47,134137,7900,126237,964724,135074
2020/06/01,Albacete,Murcia,618,1493898,260688,1233210,388167,44625
2020/06/01,Albacete,Alicante,225,1858683,322920,1535763,388167,44625
2020/06/01,Albacete,Ciudad Real,637,495761,51658,444103,388167,44625
2020/06/01,Albacete,Albacete,27753,388167,44670,343497,388167,44625
2020/06/01,Albacete,Valencia,373,2565124,518104,2047020,388167,44625
2020/06/01,Albacete,Granada,29,914678,148859,765819,388167,44625
2020/06/01,Albacete,Cuenca,961,196329,23149,173180,388167,44625
2020/06/01,Albacete,Jaén,65,633564,79448,554116,388167,44625
2020/06/01,Alicante,Valencia,1655,2565124,518104,2047020,1858683,326594
2020/06/01,Alicante,Alicante,252727,1858683,322920,1535763,1858683,326594
2020/06/01,Alicante,Almería,17,716820,107905,608915,1858683,326594
2020/06/01,Alicante,Murcia,3131,1493898,260688,1233210,1858683,326594
2020/06/01,Alicante,Albacete,409,388167,44670,343497,1858683,326594
2020/06/01,Almería,Almería,89569,716820,107905,608915,716820,110776
2020/06/01,Almería,Murcia,1941,1493898,260688,1233210,716820,110776
2020/06/01,Almería,Granada,614,914678,148859,765819,716820,110776
2020/06/01,Araba,Navarra,235,654183,119018,535165,331549,75599
2020/06/01,Araba,Burgos,2027,357072,52334,304738,331549,75599
2020/06/01,Araba,Rioja,2324,316798,55134,261664,331549,75599
2020/06/01,Araba,Bizkaia,1961,1152934,252457,900477,331549,75599
2020/06/01,Araba,Gipuzkoa,353,723576,128110,595466,331549,75599
2020/06/01,Araba,Araba,55005,331549,66383,265166,331549,75599
2020/06/01,Asturias,León,39,460001,77331,382670,1022800,184520
2020/06/01,Asturias,Asturias,151005,1022800,186485,836315,1022800,184520
2020/06/01,Asturias,Cantabria,252,580795,97657,483138,1022800,184520
2020/06/01,Asturias,Lugo,1105,329587,53622,275965,1022800,184520
2020/06/01,Ávila,Madrid,187,6663394,1187608,5475786,157640,21700
2020/06/01,Ávila,Valladolid,29,519546,94688,424858,157640,21700
2020/06/01,Ávila,Ávila,13292,157640,20796,136844,157640,21700
2020/06/01,Ávila,Salamanca,354,330119,52436,277683,157640,21700
2020/06/01,Ávila,Cáceres,190,394151,53719,340432,157640,21700
2020/06/01,Ávila,Toledo,316,694844,104704,590140,157640,21700
2020/06/01,Ávila,Segovia,132,153129,22695,130434,157640,21700
2020/06/01,Badajoz,Sevilla,74,1942389,358320,1584069,673559,100221
2020/06/01,Badajoz,Cáceres,1421,394151,53719,340432,673559,100221
2020/06/01,Badajoz,Huelva,243,521870,83753,438117,673559,100221
2020/06/01,Badajoz,Badajoz,75629,673559,101923,571636,673559,100221
2020/06/01,Badajoz,Córdoba,99,782979,124859,658120,673559,100221
2020/06/01,Badajoz,Ciudad Real,80,495761,51658,444103,673559,100221
2020/06/01,Balears,Valencia,26,2565124,518104,2047020,1149460,194428
2020/06/01,Balears,Balears,173673,1149460,193934,955526,1149460,194428
2020/06/01,Barcelona,Barcelona,567607,5664579,912820,4751759,5664579,912802
2020/06/01,Barcelona,Tarragona,2195,804664,126174,678490,5664579,912802
2020/06/01,Barcelona,Lleida,271,434930,71320,363610,5664579,912802
2020/06/01,Barcelona,Las Palmas de Gran Canaria,18,1120406,201506,918900,5664579,912802
2020/06/01,Barcelona,Girona,3164,771044,107743,663301,5664579,912802
2020/06/01,Bizkaia,Gipuzkoa,1232,723576,128110,595466,1152934,248686
2020/06/01,Bizkaia,Araba,997,331549,66383,265166,1152934,248686
2020/06/01,Bizkaia,Cantabria,3390,580795,97657,483138,1152934,248686
2020/06/01,Bizkaia,Bizkaia,196081,1152934,252457,900477,1152934,248686
2020/06/01,Bizkaia,Burgos,106,357072,52334,304738,1152934,248686
2020/06/01,Burgos,Burgos,39041,357072,52334,304738,357072,53974
2020/06/01,Burgos,Rioja,72,316798,55134,261664,357072,53974
2020/06/01,Burgos,Valladolid,102,519546,94688,424858,357072,53974
2020/06/01,Burgos,Soria,78,88636,9279,79357,357072,53974
2020/06/01,Burgos,Araba,975,331549,66383,265166,357072,53974
2020/06/01,Burgos,Palencia,200,160866,25460,135406,357072,53974
2020/06/01,Burgos,Segovia,79,153129,22695,130434,357072,53974
2020/06/01,Burgos,Bizkaia,190,1152934,252457,900477,357072,53974
2020/06/01,Burgos,Cantabria,22,580795,97657,483138,357072,53974
2020/06/01,Cáceres,Toledo,263,694844,104704,590140,394151,53385
2020/06/01,Cáceres,Ávila,131,157640,20796,136844,394151,53385
2020/06/01,Cáceres,Badajoz,1284,673559,101923,571636,394151,53385
2020/06/01,Cáceres,Cáceres,36692,394151,53719,340432,394151,53385
2020/06/01,Cádiz,Sevilla,1202,1942389,358320,1584069,1240155,214954
2020/06/01,Cádiz,Málaga,1457,1661785,277873,1383912,1240155,214954
2020/06/01,Cádiz,Ceuta,70,84777,11736,73041,1240155,214954
2020/06/01,Cádiz,Cádiz,177012,1240155,212382,1027773,1240155,214954
2020/06/01,Cádiz,Huelva,686,521870,83753,438117,1240155,214954
2020/06/01,Cantabria,Bizkaia,986,1152934,252457,900477,580795,90372
2020/06/01,Cantabria,Cantabria,68800,580795,97657,483138,580795,90372
2020/06/01,Cantabria,Palencia,66,160866,25460,135406,580795,90372
2020/06/01,Cantabria,Asturias,211,1022800,186485,836315,580795,90372
2020/06/01,Castellón,Valencia,735,2565124,518104,2047020,579962,96374
2020/06/01,Castellón,Tarragona,919,804664,126174,678490,579962,96374
2020/06/01,Castellón,Castellón,69152,579962,90335,489627,579962,96374
2020/06/01,Castellón,Teruel,48,134137,12531,121606,579962,96374
2020/06/01,Ceuta,Ceuta,11105,84777,11736,73041,84777,11922
2020/06/01,Ceuta,Cádiz,140,1240155,212382,1027773,84777,11922
2020/06/01,Ciudad Real,Albacete,459,388167,44670,343497,495761,46307
2020/06/01,Ciudad Real,Cuenca,25,196329,23149,173180,495761,46307
2020/06/01,Ciudad Real,Badajoz,124,673559,101923,571636,495761,46307
2020/06/01,Ciudad Real,Toledo,565,694844,104704,590140,495761,46307
2020/06/01,Ciudad Real,Córdoba,320,782979,124859,658120,495761,46307
2020/06/01,Ciudad Real,Ciudad Real,29722,495761,51658,444103,495761,46307
2020/06/01,Córdoba,Sevilla,1944,1942389,358320,1584069,782979,120141
2020/06/01,Córdoba,Córdoba,87894,782979,124859,658120,782979,120141
2020/06/01,Córdoba,Jaén,745,633564,79448,554116,782979,120141
2020/06/01,Córdoba,Granada,166,914678,148859,765819,782979,120141
2020/06/01,Córdoba,Badajoz,99,673559,101923,571636,782979,120141
2020/06/01,Córdoba,Ciudad Real,242,495761,51658,444103,782979,120141
2020/06/01,Córdoba,Málaga,222,1661785,277873,1383912,782979,120141
2020/06/01,Coruña,Coruña,167548,1119596,219110,900486,1119596,217433
2020/06/01,Coruña,Lugo,698,329587,53622,275965,1119596,217433
2020/06/01,Coruña,Pontevedra,6122,942665,193348,749317,1119596,217433
2020/06/01,Cuenca,Madrid,66,6663394,1187608,5475786,196329,23925
2020/06/01,Cuenca,Valencia,92,2565124,518104,2047020,196329,23925
2020/06/01,Cuenca,Cuenca,12145,196329,23149,173180,196329,23925
2020/06/01,Cuenca,Guadalajara,85,257762,43354,214408,196329,23925
2020/06/01,Cuenca,Albacete,749,388167,44670,343497,196329,23925
2020/06/01,Cuenca,Toledo,170,694844,104704,590140,196329,23925
2020/06/01,Cuenca,Ciudad Real,97,495761,51658,444103,196329,23925
2020/06/01,Gipuzkoa,Bizkaia,1877,1152934,252457,900477,723576,134125
2020/06/01,Gipuzkoa,Gipuzkoa,100161,723576,128110,595466,723576,134125
2020/06/01,Gipuzkoa,Araba,343,331549,66383,265166,723576,134125
2020/06/01,Gipuzkoa,Navarra,589,654183,119018,535165,723576,134125
2020/06/01,Girona,Girona,72645,771044,107743,663301,771044,112449
2020/06/01,Girona,Barcelona,3219,5664579,912820,4751759,771044,112449
2020/06/01,Girona,Lleida,225,434930,71320,363610,771044,112449
2020/06/01,Granada,Almería,451,716820,107905,608915,914678,144826
2020/06/01,Granada,Jaén,364,633564,79448,554116,914678,144826
2020/06/01,Granada,Murcia,146,1493898,260688,1233210,914678,144826
2020/06/01,Granada,Córdoba,219,782979,124859,658120,914678,144826
2020/06/01,Granada,Granada,107976,914678,148859,765819,914678,144826
2020/06/01,Granada,Málaga,267,1661785,277873,1383912,914678,144826
2020/06/01,Guadalajara,Teruel,34,134137,12531,121606,257762,46824
2020/06/01,Guadalajara,Cuenca,50,196329,23149,173180,257762,46824
2020/06/01,Guadalajara,Madrid,2705,6663394,1187608,5475786,257762,46824
2020/06/01,Guadalajara,Guadalajara,25273,257762,43354,214408,257762,46824
2020/06/01,Huelva,Huelva,65151,521870,83753,438117,521870,86700
2020/06/01,Huelva,Cádiz,512,1240155,212382,1027773,521870,86700
2020/06/01,Huelva,Sevilla,1098,1942389,358320,1584069,521870,86700
2020/06/01,Huelva,Badajoz,342,673559,101923,571636,521870,86700
2020/06/01,Huesca,Zaragoza,357,964724,184632,780092,220461,35070
2020/06/01,Huesca,Huesca,20973,220461,31159,189302,220461,35070
2020/06/01,Huesca,Lleida,1225,434930,71320,363610,220461,35070
2020/06/01,Jaén,Córdoba,836,782979,124859,658120,633564,76866
2020/06/01,Jaén,Albacete,37,388167,44670,343497,633564,76866
2020/06/01,Jaén,Granada,313,914678,148859,765819,633564,76866
2020/06/01,Jaén,Jaén,53745,633564,79448,554116,633564,76866
2020/06/01,Las Palmas de Gran Canaria,Las Palmas de Gran Canaria,188426,1120406,201506,918900,1120406,200721
2020/06/01,Las Palmas de Gran Canaria,Santa Cruz de Tenerife,19,1032983,181661,851322,1120406,200721
2020/06/01,León,Palencia,67,160866,25460,135406,460001,76724
2020/06/01,León,Ourense,364,307651,58629,249022,460001,76724
2020/06/01,León,Lugo,33,329587,53622,275965,460001,76724
2020/06/01,León,Valladolid,29,519546,94688,424858,460001,76724
2020/06/01,León,Asturias,47,1022800,186485,836315,460001,76724
2020/06/01,León,Zamora,183,172539,20665,151874,460001,76724
2020/06/01,León,León,58056,460001,77331,382670,460001,76724
2020/06/01,Lleida,Zaragoza,190,964724,184632,780092,434930,69487
2020/06/01,Lleida,Huesca,950,220461,31159,189302,434930,69487
2020/06/01,Lleida,Girona,222,771044,107743,663301,434930,69487
2020/06/01,Lleida,Tarragona,30,804664,126174,678490,434930,69487
2020/06/01,Lleida,Barcelona,294,5664579,912820,4751759,434930,69487
2020/06/01,Lleida,Lleida,47558,434930,71320,363610,434930,69487
2020/06/01,Lugo,Asturias,835,1022800,186485,836315,329587,54124
2020/06/01,Lugo,Coruña,703,1119596,219110,900486,329587,54124
2020/06/01,Lugo,Lugo,37803,329587,53622,275965,329587,54124
2020/06/01,Lugo,Ourense,235,307651,58629,249022,329587,54124
2020/06/01,Madrid,Ciudad Real,28,495761,51658,444103,6663394,1194655
2020/06/01,Madrid,Guadalajara,3268,257762,43354,214408,6663394,1194655
2020/06/01,Madrid,Ávila,316,157640,20796,136844,6663394,1194655
2020/06/01,Madrid,Cuenca,71,196329,23149,173180,6663394,1194655
2020/06/01,Madrid,Toledo,4428,694844,104704,590140,6663394,1194655
2020/06/01,Madrid,Madrid,702379,6663394,1187608,5475786,6663394,1194655
2020/06/01,Madrid,Segovia,55,153129,22695,130434,6663394,1194655
2020/06/01,Málaga,Granada,337,914678,148859,765819,1661785,286844
2020/06/01,Málaga,Sevilla,344,1942389,358320,1584069,1661785,286844
2020/06/01,Málaga,Murcia,18,1493898,260688,1233210,1661785,286844
2020/06/01,Málaga,Cádiz,1483,1240155,212382,1027773,1661785,286844
2020/06/01,Málaga,Córdoba,237,782979,124859,658120,1661785,286844
2020/06/01,Málaga,Málaga,232538,1661785,277873,1383912,1661785,286844
2020/06/01,Melilla,Melilla,15097,86487,15196,71291,86487,15347
2020/06/01,Murcia,Albacete,664,388167,44670,343497,1493898,256715
2020/06/01,Murcia,Granada,16,914678,148859,765819,1493898,256715
2020/06/01,Murcia,Murcia,205360,1493898,260688,1233210,1493898,256715
2020/06/01,Murcia,Almería,1356,716820,107905,608915,1493898,256715
2020/06/01,Murcia,Alicante,3214,1858683,322920,1535763,1493898,256715
2020/06/01,Navarra,Alicante,17,1858683,322920,1535763,654183,121514
2020/06/01,Navarra,Gipuzkoa,420,723576,128110,595466,654183,121514
2020/06/01,Navarra,Navarra,88085,654183,119018,535165,654183,121514
2020/06/01,Navarra,Araba,110,331549,66383,265166,654183,121514
2020/06/01,Navarra,Zaragoza,641,964724,184632,780092,654183,121514
2020/06/01,Navarra,Rioja,2575,316798,55134,261664,654183,121514
2020/06/01,Ourense,Ourense,45221,307651,58629,249022,307651,59199
2020/06/01,Ourense,Zamora,25,172539,20665,151874,307651,59199
2020/06/01,Ourense,Pontevedra,197,942665,193348,749317,307651,59199
2020/06/01,Ourense,Lugo,340,329587,53622,275965,307651,59199
2020/06/01,Ourense,León,322,460001,77331,382670,307651,59199
2020/06/01,Palencia,León,27,460001,77331,382670,160866,27216
2020/06/01,Palencia,Valladolid,328,519546,94688,424858,160866,27216
2020/06/01,Palencia,Cantabria,186,580795,97657,483138,160866,27216
2020/06/01,Palencia,Palencia,18292,160866,25460,135406,160866,27216
2020/06/01,Palencia,Burgos,264,357072,52334,304738,160866,27216
2020/06/01,Pontevedra,Ourense,249,307651,58629,249022,942665,189366
2020/06/01,Pontevedra,Pontevedra,151988,942665,193348,749317,942665,189366
2020/06/01,Pontevedra,Lugo,57,329587,53622,275965,942665,189366
2020/06/01,Pontevedra,Coruña,4479,1119596,219110,900486,942665,189366
2020/06/01,Rioja,Rioja,40447,316798,55134,261664,316798,52503
2020/06/01,Rioja,Navarra,1691,654183,119018,535165,316798,52503
2020/06/01,Rioja,Burgos,31,357072,52334,304738,316798,52503
2020/06/01,Rioja,Araba,815,331549,66383,265166,316798,52503
2020/06/01,Salamanca,Ávila,201,157640,20796,136844,330119,52668
2020/06/01,Salamanca,Salamanca,41087,330119,52436,277683,330119,52668
2020/06/01,Salamanca,Zamora,58,172539,20665,151874,330119,52668
2020/06/01,Santa Cruz de Tenerife,Santa Cruz de Tenerife,166286,1032983,181661,851322,1032983,181207
2020/06/01,Santa Cruz de Tenerife,Las Palmas de Gran Canaria,20,1120406,201506,918900,1032983,181207
2020/06/01,Segovia,Ávila,125,157640,20796,136844,153129,24365
2020/06/01,Segovia,Burgos,135,357072,52334,304738,153129,24365
2020/06/01,Segovia,Segovia,14693,153129,22695,130434,153129,24365
2020/06/01,Segovia,Valladolid,380,519546,94688,424858,153129,24365
2020/06/01,Sevilla,Córdoba,1969,782979,124859,658120,1942389,350666
2020/06/01,Sevilla,Sevilla,259699,1942389,358320,1584069,1942389,350666
2020/06/01,Sevilla,Cádiz,813,1240155,212382,1027773,1942389,350666
2020/06/01,Sevilla,Badajoz,52,673559,101923,571636,1942389,350666
2020/06/01,Sevilla,Huelva,649,521870,83753,438117,1942389,350666
2020/06/01,Sevilla,Málaga,84,1661785,277873,1383912,1942389,350666
2020/06/01,Soria,Soria,7158,88636,9279,79357,88636,11132
2020/06/01,Soria,Valladolid,27,519546,94688,424858,88636,11132
2020/06/01,Soria,Zaragoza,108,964724,184632,780092,88636,11132
2020/06/01,Soria,Burgos,71,357072,52334,304738,88636,11132
2020/06/01,Soria,Segovia,17,153129,22695,130434,88636,11132
2020/06/01,Tarragona,Barcelona,1566,5664579,912820,4751759,804664,127658
2020/06/01,Tarragona,Lleida,28,434930,71320,363610,804664,127658
2020/06/01,Tarragona,Castellón,793,579962,90335,489627,804664,127658
2020/06/01,Tarragona,Tarragona,88569,804664,126174,678490,804664,127658
2020/06/01,Tarragona,Teruel,70,134137,12531,121606,804664,127658
2020/06/01,Tarragona,Zaragoza,53,964724,184632,780092,804664,127658
2020/06/01,Teruel,Tarragona,52,804664,126174,678490,134137,14914
2020/06/01,Teruel,Castellón,71,579962,90335,489627,134137,14914
2020/06/01,Teruel,Teruel,7579,134137,12531,121606,134137,14914
2020/06/01,Teruel,Valencia,39,2565124,518104,2047020,134137,14914
2020/06/01,Teruel,Zaragoza,234,964724,184632,780092,134137,14914
2020/06/01,Toledo,Cáceres,242,394151,53719,340432,694844,99910
2020/06/01,Toledo,Madrid,3999,6663394,1187608,5475786,694844,99910
2020/06/01,Toledo,Toledo,50966,694844,104704,590140,694844,99910
2020/06/01,Toledo,Cuenca,118,196329,23149,173180,694844,99910
2020/06/01,Toledo,Ciudad Real,378,495761,51658,444103,694844,99910
2020/06/01,Toledo,Ávila,324,157640,20796,136844,694844,99910
2020/06/01,Valencia,Albacete,321,388167,44670,343497,2565124,505234
2020/06/01,Valencia,Cuenca,116,196329,23149,173180,2565124,505234
2020/06/01,Valencia,Alicante,1215,1858683,322920,1535763,2565124,505234
2020/06/01,Valencia,Castellón,721,579962,90335,489627,2565124,505234
2020/06/01,Valencia,Valencia,371785,2565124,518104,2047020,2565124,505234
2020/06/01,Valencia,Teruel,19,134137,12531,121606,2565124,505234
2020/06/01,Valladolid,Soria,30,88636,9279,79357,519546,92276
2020/06/01,Valladolid,Burgos,74,357072,52334,304738,519546,92276
2020/06/01,Valladolid,Segovia,331,153129,22695,130434,519546,92276
2020/06/01,Valladolid,Palencia,76,160866,25460,135406,519546,92276
2020/06/01,Valladolid,Valladolid,69375,519546,94688,424858,519546,92276
2020/06/01,Valladolid,Zamora,211,172539,20665,151874,519546,92276
2020/06/01,Valladolid,León,39,460001,77331,382670,519546,92276
2020/06/01,Zamora,Zamora,13247,172539,20665,151874,172539,20452
2020/06/01,Zamora,Valladolid,58,519546,94688,424858,172539,20452
2020/06/01,Zamora,León,59,460001,77331,382670,172539,20452
2020/06/01,Zamora,Ourense,57,307651,58629,249022,172539,20452
2020/06/01,Zamora,Salamanca,36,330119,52436,277683,172539,20452
2020/06/01,Zaragoza,Soria,106,88636,9279,79357,964724,181757
2020/06/01,Zaragoza,Huesca,366,220461,31159,189302,964724,181757
2020/06/01,Zaragoza,Teruel,429,134137,12531,121606,964724,181757
2020/06/01,Zaragoza,Navarra,531,654183,119018,535165,964724,181757
2020/06/01,Zaragoza,Guadalajara,35,257762,43354,214408,964724,181757
2020/06/01,Zaragoza,Lleida,126,434930,71320,363610,964724,181757
2020/06/01,Zaragoza,Zaragoza,142660,964724,184632,780092,964724,181757
2020/06/02,Albacete,Albacete,31796,388167,47856,340311,388167,49063
2020/06/02,Albacete,Murcia,782,1493898,274808,1219090,388167,49063
2020/06/02,Albacete,Alicante,253,1858683,342146,1516537,388167,49063
2020/06/02,Albacete,Jaén,84,633564,82710,550854,388167,49063
2020/06/02,Albacete,Cuenca,857,196329,25873,170456,388167,49063
2020/06/02,Albacete,Valencia,456,2565124,543781,2021343,388167,49063
2020/06/02,Albacete,Granada,22,914678,159513,755165,388167,49063
2020/06/02,Albacete,Ciudad Real,710,495761,57931,437830,388167,49063
2020/06/02,Alicante,Albacete,440,388167,47856,340311,1858683,348197
2020/06/02,Alicante,Alicante,272474,1858683,342146,1516537,1858683,348197
2020/06/02,Alicante,Murcia,4261,1493898,274808,1219090,1858683,348197
2020/06/02,Alicante,Valencia,1823,2565124,543781,2021343,1858683,348197
2020/06/02,Almería,Almería,95545,716820,114684,602136,716820,116947
2020/06/02,Almería,Murcia,2084,1493898,274808,1219090,716820,116947
2020/06/02,Almería,Granada,441,914678,159513,755165,716820,116947
2020/06/02,Araba,Rioja,2629,316798,59042,257756,331549,81997
2020/06/02,Araba,Araba,60238,331549,72761,258788,331549,81997
2020/06/02,Araba,Gipuzkoa,473,723576,139546,584030,331549,81997
2020/06/02,Araba,Burgos,2223,357072,55696,301376,331549,81997
2020/06/02,Araba,Bizkaia,2222,1152934,276204,876730,331549,81997
2020/06/02,Araba,Navarra,253,654183,128334,525849,331549,81997
2020/06/02,Asturias,Cantabria,310,580795,114103,466692,1022800,190736
2020/06/02,Asturias,Lugo,1077,329587,53086,276501,1022800,190736
2020/06/02,Asturias,Asturias,160767,1022800,192093,830707,1022800,190736
2020/06/02,Asturias,León,54,460001,79274,380727,1022800,190736
2020/06/02,Ávila,Ávila,14063,157640,21410,136230,157640,22725
2020/06/02,Ávila,Madrid,191,6663394,1279658,5383736,157640,22725
2020/06/02,Ávila,Cáceres,119,394151,54523,339628,157640,22725
2020/06/02,Ávila,Salamanca,375,330119,55982,274137,157640,22725
2020/06/02,Ávila,Segovia,136,153129,23998,129131,157640,22725
2020/06/02,Ávila,Valladolid,59,519546,103092,416454,157640,22725
2020/06/02,Ávila,Toledo,289,694844,108951,585893,157640,22725
2020/06/02,Badajoz,Ciudad Real,61,495761,57931,437830,673559,102753
2020/06/02,Badajoz,Huelva,256,521870,85954,435916,673559,102753
2020/06/02,Badajoz,Badajoz,77754,673559,103682,569877,673559,102753
2020/06/02,Badajoz,Sevilla,114,1942389,373898,1568491,673559,102753
2020/06/02,Badajoz,Córdoba,115,782979,131539,651440,673559,102753
2020/06/02,Badajoz,Cáceres,1542,394151,54523,339628,673559,102753
2020/06/02,Balears,Barcelona,20,5664579,1162052,4502527,1149460,205128
2020/06/02,Balears,Balears,184944,1149460,203989,945471,1149460,205128
2020/06/02,Balears,Valencia,52,2565124,543781,2021343,1149460,205128
2020/06/02,Barcelona,Tarragona,2696,804664,139767,664897,5664579,1163741
2020/06/02,Barcelona,Lleida,241,434930,77506,357424,5664579,1163741
2020/06/02,Barcelona,Girona,3485,771044,117025,654019,5664579,1163741
2020/06/02,Barcelona,Barcelona,750734,5664579,1162052,4502527,5664579,1163741
2020/06/02,Bizkaia,Gipuzkoa,1489,723576,139546,584030,1152934,270731
2020/06/02,Bizkaia,Cantabria,3848,580795,114103,466692,1152934,270731
2020/06/02,Bizkaia,Araba,1314,331549,72761,258788,1152934,270731
2020/06/02,Bizkaia,Rioja,51,316798,59042,257756,1152934,270731
2020/06/02,Bizkaia,Burgos,101,357072,55696,301376,1152934,270731
2020/06/02,Bizkaia,Bizkaia,218445,1152934,276204,876730,1152934,270731
2020/06/02,Burgos,Segovia,54,153129,23998,129131,357072,56902
2020/06/02,Burgos,Rioja,82,316798,59042,257756,357072,56902
2020/06/02,Burgos,Soria,52,88636,9785,78851,357072,56902
2020/06/02,Burgos,Burgos,42362,357072,55696,301376,357072,56902
2020/06/02,Burgos,Palencia,228,160866,27063,133803,357072,56902
2020/06/02,Burgos,Valladolid,98,519546,103092,416454,357072,56902
2020/06/02,Burgos,Bizkaia,173,1152934,276204,876730,357072,56902
2020/06/02,Burgos,Araba,1293,331549,72761,258788,357072,56902
2020/06/02,Cáceres,Toledo,268,694844,108951,585893,394151,54498
2020/06/02,Cáceres,Ávila,146,157640,21410,136230,394151,54498
2020/06/02,Cáceres,Valencia,23,2565124,543781,2021343,394151,54498
2020/06/02,Cáceres,Badajoz,1417,673559,103682,569877,394151,54498
2020/06/02,Cáceres,Cáceres,38035,394151,54523,339628,394151,54498
2020/06/02,Cádiz,Almería,19,716820,114684,602136,1240155,229317
2020/06/02,Cádiz,Huelva,884,521870,85954,435916,1240155,229317
2020/06/02,Cádiz,Ceuta,77,84777,12650,72127,1240155,229317
2020/06/02,Cádiz,Málaga,1676,1661785,303897,1357888,1240155,229317
2020/06/02,Cádiz,Sevilla,1145,1942389,373898,1568491,1240155,229317
2020/06/02,Cádiz,Cádiz,191866,1240155,225068,1015087,1240155,229317
2020/06/02,Cantabria,Asturias,223,1022800,192093,830707,580795,108680
2020/06/02,Cantabria,Bizkaia,1073,1152934,276204,876730,580795,108680
2020/06/02,Cantabria,Cantabria,85282,580795,114103,466692,580795,108680
2020/06/02,Cantabria,Palencia,83,160866,27063,133803,580795,108680
2020/06/02,Castellón,Valencia,917,2565124,543781,2021343,579962,102758
2020/06/02,Castellón,Tarragona,939,804664,139767,664897,579962,102758
2020/06/02,Castellón,Teruel,96,134137,12920,121217,579962,102758
2020/06/02,Castellón,Castellón,75217,579962,96626,483336,579962,102758
2020/06/02,Ceuta,Cádiz,73,1240155,225068,1015087,84777,12646
2020/06/02,Ceuta,Ceuta,12062,84777,12650,72127,84777,12646
2020/06/02,Ciudad Real,Córdoba,409,782979,131539,651440,495761,54327
2020/06/02,Ciudad Real,Badajoz,74,673559,103682,569877,495761,54327
2020/06/02,Ciudad Real,Cuenca,54,196329,25873,170456,495761,54327
2020/06/02,Ciudad Real,Toledo,562,694844,108951,585893,495761,54327
2020/06/02,Ciudad Real,Albacete,472,388167,47856,340311,495761,54327
2020/06/02,Ciudad Real,Ciudad Real,36663,495761,57931,437830,495761,54327
2020/06/02,Ciudad Real,Jaén,32,633564,82710,550854,495761,54327
2020/06/02,Córdoba,Córdoba,95907,782979,131539,651440,782979,128052
2020/06/02,Córdoba,Sevilla,2014,1942389,373898,1568491,782979,128052
2020/06/02,Córdoba,Ciudad Real,304,495761,57931,437830,782979,128052
2020/06/02,Córdoba,Jaén,773,633564,82710,550854,782979,128052
2020/06/02,Córdoba,Badajoz,108,673559,103682,569877,782979,128052
2020/06/02,Córdoba,Málaga,367,1661785,303897,1357888,782979,128052
2020/06/02,Córdoba,Granada,163,914678,159513,755165,782979,128052
2020/06/02,Coruña,Pontevedra,6019,942665,196259,746406,1119596,223281
2020/06/02,Coruña,Lugo,697,329587,53086,276501,1119596,223281
2020/06/02,Coruña,Coruña,171902,1119596,220940,898656,1119596,223281
2020/06/02,Cuenca,Valencia,108,2565124,543781,2021343,196329,27492
2020/06/02,Cuenca,Madrid,82,6663394,1279658,5383736,196329,27492
2020/06/02,Cuenca,Ciudad Real,134,495761,57931,437830,196329,27492
2020/06/02,Cuenca,Guadalajara,52,257762,45707,212055,196329,27492
2020/06/02,Cuenca,Cuenca,14708,196329,25873,170456,196329,27492
2020/06/02,Cuenca,Toledo,249,694844,108951,585893,196329,27492
2020/06/02,Cuenca,Albacete,989,388167,47856,340311,196329,27492
2020/06/02,Gipuzkoa,Bizkaia,2302,1152934,276204,876730,723576,146524
2020/06/02,Gipuzkoa,Araba,411,331549,72761,258788,723576,146524
2020/06/02,Gipuzkoa,Navarra,716,654183,128334,525849,723576,146524
2020/06/02,Gipuzkoa,Gipuzkoa,110650,723576,139546,584030,723576,146524
2020/06/02,Girona,Almería,22,716820,114684,602136,771044,124876
2020/06/02,Girona,Tarragona,22,804664,139767,664897,771044,124876
2020/06/02,Girona,Lleida,210,434930,77506,357424,771044,124876
2020/06/02,Girona,Girona,79972,771044,117025,654019,771044,124876
2020/06/02,Girona,Castellón,19,579962,96626,483336,771044,124876
2020/06/02,Girona,Barcelona,3500,5664579,1162052,4502527,771044,124876
2020/06/02,Granada,Granada,119614,914678,159513,755165,914678,156868
2020/06/02,Granada,Almería,486,716820,114684,602136,914678,156868
2020/06/02,Granada,Málaga,280,1661785,303897,1357888,914678,156868
2020/06/02,Granada,Murcia,108,1493898,274808,1219090,914678,156868
2020/06/02,Granada,Jaén,434,633564,82710,550854,914678,156868
2020/06/02,Granada,Córdoba,186,782979,131539,651440,914678,156868
2020/06/02,Guadalajara,Cuenca,73,196329,25873,170456,257762,48414
2020/06/02,Guadalajara,Guadalajara,27015,257762,45707,212055,257762,48414
2020/06/02,Guadalajara,Madrid,2910,6663394,1279658,5383736,257762,48414
2020/06/02,Huelva,Cádiz,423,1240155,225068,1015087,521870,89767
2020/06/02,Huelva,Badajoz,356,673559,103682,569877,521870,89767
2020/06/02,Huelva,Huelva,68556,521870,85954,435916,521870,89767
2020/06/02,Huelva,Sevilla,1284,1942389,373898,1568491,521870,89767
2020/06/02,Huesca,Lleida,1466,434930,77506,357424,220461,37409
2020/06/02,Huesca,Huesca,23333,220461,33118,187343,220461,37409
2020/06/02,Huesca,Zaragoza,529,964724,204849,759875,220461,37409
2020/06/02,Jaén,Granada,284,914678,159513,755165,633564,81482
2020/06/02,Jaén,Albacete,44,388167,47856,340311,633564,81482
2020/06/02,Jaén,Córdoba,890,782979,131539,651440,633564,81482
2020/06/02,Jaén,Jaén,58807,633564,82710,550854,633564,81482
2020/06/02,Las Palmas de Gran Canaria,Santa Cruz de Tenerife,16,1032983,193061,839922,1120406,208470
2020/06/02,Las Palmas de Gran Canaria,Las Palmas de Gran Canaria,195981,1120406,208780,911626,1120406,208470
2020/06/02,León,Ourense,397,307651,60028,247623,460001,79079
2020/06/02,León,Valladolid,34,519546,103092,416454,460001,79079
2020/06/02,León,Palencia,26,160866,27063,133803,460001,79079
2020/06/02,León,Zamora,119,172539,26564,145975,460001,79079
2020/06/02,León,León,60796,460001,79274,380727,460001,79079
2020/06/02,León,Asturias,56,1022800,192093,830707,460001,79079
2020/06/02,Lleida,Lleida,52173,434930,77506,357424,434930,74782
2020/06/02,Lleida,Girona,213,771044,117025,654019,434930,74782
2020/06/02,Lleida,Barcelona,280,5664579,1162052,4502527,434930,74782
2020/06/02,Lleida,Zaragoza,213,964724,204849,759875,434930,74782
2020/06/02,Lleida,Tarragona,61,804664,139767,664897,434930,74782
2020/06/02,Lleida,Huesca,827,220461,33118,187343,434930,74782
2020/06/02,Lugo,Pontevedra,50,942665,196259,746406,329587,55224
2020/06/02,Lugo,Lugo,38323,329587,53086,276501,329587,55224
2020/06/02,Lugo,Coruña,727,1119596,220940,898656,329587,55224
2020/06/02,Lugo,Ourense,304,307651,60028,247623,329587,55224
2020/06/02,Lugo,Asturias,844,1022800,192093,830707,329587,55224
2020/06/02,Madrid,Guadalajara,4089,257762,45707,212055,6663394,1277224
2020/06/02,Madrid,Ávila,454,157640,21410,136230,6663394,1277224
2020/06/02,Madrid,Madrid,787474,6663394,1279658,5383736,6663394,1277224
2020/06/02,Madrid,Toledo,5303,694844,108951,585893,6663394,1277224
2020/06/02,Madrid,Segovia,73,153129,23998,129131,6663394,1277224
2020/06/02,Madrid,Cuenca,90,196329,25873,170456,6663394,1277224
2020/06/02,Málaga,Granada,372,914678,159513,755165,1661785,307887
2020/06/02,Málaga,Málaga,258831,1661785,303897,1357888,1661785,307887
2020/06/02,Málaga,Cádiz,1470,1240155,225068,1015087,1661785,307887
2020/06/02,Málaga,Sevilla,379,1942389,373898,1568491,1661785,307887
2020/06/02,Málaga,Córdoba,329,782979,131539,651440,1661785,307887
2020/06/02,Melilla,Melilla,15549,86487,15654,70833,86487,15757
2020/06/02,Murcia,Albacete,563,388167,47856,340311,1493898,267474
2020/06/02,Murcia,Almería,1287,716820,114684,602136,1493898,267474
2020/06/02,Murcia,Alicante,3187,1858683,342146,1516537,1493898,267474
2020/06/02,Murcia,Murcia,217157,1493898,274808,1219090,1493898,267474
2020/06/02,Murcia,Granada,29,914678,159513,755165,1493898,267474
2020/06/02,Navarra,Navarra,96703,654183,128334,525849,654183,131082
2020/06/02,Navarra,Araba,98,331549,72761,258788,654183,131082
2020/06/02,Navarra,Rioja,2891,316798,59042,257756,654183,131082
2020/06/02,Navarra,Gipuzkoa,511,723576,139546,584030,654183,131082
2020/06/02,Navarra,Zaragoza,749,964724,204849,759875,654183,131082
2020/06/02,Ourense,León,305,460001,79274,380727,307651,60175
2020/06/02,Ourense,Zamora,54,172539,26564,145975,307651,60175
2020/06/02,Ourense,Pontevedra,210,942665,196259,746406,307651,60175
2020/06/02,Ourense,Ourense,46869,307651,60028,247623,307651,60175
2020/06/02,Ourense,Lugo,197,329587,53086,276501,307651,60175
2020/06/02,Palencia,Palencia,20054,160866,27063,133803,160866,28842
2020/06/02,Palencia,León,59,460001,79274,380727,160866,28842
2020/06/02,Palencia,Cantabria,205,580795,114103,466692,160866,28842
2020/06/02,Palencia,Burgos,258,357072,55696,301376,160866,28842
2020/06/02,Palencia,Valladolid,457,519546,103092,416454,160866,28842
2020/06/02,Pontevedra,Pontevedra,156037,942665,196259,746406,942665,195387
2020/06/02,Pontevedra,Coruña,4591,1119596,220940,898656,942665,195387
2020/06/02,Pontevedra,Ourense,263,307651,60028,247623,942665,195387
2020/06/02,Pontevedra,Lugo,46,329587,53086,276501,942665,195387
2020/06/02,Rioja,Araba,881,331549,72761,258788,316798,56028
2020/06/02,Rioja,Burgos,66,357072,55696,301376,316798,56028
2020/06/02,Rioja,Bizkaia,19,1152934,276204,876730,316798,56028
2020/06/02,Rioja,Rioja,43704,316798,59042,257756,316798,56028
2020/06/02,Rioja,Navarra,2143,654183,128334,525849,316798,56028
2020/06/02,Salamanca,Ávila,274,157640,21410,136230,330119,55549
2020/06/02,Salamanca,Zamora,119,172539,26564,145975,330119,55549
2020/06/02,Salamanca,Salamanca,44380,330119,55982,274137,330119,55549
2020/06/02,Salamanca,Cáceres,34,394151,54523,339628,330119,55549
2020/06/02,Santa Cruz de Tenerife,Santa Cruz de Tenerife,177626,1032983,193061,839922,1032983,192731
2020/06/02,Santa Cruz de Tenerife,Las Palmas de Gran Canaria,54,1120406,208780,911626,1032983,192731
2020/06/02,Segovia,Burgos,148,357072,55696,301376,153129,25892
2020/06/02,Segovia,Valladolid,491,519546,103092,416454,153129,25892
2020/06/02,Segovia,Madrid,24,6663394,1279658,5383736,153129,25892
2020/06/02,Segovia,Ávila,101,157640,21410,136230,153129,25892
2020/06/02,Segovia,Segovia,16033,153129,23998,129131,153129,25892
2020/06/02,Sevilla,Córdoba,2392,782979,131539,651440,1942389,366634
2020/06/02,Sevilla,Cádiz,1081,1240155,225068,1015087,1942389,366634
2020/06/02,Sevilla,Badajoz,57,673559,103682,569877,1942389,366634
2020/06/02,Sevilla,Huelva,711,521870,85954,435916,1942389,366634
2020/06/02,Sevilla,Málaga,157,1661785,303897,1357888,1942389,366634
2020/06/02,Sevilla,Sevilla,277039,1942389,373898,1568491,1942389,366634
2020/06/02,Soria,Soria,7510,88636,9785,78851,88636,11218
2020/06/02,Soria,Valladolid,35,519546,103092,416454,88636,11218
2020/06/02,Soria,Burgos,139,357072,55696,301376,88636,11218
2020/06/02,Soria,Segovia,22,153129,23998,129131,88636,11218
2020/06/02,Soria,Navarra,23,654183,128334,525849,88636,11218
2020/06/02,Soria,Zaragoza,134,964724,204849,759875,88636,11218
2020/06/02,Tarragona,Tarragona,97954,804664,139767,664897,804664,139408
2020/06/02,Tarragona,Castellón,1086,579962,96626,483336,804664,139408
2020/06/02,Tarragona,Teruel,83,134137,12920,121217,804664,139408
2020/06/02,Tarragona,Barcelona,1656,5664579,1162052,4502527,804664,139408
2020/06/02,Tarragona,Lleida,49,434930,77506,357424,804664,139408
2020/06/02,Teruel,Castellón,25,579962,96626,483336,134137,15304
2020/06/02,Teruel,Guadalajara,63,257762,45707,212055,134137,15304
2020/06/02,Teruel,Teruel,8214,134137,12920,121217,134137,15304
2020/06/02,Teruel,Tarragona,76,804664,139767,664897,134137,15304
2020/06/02,Teruel,Valencia,25,2565124,543781,2021343,134137,15304
2020/06/02,Teruel,Zaragoza,300,964724,204849,759875,134137,15304
2020/06/02,Toledo,Cáceres,261,394151,54523,339628,694844,104572
2020/06/02,Toledo,Madrid,4595,6663394,1279658,5383736,694844,104572
2020/06/02,Toledo,Toledo,53531,694844,108951,585893,694844,104572
2020/06/02,Toledo,Ávila,264,157640,21410,136230,694844,104572
2020/06/02,Toledo,Ciudad Real,404,495761,57931,437830,694844,104572
2020/06/02,Toledo,Cuenca,177,196329,25873,170456,694844,104572
2020/06/02,Valencia,Cuenca,122,196329,25873,170456,2565124,527564
2020/06/02,Valencia,Cáceres,19,394151,54523,339628,2565124,527564
2020/06/02,Valencia,Teruel,21,134137,12920,121217,2565124,527564
2020/06/02,Valencia,Castellón,786,579962,96626,483336,2565124,527564
2020/06/02,Valencia,Valencia,397271,2565124,543781,2021343,2565124,527564
2020/06/02,Valencia,Alicante,1419,1858683,342146,1516537,2565124,527564
2020/06/02,Valencia,Albacete,418,388167,47856,340311,2565124,527564
2020/06/02,Valladolid,Zamora,121,172539,26564,145975,519546,99183
2020/06/02,Valladolid,Ávila,28,157640,21410,136230,519546,99183
2020/06/02,Valladolid,Palencia,90,160866,27063,133803,519546,99183
2020/06/02,Valladolid,Soria,38,88636,9785,78851,519546,99183
2020/06/02,Valladolid,Segovia,367,153129,23998,129131,519546,99183
2020/06/02,Valladolid,Burgos,81,357072,55696,301376,519546,99183
2020/06/02,Valladolid,León,35,460001,79274,380727,519546,99183
2020/06/02,Valladolid,Valladolid,77435,519546,103092,416454,519546,99183
2020/06/02,Zamora,Zamora,18482,172539,26564,145975,172539,26893
2020/06/02,Zamora,León,61,460001,79274,380727,172539,26893
2020/06/02,Zamora,Valladolid,74,519546,103092,416454,172539,26893
2020/06/02,Zamora,Salamanca,16,330119,55982,274137,172539,26893
2020/06/02,Zamora,Ourense,117,307651,60028,247623,172539,26893
2020/06/02,Zaragoza,Navarra,552,654183,128334,525849,964724,197756
2020/06/02,Zaragoza,Teruel,352,134137,12920,121217,964724,197756
2020/06/02,Zaragoza,Huesca,324,220461,33118,187343,964724,197756
2020/06/02,Zaragoza,Lleida,107,434930,77506,357424,964724,197756
2020/06/02,Zaragoza,Zaragoza,162265,964724,204849,759875,964724,197756
2020/06/02,Zaragoza,Soria,100,88636,9785,78851,964724,197756
2020/06/03,Albacete,Murcia,857,1493898,274668,1219230,388167,47228
2020/06/03,Albacete,Albacete,29809,388167,45574,342593,388167,47228
2020/06/03,Albacete,Alicante,245,1858683,343903,1514780,388167,47228
2020/06/03,Albacete,Valencia,475,2565124,545517,2019607,388167,47228
2020/06/03,Albacete,Cuenca,995,196329,25707,170622,388167,47228
2020/06/03,Albacete,Ciudad Real,763,495761,57499,438262,388167,47228
2020/06/03,Albacete,Jaén,89,633564,83950,549614,388167,47228
2020/06/03,Alicante,Valencia,1821,2565124,545517,2019607,1858683,350474
2020/06/03,Alicante,Albacete,442,388167,45574,342593,1858683,350474
2020/06/03,Alicante,Alicante,274036,1858683,343903,1514780,1858683,350474
2020/06/03,Alicante,Murcia,3666,1493898,274668,1219230,1858683,350474
2020/06/03,Almería,Murcia,1979,1493898,274668,1219230,716820,116471
2020/06/03,Almería,Almería,96550,716820,114568,602252,716820,116471
2020/06/03,Almería,Granada,559,914678,161469,753209,716820,116471
2020/06/03,Araba,Navarra,216,654183,125115,529068,331549,79304
2020/06/03,Araba,Burgos,2340,357072,54486,302586,331549,79304
2020/06/03,Araba,Bizkaia,2193,1152934,269392,883542,331549,79304
2020/06/03,Araba,Gipuzkoa,366,723576,135625,587951,331549,79304
2020/06/03,Araba,Rioja,2374,316798,58269,258529,331549,79304
2020/06/03,Araba,Araba,58232,331549,70200,261349,331549,79304
2020/06/03,Asturias,Cantabria,284,580795,111383,469412,1022800,193265
2020/06/03,Asturias,Asturias,160678,1022800,193877,828923,1022800,193265
2020/06/03,Asturias,Lugo,1145,329587,53657,275930,1022800,193265
2020/06/03,Asturias,León,43,460001,78524,381477,1022800,193265
2020/06/03,Ávila,Salamanca,394,330119,55033,275086,157640,23075
2020/06/03,Ávila,Madrid,555,6663394,1304923,5358471,157640,23075
2020/06/03,Ávila,Valladolid,60,519546,101757,417789,157640,23075
2020/06/03,Ávila,Segovia,113,153129,23839,129290,157640,23075
2020/06/03,Ávila,Cáceres,141,394151,54642,339509,157640,23075
2020/06/03,Ávila,Ávila,14361,157640,21665,135975,157640,23075
2020/06/03,Ávila,Toledo,345,694844,108953,585891,157640,23075
2020/06/03,Badajoz,Huelva,232,521870,84906,436964,673559,103515
2020/06/03,Badajoz,Sevilla,98,1942389,374113,1568276,673559,103515
2020/06/03,Badajoz,Badajoz,79067,673559,104265,569294,673559,103515
2020/06/03,Badajoz,Córdoba,124,782979,132371,650608,673559,103515
2020/06/03,Badajoz,Cáceres,1424,394151,54642,339509,673559,103515
2020/06/03,Badajoz,Ciudad Real,45,495761,57499,438262,673559,103515
2020/06/03,Balears,Valencia,52,2565124,545517,2019607,1149460,204573
2020/06/03,Balears,Balears,184152,1149460,203623,945837,1149460,204573
2020/06/03,Barcelona,Barcelona,773409,5664579,1180872,4483707,5664579,1172798
2020/06/03,Barcelona,Lleida,227,434930,76541,358389,5664579,1172798
2020/06/03,Barcelona,Girona,3456,771044,120311,650733,5664579,1172798
2020/06/03,Barcelona,Tarragona,2525,804664,137187,667477,5664579,1172798
2020/06/03,Bizkaia,Burgos,111,357072,54486,302586,1152934,264483
2020/06/03,Bizkaia,Gipuzkoa,1452,723576,135625,587951,1152934,264483
2020/06/03,Bizkaia,Cantabria,3609,580795,111383,469412,1152934,264483
2020/06/03,Bizkaia,Bizkaia,213428,1152934,269392,883542,1152934,264483
2020/06/03,Bizkaia,Araba,1187,331549,70200,261349,1152934,264483
2020/06/03,Burgos,Palencia,267,160866,26562,134304,357072,55784
2020/06/03,Burgos,Burgos,41077,357072,54486,302586,357072,55784
2020/06/03,Burgos,Cantabria,44,580795,111383,469412,357072,55784
2020/06/03,Burgos,Valladolid,93,519546,101757,417789,357072,55784
2020/06/03,Burgos,Soria,55,88636,9756,78880,357072,55784
2020/06/03,Burgos,Bizkaia,162,1152934,269392,883542,357072,55784
2020/06/03,Burgos,Rioja,201,316798,58269,258529,357072,55784
2020/06/03,Burgos,Araba,1109,331549,70200,261349,357072,55784
2020/06/03,Burgos,Segovia,53,153129,23839,129290,357072,55784
2020/06/03,Cáceres,Toledo,274,694844,108953,585891,394151,54692
2020/06/03,Cáceres,Cáceres,38293,394151,54642,339509,394151,54692
2020/06/03,Cáceres,Ávila,136,157640,21665,135975,394151,54692
2020/06/03,Cáceres,Valencia,21,2565124,545517,2019607,394151,54692
2020/06/03,Cáceres,Badajoz,1416,673559,104265,569294,394151,54692
2020/06/03,Cádiz,Ceuta,112,84777,13335,71442,1240155,227119
2020/06/03,Cádiz,Huelva,734,521870,84906,436964,1240155,227119
2020/06/03,Cádiz,Sevilla,1382,1942389,374113,1568276,1240155,227119
2020/06/03,Cádiz,Cádiz,189466,1240155,223011,1017144,1240155,227119
2020/06/03,Cádiz,Málaga,1536,1661785,302467,1359318,1240155,227119
2020/06/03,Cantabria,Palencia,61,160866,26562,134304,580795,105792
2020/06/03,Cantabria,Asturias,190,1022800,193877,828923,580795,105792
2020/06/03,Cantabria,Cantabria,83600,580795,111383,469412,580795,105792
2020/06/03,Cantabria,Bizkaia,927,1152934,269392,883542,580795,105792
2020/06/03,Castellón,Tarragona,940,804664,137187,667477,579962,102420
2020/06/03,Castellón,Castellón,75236,579962,97053,482909,579962,102420
2020/06/03,Castellón,Valencia,1055,2565124,545517,2019607,579962,102420
2020/06/03,Castellón,Teruel,69,134137,12907,121230,579962,102420
2020/06/03,Ceuta,Cádiz,105,1240155,223011,1017144,84777,13317
2020/06/03,Ceuta,Ceuta,12708,84777,13335,71442,84777,13317
2020/06/03,Ciudad Real,Albacete,457,388167,45574,342593,495761,54130
2020/06/03,Ciudad Real,Cuenca,30,196329,25707,170622,495761,54130
2020/06/03,Ciudad Real,Toledo,525,694844,108953,585891,495761,54130
2020/06/03,Ciudad Real,Córdoba,373,782979,132371,650608,495761,54130
2020/06/03,Ciudad Real,Badajoz,61,673559,104265,569294,495761,54130
2020/06/03,Ciudad Real,Ciudad Real,36303,495761,57499,438262,495761,54130
2020/06/03,Córdoba,Jaén,816,633564,83950,549614,782979,129021
2020/06/03,Córdoba,Córdoba,96620,782979,132371,650608,782979,129021
2020/06/03,Córdoba,Badajoz,118,673559,104265,569294,782979,129021
2020/06/03,Córdoba,Sevilla,2054,1942389,374113,1568276,782979,129021
2020/06/03,Córdoba,Granada,134,914678,161469,753209,782979,129021
2020/06/03,Córdoba,Ciudad Real,265,495761,57499,438262,782979,129021
2020/06/03,Córdoba,Málaga,297,1661785,302467,1359318,782979,129021
2020/06/03,Coruña,Coruña,173593,1119596,221921,897675,1119596,224834
2020/06/03,Coruña,Pontevedra,5872,942665,196919,745746,1119596,224834
2020/06/03,Coruña,Lugo,722,329587,53657,275930,1119596,224834
2020/06/03,Cuenca,Guadalajara,42,257762,45955,211807,196329,27553
2020/06/03,Cuenca,Cuenca,14366,196329,25707,170622,196329,27553
2020/06/03,Cuenca,Ciudad Real,143,495761,57499,438262,196329,27553
2020/06/03,Cuenca,Toledo,259,694844,108953,585891,196329,27553
2020/06/03,Cuenca,Albacete,968,388167,45574,342593,196329,27553
2020/06/03,Cuenca,Madrid,82,6663394,1304923,5358471,196329,27553
2020/06/03,Cuenca,Valencia,107,2565124,545517,2019607,196329,27553
2020/06/03,Cuenca,Murcia,17,1493898,274668,1219230,196329,27553
2020/06/03,Gipuzkoa,Navarra,568,654183,125115,529068,723576,141612
2020/06/03,Gipuzkoa,Gipuzkoa,107293,723576,135625,587951,723576,141612
2020/06/03,Gipuzkoa,Bizkaia,2011,1152934,269392,883542,723576,141612
2020/06/03,Gipuzkoa,Araba,342,331549,70200,261349,723576,141612
2020/06/03,Girona,Girona,83777,771044,120311,650733,771044,128157
2020/06/03,Girona,Barcelona,3437,5664579,1180872,4483707,771044,128157
2020/06/03,Girona,Lleida,263,434930,76541,358389,771044,128157
2020/06/03,Granada,Córdoba,194,782979,132371,650608,914678,159077
2020/06/03,Granada,Granada,121322,914678,161469,753209,914678,159077
2020/06/03,Granada,Málaga,309,1661785,302467,1359318,914678,159077
2020/06/03,Granada,Almería,642,716820,114568,602252,914678,159077
2020/06/03,Granada,Murcia,173,1493898,274668,1219230,914678,159077
2020/06/03,Granada,Jaén,458,633564,83950,549614,914678,159077
2020/06/03,Guadalajara,Guadalajara,27331,257762,45955,211807,257762,49074
2020/06/03,Guadalajara,Cuenca,51,196329,25707,170622,257762,49074
2020/06/03,Guadalajara,Madrid,3064,6663394,1304923,5358471,257762,49074
2020/06/03,Huelva,Cádiz,565,1240155,223011,1017144,521870,88603
2020/06/03,Huelva,Sevilla,1127,1942389,374113,1568276,521870,88603
2020/06/03,Huelva,Badajoz,357,673559,104265,569294,521870,88603
2020/06/03,Huelva,Huelva,67530,521870,84906,436964,521870,88603
2020/06/03,Huesca,Huesca,22548,220461,32463,187998,220461,36272
2020/06/03,Huesca,Zaragoza,400,964724,200103,764621,220461,36272
2020/06/03,Huesca,Lleida,1537,434930,76541,358389,220461,36272
2020/06/03,Jaén,Granada,342,914678,161469,753209,633564,83300
2020/06/03,Jaén,Jaén,60161,633564,83950,549614,633564,83300
2020/06/03,Jaén,Córdoba,932,782979,132371,650608,633564,83300
2020/06/03,Las Palmas de Gran Canaria,Santa Cruz de Tenerife,27,1032983,189982,843001,1120406,209142
2020/06/03,Las Palmas de Gran Canaria,Las Palmas de Gran Canaria,197482,1120406,209502,910904,1120406,209142
2020/06/03,León,León,60409,460001,78524,381477,460001,77816
2020/06/03,León,Lugo,37,329587,53657,275930,460001,77816
2020/06/03,León,Zamora,130,172539,25708,146831,460001,77816
2020/06/03,León,Ourense,380,307651,60038,247613,460001,77816
2020/06/03,León,Palencia,54,160866,26562,134304,460001,77816
2020/06/03,León,Valladolid,53,519546,101757,417789,460001,77816
2020/06/03,León,Asturias,70,1022800,193877,828923,460001,77816
2020/06/03,Lleida,Girona,241,771044,120311,650733,434930,73899
2020/06/03,Lleida,Tarragona,27,804664,137187,667477,434930,73899
2020/06/03,Lleida,Lleida,51536,434930,76541,358389,434930,73899
2020/06/03,Lleida,Huesca,851,220461,32463,187998,434930,73899
2020/06/03,Lleida,Zaragoza,179,964724,200103,764621,434930,73899
2020/06/03,Lleida,Barcelona,347,5664579,1180872,4483707,434930,73899
2020/06/03,Lugo,León,70,460001,78524,381477,329587,55431
2020/06/03,Lugo,Coruña,712,1119596,221921,897675,329587,55431
2020/06/03,Lugo,Lugo,38822,329587,53657,275930,329587,55431
2020/06/03,Lugo,Ourense,248,307651,60038,247613,329587,55431
2020/06/03,Lugo,Asturias,986,1022800,193877,828923,329587,55431
2020/06/03,Madrid,Guadalajara,3804,257762,45955,211807,6663394,1302014
2020/06/03,Madrid,Segovia,53,153129,23839,129290,6663394,1302014
2020/06/03,Madrid,Madrid,809973,6663394,1304923,5358471,6663394,1302014
2020/06/03,Madrid,Cuenca,132,196329,25707,170622,6663394,1302014
2020/06/03,Madrid,Ávila,337,157640,21665,135975,6663394,1302014
2020/06/03,Madrid,Ciudad Real,32,495761,57499,438262,6663394,1302014
2020/06/03,Madrid,Toledo,5123,694844,108953,585891,6663394,1302014
2020/06/03,Málaga,Málaga,258892,1661785,302467,1359318,1661785,306861
2020/06/03,Málaga,Córdoba,348,782979,132371,650608,1661785,306861
2020/06/03,Málaga,Granada,342,914678,161469,753209,1661785,306861
2020/06/03,Málaga,Cádiz,1564,1240155,223011,1017144,1661785,306861
2020/06/03,Málaga,Sevilla,267,1942389,374113,1568276,1661785,306861
2020/06/03,Melilla,Melilla,15510,86487,15628,70859,86487,15711
2020/06/03,Murcia,Almería,1199,716820,114568,602252,1493898,267485
2020/06/03,Murcia,Albacete,509,388167,45574,342593,1493898,267485
2020/06/03,Murcia,Alicante,3210,1858683,343903,1514780,1493898,267485
2020/06/03,Murcia,Granada,16,914678,161469,753209,1493898,267485
2020/06/03,Murcia,Murcia,218023,1493898,274668,1219230,1493898,267485
2020/06/03,Navarra,Rioja,2741,316798,58269,258529,654183,126710
2020/06/03,Navarra,Zaragoza,745,964724,200103,764621,654183,126710
2020/06/03,Navarra,Gipuzkoa,481,723576,135625,587951,654183,126710
2020/06/03,Navarra,Navarra,93530,654183,125115,529068,654183,126710
2020/06/03,Navarra,Araba,98,331549,70200,261349,654183,126710
2020/06/03,Ourense,León,391,460001,78524,381477,307651,60918
2020/06/03,Ourense,Zamora,78,172539,25708,146831,307651,60918
2020/06/03,Ourense,Ourense,47118,307651,60038,247613,307651,60918
2020/06/03,Ourense,Pontevedra,195,942665,196919,745746,307651,60918
2020/06/03,Ourense,Lugo,231,329587,53657,275930,307651,60918
2020/06/03,Palencia,Valladolid,273,519546,101757,417789,160866,28489
2020/06/03,Palencia,Cantabria,212,580795,111383,469412,160866,28489
2020/06/03,Palencia,Palencia,19688,160866,26562,134304,160866,28489
2020/06/03,Palencia,León,66,460001,78524,381477,160866,28489
2020/06/03,Palencia,Burgos,306,357072,54486,302586,160866,28489
2020/06/03,Pontevedra,Coruña,4811,1119596,221921,897675,942665,197048
2020/06/03,Pontevedra,Ourense,280,307651,60038,247613,942665,197048
2020/06/03,Pontevedra,Pontevedra,157592,942665,196919,745746,942665,197048
2020/06/03,Rioja,Rioja,43400,316798,58269,258529,316798,55607
2020/06/03,Rioja,Burgos,32,357072,54486,302586,316798,55607
2020/06/03,Rioja,Araba,850,331549,70200,261349,316798,55607
2020/06/03,Rioja,Navarra,2129,654183,125115,529068,316798,55607
2020/06/03,Salamanca,Salamanca,43990,330119,55033,275086,330119,54656
2020/06/03,Salamanca,Zamora,77,172539,25708,146831,330119,54656
2020/06/03,Salamanca,Ávila,217,157640,21665,135975,330119,54656
2020/06/03,Santa Cruz de Tenerife,Santa Cruz de Tenerife,175535,1032983,189982,843001,1032983,189704
2020/06/03,Santa Cruz de Tenerife,Las Palmas de Gran Canaria,17,1120406,209502,910904,1032983,189704
2020/06/03,Segovia,Valladolid,379,519546,101757,417789,153129,26095
2020/06/03,Segovia,Ávila,112,157640,21665,135975,153129,26095
2020/06/03,Segovia,Segovia,16079,153129,23839,129290,153129,26095
2020/06/03,Segovia,Burgos,166,357072,54486,302586,153129,26095
2020/06/03,Sevilla,Córdoba,2200,782979,132371,650608,1942389,367319
2020/06/03,Sevilla,Badajoz,56,673559,104265,569294,1942389,367319
2020/06/03,Sevilla,Cádiz,992,1240155,223011,1017144,1942389,367319
2020/06/03,Sevilla,Sevilla,277659,1942389,374113,1568276,1942389,367319
2020/06/03,Sevilla,Málaga,128,1661785,302467,1359318,1942389,367319
2020/06/03,Sevilla,Huelva,655,521870,84906,436964,1942389,367319
2020/06/03,Soria,Valladolid,85,519546,101757,417789,88636,11231
2020/06/03,Soria,Soria,7468,88636,9756,78880,88636,11231
2020/06/03,Soria,Navarra,18,654183,125115,529068,88636,11231
2020/06/03,Soria,Zaragoza,176,964724,200103,764621,88636,11231
2020/06/03,Soria,Segovia,18,153129,23839,129290,88636,11231
2020/06/03,Soria,Burgos,130,357072,54486,302586,88636,11231
2020/06/03,Tarragona,Barcelona,2235,5664579,1180872,4483707,804664,139197
2020/06/03,Tarragona,Tarragona,95797,804664,137187,667477,804664,139197
2020/06/03,Tarragona,Teruel,70,134137,12907,121230,804664,139197
2020/06/03,Tarragona,Castellón,1088,579962,97053,482909,804664,139197
2020/06/03,Tarragona,Zaragoza,37,964724,200103,764621,804664,139197
2020/06/03,Teruel,Valencia,22,2565124,545517,2019607,134137,14924
2020/06/03,Teruel,Castellón,73,579962,97053,482909,134137,14924
2020/06/03,Teruel,Teruel,8293,134137,12907,121230,134137,14924
2020/06/03,Teruel,Tarragona,94,804664,137187,667477,134137,14924
2020/06/03,Teruel,Zaragoza,358,964724,200103,764621,134137,14924
2020/06/03,Toledo,Toledo,54269,694844,108953,585891,694844,106327
2020/06/03,Toledo,Madrid,5004,6663394,1304923,5358471,694844,106327
2020/06/03,Toledo,Ávila,440,157640,21665,135975,694844,106327
2020/06/03,Toledo,Ciudad Real,444,495761,57499,438262,694844,106327
2020/06/03,Toledo,Cáceres,214,394151,54642,339509,694844,106327
2020/06/03,Toledo,Cuenca,168,196329,25707,170622,694844,106327
2020/06/03,Valencia,Albacete,373,388167,45574,342593,2565124,531211
2020/06/03,Valencia,Valencia,400951,2565124,545517,2019607,2565124,531211
2020/06/03,Valencia,Alicante,1493,1858683,343903,1514780,2565124,531211
2020/06/03,Valencia,Cáceres,23,394151,54642,339509,2565124,531211
2020/06/03,Valencia,Castellón,779,579962,97053,482909,2565124,531211
2020/06/03,Valencia,Cuenca,172,196329,25707,170622,2565124,531211
2020/06/03,Valladolid,Soria,41,88636,9756,78880,519546,98119
2020/06/03,Valladolid,León,45,460001,78524,381477,519546,98119
2020/06/03,Valladolid,Burgos,91,357072,54486,302586,519546,98119
2020/06/03,Valladolid,Ávila,61,157640,21665,135975,519546,98119
2020/06/03,Valladolid,Palencia,100,160866,26562,134304,519546,98119
2020/06/03,Valladolid,Segovia,391,153129,23839,129290,519546,98119
2020/06/03,Valladolid,Valladolid,76291,519546,101757,417789,519546,98119
2020/06/03,Valladolid,Zamora,188,172539,25708,146831,519546,98119
2020/06/03,Zamora,Valladolid,73,519546,101757,417789,172539,25918
2020/06/03,Zamora,Ourense,122,307651,60038,247613,172539,25918
2020/06/03,Zamora,Asturias,16,1022800,193877,828923,172539,25918
2020/06/03,Zamora,León,57,460001,78524,381477,172539,25918
2020/06/03,Zamora,Salamanca,42,330119,55033,275086,172539,25918
2020/06/03,Zamora,Zamora,17839,172539,25708,146831,172539,25918
2020/06/03,Zaragoza,Zaragoza,159064,964724,200103,764621,964724,193962
2020/06/03,Zaragoza,Soria,82,88636,9756,78880,964724,193962
2020/06/03,Zaragoza,Teruel,322,134137,12907,121230,964724,193962
2020/06/03,Zaragoza,Lleida,143,434930,76541,358389,964724,193962
2020/06/03,Zaragoza,Huesca,355,220461,32463,187998,964724,193962
2020/06/03,Zaragoza,Navarra,613,654183,125115,529068,964724,193962
2020/06/04,Albacete,Jaén,48,633564,83785,549779,388167,46733
2020/06/04,Albacete,Cuenca,958,196329,24543,171786,388167,46733
2020/06/04,Albacete,Albacete,29425,388167,45043,343124,388167,46733
2020/06/04,Albacete,Valencia,370,2565124,542229,2022895,388167,46733
2020/06/04,Albacete,Ciudad Real,840,495761,57231,438530,388167,46733
2020/06/04,Albacete,Alicante,238,1858683,347510,1511173,388167,46733
2020/06/04,Albacete,Murcia,645,1493898,273833,1220065,388167,46733
2020/06/04,Alicante,Albacete,453,388167,45043,343124,1858683,354355
2020/06/04,Alicante,Murcia,4050,1493898,273833,1220065,1858683,354355
2020/06/04,Alicante,Valencia,1784,2565124,542229,2022895,1858683,354355
2020/06/04,Alicante,Alicante,277401,1858683,347510,1511173,1858683,354355
2020/06/04,Almería,Murcia,1804,1493898,273833,1220065,716820,117621
2020/06/04,Almería,Almería,97177,716820,115430,601390,716820,117621
2020/06/04,Almería,Granada,596,914678,160970,753708,716820,117621
2020/06/04,Araba,Burgos,2119,357072,53617,303455,331549,77509
2020/06/04,Araba,Araba,56688,331549,69170,262379,331549,77509
2020/06/04,Araba,Gipuzkoa,335,723576,132568,591008,331549,77509
2020/06/04,Araba,Bizkaia,2179,1152934,266185,886749,331549,77509
2020/06/04,Araba,Navarra,208,654183,124987,529196,331549,77509
2020/06/04,Araba,Rioja,2153,316798,56398,260400,331549,77509
2020/06/04,Asturias,Asturias,158251,1022800,191962,830838,1022800,191036
2020/06/04,Asturias,León,64,460001,76160,383841,1022800,191036
2020/06/04,Asturias,Cantabria,192,580795,109491,471304,1022800,191036
2020/06/04,Asturias,Lugo,1090,329587,53743,275844,1022800,191036
2020/06/04,Ávila,Segovia,126,153129,25010,128119,157640,21938
2020/06/04,Ávila,Salamanca,328,330119,53813,276306,157640,21938
2020/06/04,Ávila,Madrid,434,6663394,1295213,5368181,157640,21938
2020/06/04,Ávila,Cáceres,117,394151,53259,340892,157640,21938
2020/06/04,Ávila,Ávila,13581,157640,20602,137038,157640,21938
2020/06/04,Ávila,Toledo,380,694844,106902,587942,157640,21938
2020/06/04,Ávila,Valladolid,76,519546,98957,420589,157640,21938
2020/06/04,Badajoz,Córdoba,93,782979,131933,651046,673559,103050
2020/06/04,Badajoz,Ciudad Real,56,495761,57231,438530,673559,103050
2020/06/04,Badajoz,Badajoz,78168,673559,103700,569859,673559,103050
2020/06/04,Badajoz,Cáceres,1408,394151,53259,340892,673559,103050
2020/06/04,Badajoz,Huelva,227,521870,83118,438752,673559,103050
2020/06/04,Badajoz,Sevilla,76,1942389,372714,1569675,673559,103050
2020/06/04,Balears,Balears,180121,1149460,200324,949136,1149460,201471
2020/06/04,Balears,Valencia,55,2565124,542229,2022895,1149460,201471
2020/06/04,Barcelona,Girona,3425,771044,115922,655122,5664579,1138274
2020/06/04,Barcelona,Barcelona,739932,5664579,1141820,4522759,5664579,1138274
2020/06/04,Barcelona,Lleida,275,434930,73799,361131,5664579,1138274
2020/06/04,Barcelona,Tarragona,2749,804664,133397,671267,5664579,1138274
2020/06/04,Bizkaia,Bizkaia,209479,1152934,266185,886749,1152934,260485
2020/06/04,Bizkaia,Cantabria,3444,580795,109491,471304,1152934,260485
2020/06/04,Bizkaia,Araba,1159,331549,69170,262379,1152934,260485
2020/06/04,Bizkaia,Gipuzkoa,1321,723576,132568,591008,1152934,260485
2020/06/04,Bizkaia,Burgos,95,357072,53617,303455,1152934,260485
2020/06/04,Burgos,Segovia,20,153129,25010,128119,357072,54524
2020/06/04,Burgos,Valladolid,157,519546,98957,420589,357072,54524
2020/06/04,Burgos,Soria,59,88636,9663,78973,357072,54524
2020/06/04,Burgos,Burgos,40209,357072,53617,303455,357072,54524
2020/06/04,Burgos,Palencia,254,160866,25421,135445,357072,54524
2020/06/04,Burgos,Bizkaia,190,1152934,266185,886749,357072,54524
2020/06/04,Burgos,Rioja,88,316798,56398,260400,357072,54524
2020/06/04,Burgos,Araba,1128,331549,69170,262379,357072,54524
2020/06/04,Burgos,Cantabria,23,580795,109491,471304,357072,54524
2020/06/04,Cáceres,Toledo,235,694844,106902,587942,394151,53360
2020/06/04,Cáceres,Ávila,118,157640,20602,137038,394151,53360
2020/06/04,Cáceres,Badajoz,1330,673559,103700,569859,394151,53360
2020/06/04,Cáceres,Salamanca,40,330119,53813,276306,394151,53360
2020/06/04,Cáceres,Cáceres,36771,394151,53259,340892,394151,53360
2020/06/04,Cádiz,Sevilla,1095,1942389,372714,1569675,1240155,219232
2020/06/04,Cádiz,Ceuta,49,84777,12751,72026,1240155,219232
2020/06/04,Cádiz,Cádiz,182178,1240155,215307,1024848,1240155,219232
2020/06/04,Cádiz,Málaga,1617,1661785,300377,1361408,1240155,219232
2020/06/04,Cádiz,Huelva,718,521870,83118,438752,1240155,219232
2020/06/04,Cantabria,Asturias,212,1022800,191962,830838,580795,104313
2020/06/04,Cantabria,Bizkaia,899,1152934,266185,886749,580795,104313
2020/06/04,Cantabria,Palencia,83,160866,25421,135445,580795,104313
2020/06/04,Cantabria,Cantabria,82036,580795,109491,471304,580795,104313
2020/06/04,Castellón,Castellón,73330,579962,94184,485778,579962,100067
2020/06/04,Castellón,Tarragona,1015,804664,133397,671267,579962,100067
2020/06/04,Castellón,Valencia,958,2565124,542229,2022895,579962,100067
2020/06/04,Castellón,Teruel,124,134137,11581,122556,579962,100067
2020/06/04,Ceuta,Cádiz,131,1240155,215307,1024848,84777,12766
2020/06/04,Ceuta,Ceuta,12161,84777,12751,72026,84777,12766
2020/06/04,Ciudad Real,Cuenca,62,196329,24543,171786,495761,53434
2020/06/04,Ciudad Real,Badajoz,60,673559,103700,569859,495761,53434
2020/06/04,Ciudad Real,Albacete,429,388167,45043,343124,495761,53434
2020/06/04,Ciudad Real,Córdoba,418,782979,131933,651046,495761,53434
2020/06/04,Ciudad Real,Ciudad Real,36046,495761,57231,438530,495761,53434
2020/06/04,Ciudad Real,Toledo,426,694844,106902,587942,495761,53434
2020/06/04,Córdoba,Sevilla,2130,1942389,372714,1569675,782979,129129
2020/06/04,Córdoba,Jaén,776,633564,83785,549779,782979,129129
2020/06/04,Córdoba,Badajoz,42,673559,103700,569859,782979,129129
2020/06/04,Córdoba,Córdoba,96354,782979,131933,651046,782979,129129
2020/06/04,Córdoba,Granada,116,914678,160970,753708,782979,129129
2020/06/04,Córdoba,Málaga,370,1661785,300377,1361408,782979,129129
2020/06/04,Córdoba,Ciudad Real,260,495761,57231,438530,782979,129129
2020/06/04,Coruña,Lugo,649,329587,53743,275844,1119596,228611
2020/06/04,Coruña,Pontevedra,5912,942665,197216,745449,1119596,228611
2020/06/04,Coruña,Coruña,177303,1119596,226337,893259,1119596,228611
2020/06/04,Cuenca,Toledo,171,694844,106902,587942,196329,25559
2020/06/04,Cuenca,Madrid,79,6663394,1295213,5368181,196329,25559
2020/06/04,Cuenca,Ciudad Real,152,495761,57231,438530,196329,25559
2020/06/04,Cuenca,Cuenca,13354,196329,24543,171786,196329,25559
2020/06/04,Cuenca,Guadalajara,79,257762,46226,211536,196329,25559
2020/06/04,Cuenca,Valencia,78,2565124,542229,2022895,196329,25559
2020/06/04,Cuenca,Albacete,899,388167,45043,343124,196329,25559
2020/06/04,Gipuzkoa,Araba,418,331549,69170,262379,723576,137739
2020/06/04,Gipuzkoa,Navarra,586,654183,124987,529196,723576,137739
2020/06/04,Gipuzkoa,Bizkaia,2184,1152934,266185,886749,723576,137739
2020/06/04,Gipuzkoa,Gipuzkoa,104099,723576,132568,591008,723576,137739
2020/06/04,Girona,Girona,80177,771044,115922,655122,771044,123782
2020/06/04,Girona,Lleida,271,434930,73799,361131,771044,123782
2020/06/04,Girona,Barcelona,3248,5664579,1141820,4522759,771044,123782
2020/06/04,Granada,Málaga,233,1661785,300377,1361408,914678,158832
2020/06/04,Granada,Granada,121431,914678,160970,753708,914678,158832
2020/06/04,Granada,Almería,524,716820,115430,601390,914678,158832
2020/06/04,Granada,Murcia,101,1493898,273833,1220065,914678,158832
2020/06/04,Granada,Córdoba,213,782979,131933,651046,914678,158832
2020/06/04,Granada,Jaén,436,633564,83785,549779,914678,158832
2020/06/04,Guadalajara,Guadalajara,27693,257762,46226,211536,257762,48987
2020/06/04,Guadalajara,Cuenca,105,196329,24543,171786,257762,48987
2020/06/04,Guadalajara,Madrid,3023,6663394,1295213,5368181,257762,48987
2020/06/04,Huelva,Cádiz,447,1240155,215307,1024848,521870,86743
2020/06/04,Huelva,Huelva,66137,521870,83118,438752,521870,86743
2020/06/04,Huelva,Sevilla,1194,1942389,372714,1569675,521870,86743
2020/06/04,Huelva,Badajoz,334,673559,103700,569859,521870,86743
2020/06/04,Huesca,Lleida,1195,434930,73799,361131,220461,34948
2020/06/04,Huesca,Zaragoza,332,964724,191830,772894,220461,34948
2020/06/04,Huesca,Huesca,21656,220461,31746,188715,220461,34948
2020/06/04,Jaén,Córdoba,851,782979,131933,651046,633564,83198
2020/06/04,Jaén,Granada,330,914678,160970,753708,633564,83198
2020/06/04,Jaén,Albacete,56,388167,45043,343124,633564,83198
2020/06/04,Jaén,Jaén,59909,633564,83785,549779,633564,83198
2020/06/04,Las Palmas de Gran Canaria,Santa Cruz de Tenerife,35,1032983,189605,843378,1120406,210278
2020/06/04,Las Palmas de Gran Canaria,Las Palmas de Gran Canaria,198594,1120406,210556,909850,1120406,210278
2020/06/04,León,León,57763,460001,76160,383841,460001,76110
2020/06/04,León,Asturias,56,1022800,191962,830838,460001,76110
2020/06/04,León,Lugo,36,329587,53743,275844,460001,76110
2020/06/04,León,Ourense,357,307651,60376,247275,460001,76110
2020/06/04,León,Zamora,74,172539,25336,147203,460001,76110
2020/06/04,León,Palencia,60,160866,25421,135445,460001,76110
2020/06/04,León,Valladolid,59,519546,98957,420589,460001,76110
2020/06/04,Lleida,Barcelona,368,5664579,1141820,4522759,434930,71799
2020/06/04,Lleida,Lleida,49248,434930,73799,361131,434930,71799
2020/06/04,Lleida,Girona,255,771044,115922,655122,434930,71799
2020/06/04,Lleida,Huesca,897,220461,31746,188715,434930,71799
2020/06/04,Lleida,Zaragoza,177,964724,191830,772894,434930,71799
2020/06/04,Lugo,Lugo,39005,329587,53743,275844,329587,55518
2020/06/04,Lugo,Asturias,870,1022800,191962,830838,329587,55518
2020/06/04,Lugo,Pontevedra,27,942665,197216,745449,329587,55518
2020/06/04,Lugo,León,32,460001,76160,383841,329587,55518
2020/06/04,Lugo,Coruña,713,1119596,226337,893259,329587,55518
2020/06/04,Lugo,Ourense,179,307651,60376,247275,329587,55518
2020/06/04,Madrid,Guadalajara,4046,257762,46226,211536,6663394,1290493
2020/06/04,Madrid,Segovia,62,153129,25010,128119,6663394,1290493
2020/06/04,Madrid,Alicante,17,1858683,347510,1511173,6663394,1290493
2020/06/04,Madrid,Madrid,801556,6663394,1295213,5368181,6663394,1290493
2020/06/04,Madrid,Cuenca,90,196329,24543,171786,6663394,1290493
2020/06/04,Madrid,Toledo,5191,694844,106902,587942,6663394,1290493
2020/06/04,Madrid,Ávila,329,157640,20602,137038,6663394,1290493
2020/06/04,Madrid,Zaragoza,98,964724,191830,772894,6663394,1290493
2020/06/04,Málaga,Cádiz,1359,1240155,215307,1024848,1661785,304869
2020/06/04,Málaga,Sevilla,304,1942389,372714,1569675,1661785,304869
2020/06/04,Málaga,Málaga,256433,1661785,300377,1361408,1661785,304869
2020/06/04,Málaga,Melilla,18,86487,15379,71108,1661785,304869
2020/06/04,Málaga,Granada,346,914678,160970,753708,1661785,304869
2020/06/04,Málaga,Córdoba,367,782979,131933,651046,1661785,304869
2020/06/04,Melilla,Melilla,15080,86487,15379,71108,86487,15194
2020/06/04,Murcia,Murcia,217291,1493898,273833,1220065,1493898,268880
2020/06/04,Murcia,Albacete,603,388167,45043,343124,1493898,268880
2020/06/04,Murcia,Almería,1610,716820,115430,601390,1493898,268880
2020/06/04,Murcia,Granada,30,914678,160970,753708,1493898,268880
2020/06/04,Murcia,Alicante,3143,1858683,347510,1511173,1493898,268880
2020/06/04,Navarra,Navarra,93209,654183,124987,529196,654183,127069
2020/06/04,Navarra,Araba,167,331549,69170,262379,654183,127069
2020/06/04,Navarra,Zaragoza,889,964724,191830,772894,654183,127069
2020/06/04,Navarra,Gipuzkoa,478,723576,132568,591008,654183,127069
2020/06/04,Navarra,Rioja,3033,316798,56398,260400,654183,127069
2020/06/04,Ourense,Pontevedra,229,942665,197216,745449,307651,61103
2020/06/04,Ourense,Ourense,47471,307651,60376,247275,307651,61103
2020/06/04,Ourense,León,383,460001,76160,383841,307651,61103
2020/06/04,Ourense,Lugo,197,329587,53743,275844,307651,61103
2020/06/04,Ourense,Zamora,67,172539,25336,147203,307651,61103
2020/06/04,Palencia,Cantabria,166,580795,109491,471304,160866,27268
2020/06/04,Palencia,Burgos,231,357072,53617,303455,160866,27268
2020/06/04,Palencia,Palencia,18392,160866,25421,135445,160866,27268
2020/06/04,Palencia,Valladolid,370,519546,98957,420589,160866,27268
2020/06/04,Palencia,León,26,460001,76160,383841,160866,27268
2020/06/04,Pontevedra,Ourense,236,307651,60376,247275,942665,196640
2020/06/04,Pontevedra,Pontevedra,157044,942665,197216,745449,942665,196640
2020/06/04,Pontevedra,Coruña,4532,1119596,226337,893259,942665,196640
2020/06/04,Pontevedra,Lugo,39,329587,53743,275844,942665,196640
2020/06/04,Rioja,Araba,962,331549,69170,262379,316798,53995
2020/06/04,Rioja,Burgos,145,357072,53617,303455,316798,53995
2020/06/04,Rioja,Rioja,41518,316798,56398,260400,316798,53995
2020/06/04,Rioja,Navarra,2044,654183,124987,529196,316798,53995
2020/06/04,Salamanca,Ávila,205,157640,20602,137038,330119,53577
2020/06/04,Salamanca,Cáceres,16,394151,53259,340892,330119,53577
2020/06/04,Salamanca,Zamora,56,172539,25336,147203,330119,53577
2020/06/04,Salamanca,Salamanca,42913,330119,53813,276306,330119,53577
2020/06/04,Santa Cruz de Tenerife,Santa Cruz de Tenerife,174810,1032983,189605,843378,1032983,189214
2020/06/04,Santa Cruz de Tenerife,Las Palmas de Gran Canaria,62,1120406,210556,909850,1032983,189214
2020/06/04,Segovia,Valladolid,423,519546,98957,420589,153129,26854
2020/06/04,Segovia,Madrid,20,6663394,1295213,5368181,153129,26854
2020/06/04,Segovia,Burgos,137,357072,53617,303455,153129,26854
2020/06/04,Segovia,Segovia,16943,153129,25010,128119,153129,26854
2020/06/04,Segovia,Ávila,123,157640,20602,137038,153129,26854
2020/06/04,Sevilla,Málaga,74,1661785,300377,1361408,1942389,365921
2020/06/04,Sevilla,Cádiz,859,1240155,215307,1024848,1942389,365921
2020/06/04,Sevilla,Sevilla,276536,1942389,372714,1569675,1942389,365921
2020/06/04,Sevilla,Badajoz,57,673559,103700,569859,1942389,365921
2020/06/04,Sevilla,Huelva,570,521870,83118,438752,1942389,365921
2020/06/04,Sevilla,Córdoba,2145,782979,131933,651046,1942389,365921
2020/06/04,Soria,Navarra,36,654183,124987,529196,88636,10756
2020/06/04,Soria,Burgos,56,357072,53617,303455,88636,10756
2020/06/04,Soria,Valladolid,49,519546,98957,420589,88636,10756
2020/06/04,Soria,Zaragoza,169,964724,191830,772894,88636,10756
2020/06/04,Soria,Soria,7290,88636,9663,78973,88636,10756
2020/06/04,Soria,Segovia,26,153129,25010,128119,88636,10756
2020/06/04,Tarragona,Tarragona,91935,804664,133397,671267,804664,134009
2020/06/04,Tarragona,Castellón,864,579962,94184,485778,804664,134009
2020/06/04,Tarragona,Barcelona,1602,5664579,1141820,4522759,804664,134009
2020/06/04,Tarragona,Teruel,53,134137,11581,122556,804664,134009
2020/06/04,Tarragona,Lleida,49,434930,73799,361131,804664,134009
2020/06/04,Tarragona,Zaragoza,39,964724,191830,772894,804664,134009
2020/06/04,Teruel,Zaragoza,247,964724,191830,772894,134137,13767
2020/06/04,Teruel,Castellón,44,579962,94184,485778,134137,13767
2020/06/04,Teruel,Teruel,7096,134137,11581,122556,134137,13767
2020/06/04,Teruel,Tarragona,47,804664,133397,671267,134137,13767
2020/06/04,Teruel,Valencia,31,2565124,542229,2022895,134137,13767
2020/06/04,Toledo,Ávila,265,157640,20602,137038,694844,103366
2020/06/04,Toledo,Toledo,52369,694844,106902,587942,694844,103366
2020/06/04,Toledo,Cáceres,224,394151,53259,340892,694844,103366
2020/06/04,Toledo,Ciudad Real,431,495761,57231,438530,694844,103366
2020/06/04,Toledo,Cuenca,176,196329,24543,171786,694844,103366
2020/06/04,Toledo,Madrid,4450,6663394,1295213,5368181,694844,103366
2020/06/04,Valencia,Murcia,30,1493898,273833,1220065,2565124,528594
2020/06/04,Valencia,Albacete,402,388167,45043,343124,2565124,528594
2020/06/04,Valencia,Cuenca,136,196329,24543,171786,2565124,528594
2020/06/04,Valencia,Castellón,751,579962,94184,485778,2565124,528594
2020/06/04,Valencia,Alicante,1557,1858683,347510,1511173,2565124,528594
2020/06/04,Valencia,Valencia,397360,2565124,542229,2022895,2565124,528594
2020/06/04,Valladolid,Zamora,210,172539,25336,147203,519546,95378
2020/06/04,Valladolid,León,38,460001,76160,383841,519546,95378
2020/06/04,Valladolid,Palencia,73,160866,25421,135445,519546,95378
2020/06/04,Valladolid,Soria,24,88636,9663,78973,519546,95378
2020/06/04,Valladolid,Segovia,599,153129,25010,128119,519546,95378
2020/06/04,Valladolid,Valladolid,73601,519546,98957,420589,519546,95378
2020/06/04,Valladolid,Burgos,119,357072,53617,303455,519546,95378
2020/06/04,Valladolid,Ávila,24,157640,20602,137038,519546,95378
2020/06/04,Zamora,Zamora,17388,172539,25336,147203,172539,25572
2020/06/04,Zamora,Valladolid,135,519546,98957,420589,172539,25572
2020/06/04,Zamora,Salamanca,24,330119,53813,276306,172539,25572
2020/06/04,Zamora,Ourense,152,307651,60376,247275,172539,25572
2020/06/04,Zamora,León,62,460001,76160,383841,172539,25572
2020/06/04,Zaragoza,Soria,93,88636,9663,78973,964724,185280
2020/06/04,Zaragoza,Teruel,199,134137,11581,122556,964724,185280
2020/06/04,Zaragoza,Tarragona,42,804664,133397,671267,964724,185280
2020/06/04,Zaragoza,Zaragoza,150793,964724,191830,772894,964724,185280
2020/06/04,Zaragoza,Lleida,119,434930,73799,361131,964724,185280
2020/06/04,Zaragoza,Navarra,530,654183,124987,529196,964724,185280
2020/06/04,Zaragoza,Huesca,265,220461,31746,188715,964724,185280
2020/06/05,Albacete,Murcia,718,1493898,276481,1217417,388167,48555
2020/06/05,Albacete,Cuenca,854,196329,24829,171500,388167,48555
2020/06/05,Albacete,Valencia,473,2565124,552109,2013015,388167,48555
2020/06/05,Albacete,Albacete,31407,388167,46522,341645,388167,48555
2020/06/05,Albacete,Jaén,52,633564,84192,549372,388167,48555
2020/06/05,Albacete,Ciudad Real,730,495761,57423,438338,388167,48555
2020/06/05,Albacete,Alicante,234,1858683,346221,1512462,388167,48555
2020/06/05,Alicante,Albacete,417,388167,46522,341645,1858683,352637
2020/06/05,Alicante,Murcia,3788,1493898,276481,1217417,1858683,352637
2020/06/05,Alicante,Valencia,1835,2565124,552109,2013015,1858683,352637
2020/06/05,Alicante,Alicante,277625,1858683,346221,1512462,1858683,352637
2020/06/05,Almería,Granada,534,914678,157849,756829,716820,118015
2020/06/05,Almería,Almería,97532,716820,116339,600481,716820,118015
2020/06/05,Almería,Murcia,1898,1493898,276481,1217417,716820,118015
2020/06/05,Araba,Navarra,185,654183,125851,528332,331549,80728
2020/06/05,Araba,Rioja,2289,316798,59650,257148,331549,80728
2020/06/05,Araba,Burgos,2202,357072,56215,300857,331549,80728
2020/06/05,Araba,Gipuzkoa,358,723576,135952,587624,331549,80728
2020/06/05,Araba,Bizkaia,2162,1152934,266523,886411,331549,80728
2020/06/05,Araba,Araba,60257,331549,72584,258965,331549,80728
2020/06/05,Asturias,León,232,460001,79995,380006,1022800,197452
2020/06/05,Asturias,Asturias,164979,1022800,197397,825403,1022800,197452
2020/06/05,Asturias,Lugo,1168,329587,54215,275372,1022800,197452
2020/06/05,Asturias,Cantabria,212,580795,110693,470102,1022800,197452
2020/06/05,Ávila,Segovia,143,153129,24007,129122,157640,22835
2020/06/05,Ávila,Toledo,316,694844,107981,586863,157640,22835
2020/06/05,Ávila,Valladolid,69,519546,103589,415957,157640,22835
2020/06/05,Ávila,Ávila,14258,157640,21181,136459,157640,22835
2020/06/05,Ávila,Madrid,193,6663394,1316270,5347124,157640,22835
2020/06/05,Ávila,Salamanca,356,330119,56586,273533,157640,22835
2020/06/05,Ávila,Cáceres,165,394151,54484,339667,157640,22835
2020/06/05,Badajoz,Ciudad Real,84,495761,57423,438338,673559,103700
2020/06/05,Badajoz,Cáceres,1430,394151,54484,339667,673559,103700
2020/06/05,Badajoz,Córdoba,97,782979,132909,650070,673559,103700
2020/06/05,Badajoz,Sevilla,74,1942389,376558,1565831,673559,103700
2020/06/05,Badajoz,Badajoz,79954,673559,104706,568853,673559,103700
2020/06/05,Badajoz,Huelva,193,521870,86473,435397,673559,103700
2020/06/05,Balears,Balears,183238,1149460,202567,946893,1149460,203285
2020/06/05,Balears,Valencia,106,2565124,552109,2013015,1149460,203285
2020/06/05,Balears,Barcelona,20,5664579,1214291,4450288,1149460,203285
2020/06/05,Barcelona,Barcelona,806437,5664579,1214291,4450288,5664579,1209565
2020/06/05,Barcelona,Tarragona,2760,804664,140344,664320,5664579,1209565
2020/06/05,Barcelona,Girona,3605,771044,122765,648279,5664579,1209565
2020/06/05,Barcelona,Lleida,319,434930,76662,358268,5664579,1209565
2020/06/05,Bizkaia,Araba,1209,331549,72584,258965,1152934,261317
2020/06/05,Bizkaia,Gipuzkoa,1404,723576,135952,587624,1152934,261317
2020/06/05,Bizkaia,Cantabria,3151,580795,110693,470102,1152934,261317
2020/06/05,Bizkaia,Bizkaia,211927,1152934,266523,886411,1152934,261317
2020/06/05,Bizkaia,Burgos,80,357072,56215,300857,1152934,261317
2020/06/05,Burgos,Segovia,102,153129,24007,129122,357072,57671
2020/06/05,Burgos,Araba,1475,331549,72584,258965,357072,57671
2020/06/05,Burgos,Soria,53,88636,10022,78614,357072,57671
2020/06/05,Burgos,Valladolid,89,519546,103589,415957,357072,57671
2020/06/05,Burgos,Rioja,73,316798,59650,257148,357072,57671
2020/06/05,Burgos,Palencia,332,160866,27629,133237,357072,57671
2020/06/05,Burgos,Burgos,43205,357072,56215,300857,357072,57671
2020/06/05,Burgos,Cantabria,16,580795,110693,470102,357072,57671
2020/06/05,Burgos,Bizkaia,190,1152934,266523,886411,357072,57671
2020/06/05,Cáceres,Toledo,289,694844,107981,586863,394151,54465
2020/06/05,Cáceres,Valencia,29,2565124,552109,2013015,394151,54465
2020/06/05,Cáceres,Cáceres,38431,394151,54484,339667,394151,54465
2020/06/05,Cáceres,Badajoz,1231,673559,104706,568853,394151,54465
2020/06/05,Cáceres,Ávila,121,157640,21181,136459,394151,54465
2020/06/05,Cádiz,Málaga,1479,1661785,305105,1356680,1240155,229221
2020/06/05,Cádiz,Cádiz,193732,1240155,225986,1014169,1240155,229221
2020/06/05,Cádiz,Ceuta,83,84777,12792,71985,1240155,229221
2020/06/05,Cádiz,Huelva,677,521870,86473,435397,1240155,229221
2020/06/05,Cádiz,Sevilla,1119,1942389,376558,1565831,1240155,229221
2020/06/05,Cantabria,Burgos,26,357072,56215,300857,580795,105919
2020/06/05,Cantabria,Cantabria,83825,580795,110693,470102,580795,105919
2020/06/05,Cantabria,Asturias,170,1022800,197397,825403,580795,105919
2020/06/05,Cantabria,Palencia,71,160866,27629,133237,580795,105919
2020/06/05,Cantabria,Bizkaia,955,1152934,266523,886411,580795,105919
2020/06/05,Castellón,Valencia,999,2565124,552109,2013015,579962,102452
2020/06/05,Castellón,Castellón,75964,579962,97602,482360,579962,102452
2020/06/05,Castellón,Tarragona,1041,804664,140344,664320,579962,102452
2020/06/05,Ceuta,Cádiz,73,1240155,225986,1014169,84777,12841
2020/06/05,Ceuta,Ceuta,12258,84777,12792,71985,84777,12841
2020/06/05,Ciudad Real,Cuenca,95,196329,24829,171500,495761,54609
2020/06/05,Ciudad Real,Córdoba,389,782979,132909,650070,495761,54609
2020/06/05,Ciudad Real,Albacete,540,388167,46522,341645,495761,54609
2020/06/05,Ciudad Real,Badajoz,101,673559,104706,568853,495761,54609
2020/06/05,Ciudad Real,Toledo,551,694844,107981,586863,495761,54609
2020/06/05,Ciudad Real,Ciudad Real,37186,495761,57423,438338,495761,54609
2020/06/05,Ciudad Real,Jaén,17,633564,84192,549372,495761,54609
2020/06/05,Córdoba,Badajoz,125,673559,104706,568853,782979,130784
2020/06/05,Córdoba,Ciudad Real,311,495761,57423,438338,782979,130784
2020/06/05,Córdoba,Córdoba,98195,782979,132909,650070,782979,130784
2020/06/05,Córdoba,Sevilla,2011,1942389,376558,1565831,782979,130784
2020/06/05,Córdoba,Jaén,867,633564,84192,549372,782979,130784
2020/06/05,Córdoba,Málaga,371,1661785,305105,1356680,782979,130784
2020/06/05,Córdoba,Granada,121,914678,157849,756829,782979,130784
2020/06/05,Coruña,Lugo,691,329587,54215,275372,1119596,231089
2020/06/05,Coruña,Coruña,179100,1119596,228152,891444,1119596,231089
2020/06/05,Coruña,Pontevedra,6290,942665,202539,740126,1119596,231089
2020/06/05,Cuenca,Toledo,165,694844,107981,586863,196329,25943
2020/06/05,Cuenca,Guadalajara,75,257762,46241,211521,196329,25943
2020/06/05,Cuenca,Ciudad Real,108,495761,57423,438338,196329,25943
2020/06/05,Cuenca,Valencia,89,2565124,552109,2013015,196329,25943
2020/06/05,Cuenca,Cuenca,13810,196329,24829,171500,196329,25943
2020/06/05,Cuenca,Albacete,952,388167,46522,341645,196329,25943
2020/06/05,Cuenca,Madrid,71,6663394,1316270,5347124,196329,25943
2020/06/05,Gipuzkoa,Gipuzkoa,107947,723576,135952,587624,723576,139496
2020/06/05,Gipuzkoa,Navarra,575,654183,125851,528332,723576,139496
2020/06/05,Gipuzkoa,Bizkaia,2209,1152934,266523,886411,723576,139496
2020/06/05,Gipuzkoa,Araba,369,331549,72584,258965,723576,139496
2020/06/05,Girona,Lleida,252,434930,76662,358268,771044,130614
2020/06/05,Girona,Girona,85829,771044,122765,648279,771044,130614
2020/06/05,Girona,Barcelona,3470,5664579,1214291,4450288,771044,130614
2020/06/05,Granada,Málaga,254,1661785,305105,1356680,914678,156341
2020/06/05,Granada,Granada,119609,914678,157849,756829,914678,156341
2020/06/05,Granada,Córdoba,181,782979,132909,650070,914678,156341
2020/06/05,Granada,Murcia,124,1493898,276481,1217417,914678,156341
2020/06/05,Granada,Almería,627,716820,116339,600481,914678,156341
2020/06/05,Granada,Jaén,396,633564,84192,549372,914678,156341
2020/06/05,Guadalajara,Madrid,3054,6663394,1316270,5347124,257762,49734
2020/06/05,Guadalajara,Guadalajara,28364,257762,46241,211521,257762,49734
2020/06/05,Guadalajara,Cuenca,25,196329,24829,171500,257762,49734
2020/06/05,Huelva,Huelva,69661,521870,86473,435397,521870,89617
2020/06/05,Huelva,Cádiz,478,1240155,225986,1014169,521870,89617
2020/06/05,Huelva,Badajoz,365,673559,104706,568853,521870,89617
2020/06/05,Huelva,Sevilla,1176,1942389,376558,1565831,521870,89617
2020/06/05,Huesca,Zaragoza,491,964724,207990,756734,220461,36782
2020/06/05,Huesca,Huesca,23357,220461,33341,187120,220461,36782
2020/06/05,Huesca,Lleida,1378,434930,76662,358268,220461,36782
2020/06/05,Jaén,Córdoba,959,782979,132909,650070,633564,83292
2020/06/05,Jaén,Albacete,32,388167,46522,341645,633564,83292
2020/06/05,Jaén,Granada,314,914678,157849,756829,633564,83292
2020/06/05,Jaén,Jaén,60588,633564,84192,549372,633564,83292
2020/06/05,Las Palmas de Gran Canaria,Las Palmas de Gran Canaria,203107,1120406,215160,905246,1120406,214565
2020/06/05,León,Valladolid,34,519546,103589,415957,460001,79435
2020/06/05,León,Palencia,67,160866,27629,133237,460001,79435
2020/06/05,León,Lugo,68,329587,54215,275372,460001,79435
2020/06/05,León,Zamora,130,172539,25784,146755,460001,79435
2020/06/05,León,Ourense,396,307651,60883,246768,460001,79435
2020/06/05,León,Asturias,79,1022800,197397,825403,460001,79435
2020/06/05,León,León,61653,460001,79995,380006,460001,79435
2020/06/05,Lleida,Tarragona,28,804664,140344,664320,434930,74418
2020/06/05,Lleida,Zaragoza,175,964724,207990,756734,434930,74418
2020/06/05,Lleida,Lleida,52091,434930,76662,358268,434930,74418
2020/06/05,Lleida,Girona,259,771044,122765,648279,434930,74418
2020/06/05,Lleida,Huesca,894,220461,33341,187120,434930,74418
2020/06/05,Lleida,Barcelona,392,5664579,1214291,4450288,434930,74418
2020/06/05,Lugo,Lugo,39404,329587,54215,275372,329587,55858
2020/06/05,Lugo,Coruña,710,1119596,228152,891444,329587,55858
2020/06/05,Lugo,Asturias,867,1022800,197397,825403,329587,55858
2020/06/05,Lugo,León,31,460001,79995,380006,329587,55858
2020/06/05,Lugo,Ourense,211,307651,60883,246768,329587,55858
2020/06/05,Madrid,Toledo,4822,694844,107981,586863,6663394,1311049
2020/06/05,Madrid,Ávila,308,157640,21181,136459,6663394,1311049
2020/06/05,Madrid,Cuenca,78,196329,24829,171500,6663394,1311049
2020/06/05,Madrid,Segovia,55,153129,24007,129122,6663394,1311049
2020/06/05,Madrid,Guadalajara,3900,257762,46241,211521,6663394,1311049
2020/06/05,Madrid,Madrid,822040,6663394,1316270,5347124,6663394,1311049
2020/06/05,Málaga,Sevilla,374,1942389,376558,1565831,1661785,308810
2020/06/05,Málaga,Cádiz,1390,1240155,225986,1014169,1661785,308810
2020/06/05,Málaga,Córdoba,374,782979,132909,650070,1661785,308810
2020/06/05,Málaga,Granada,368,914678,157849,756829,1661785,308810
2020/06/05,Málaga,Málaga,261304,1661785,305105,1356680,1661785,308810
2020/06/05,Melilla,Melilla,15474,86487,15743,70744,86487,15616
2020/06/05,Murcia,Alicante,3140,1858683,346221,1512462,1493898,271967
2020/06/05,Murcia,Almería,1285,716820,116339,600481,1493898,271967
2020/06/05,Murcia,Albacete,658,388167,46522,341645,1493898,271967
2020/06/05,Murcia,Murcia,221877,1493898,276481,1217417,1493898,271967
2020/06/05,Navarra,Araba,104,331549,72584,258965,654183,125886
2020/06/05,Navarra,Navarra,93922,654183,125851,528332,654183,125886
2020/06/05,Navarra,Zaragoza,780,964724,207990,756734,654183,125886
2020/06/05,Navarra,Gipuzkoa,420,723576,135952,587624,654183,125886
2020/06/05,Navarra,Rioja,2884,316798,59650,257148,654183,125886
2020/06/05,Navarra,Bizkaia,20,1152934,266523,886411,654183,125886
2020/06/05,Ourense,Zamora,68,172539,25784,146755,307651,61018
2020/06/05,Ourense,Pontevedra,180,942665,202539,740126,307651,61018
2020/06/05,Ourense,Lugo,232,329587,54215,275372,307651,61018
2020/06/05,Ourense,Ourense,47927,307651,60883,246768,307651,61018
2020/06/05,Ourense,León,366,460001,79995,380006,307651,61018
2020/06/05,Palencia,Palencia,20391,160866,27629,133237,160866,28830
2020/06/05,Palencia,León,56,460001,79995,380006,160866,28830
2020/06/05,Palencia,Burgos,246,357072,56215,300857,160866,28830
2020/06/05,Palencia,Cantabria,256,580795,110693,470102,160866,28830
2020/06/05,Palencia,Valladolid,397,519546,103589,415957,160866,28830
2020/06/05,Pontevedra,Lugo,74,329587,54215,275372,942665,201814
2020/06/05,Pontevedra,Coruña,4856,1119596,228152,891444,942665,201814
2020/06/05,Pontevedra,Pontevedra,162297,942665,202539,740126,942665,201814
2020/06/05,Pontevedra,Ourense,284,307651,60883,246768,942665,201814
2020/06/05,Rioja,Burgos,82,357072,56215,300857,316798,57168
2020/06/05,Rioja,Rioja,45346,316798,59650,257148,316798,57168
2020/06/05,Rioja,Araba,901,331549,72584,258965,316798,57168
2020/06/05,Rioja,Navarra,2027,654183,125851,528332,316798,57168
2020/06/05,Salamanca,Zamora,102,172539,25784,146755,330119,55927
2020/06/05,Salamanca,Cáceres,67,394151,54484,339667,330119,55927
2020/06/05,Salamanca,Salamanca,45539,330119,56586,273533,330119,55927
2020/06/05,Salamanca,Ávila,227,157640,21181,136459,330119,55927
2020/06/05,Santa Cruz de Tenerife,Santa Cruz de Tenerife,181604,1032983,196122,836861,1032983,195681
2020/06/05,Santa Cruz de Tenerife,Las Palmas de Gran Canaria,35,1120406,215160,905246,1032983,195681
2020/06/05,Segovia,Valladolid,412,519546,103589,415957,153129,26119
2020/06/05,Segovia,Segovia,16439,153129,24007,129122,153129,26119
2020/06/05,Segovia,Ávila,138,157640,21181,136459,153129,26119
2020/06/05,Segovia,Madrid,20,6663394,1316270,5347124,153129,26119
2020/06/05,Segovia,Burgos,133,357072,56215,300857,153129,26119
2020/06/05,Sevilla,Huelva,711,521870,86473,435397,1942389,371728
2020/06/05,Sevilla,Málaga,138,1661785,305105,1356680,1942389,371728
2020/06/05,Sevilla,Córdoba,2268,782979,132909,650070,1942389,371728
2020/06/05,Sevilla,Cádiz,862,1240155,225986,1014169,1942389,371728
2020/06/05,Sevilla,Sevilla,283995,1942389,376558,1565831,1942389,371728
2020/06/05,Sevilla,Badajoz,48,673559,104706,568853,1942389,371728
2020/06/05,Soria,Zaragoza,124,964724,207990,756734,88636,11091
2020/06/05,Soria,Burgos,99,357072,56215,300857,88636,11091
2020/06/05,Soria,Navarra,39,654183,125851,528332,88636,11091
2020/06/05,Soria,Valladolid,44,519546,103589,415957,88636,11091
2020/06/05,Soria,Soria,7681,88636,10022,78614,88636,11091
2020/06/05,Soria,Segovia,21,153129,24007,129122,88636,11091
2020/06/05,Soria,Rioja,17,316798,59650,257148,88636,11091
2020/06/05,Tarragona,Lleida,17,434930,76662,358268,804664,141216
2020/06/05,Tarragona,Tarragona,99567,804664,140344,664320,804664,141216
2020/06/05,Tarragona,Castellón,1089,579962,97602,482360,804664,141216
2020/06/05,Tarragona,Zaragoza,37,964724,207990,756734,804664,141216
2020/06/05,Tarragona,Barcelona,1813,5664579,1214291,4450288,804664,141216
2020/06/05,Tarragona,Teruel,71,134137,12337,121800,804664,141216
2020/06/05,Teruel,Teruel,7656,134137,12337,121800,134137,14162
2020/06/05,Teruel,Zaragoza,317,964724,207990,756734,134137,14162
2020/06/05,Teruel,Tarragona,72,804664,140344,664320,134137,14162
2020/06/05,Teruel,Castellón,56,579962,97602,482360,134137,14162
2020/06/05,Teruel,Valencia,59,2565124,552109,2013015,134137,14162
2020/06/05,Toledo,Ciudad Real,439,495761,57423,438338,694844,106730
2020/06/05,Toledo,Madrid,4430,6663394,1316270,5347124,694844,106730
2020/06/05,Toledo,Cuenca,127,196329,24829,171500,694844,106730
2020/06/05,Toledo,Toledo,55372,694844,107981,586863,694844,106730
2020/06/05,Toledo,Cáceres,250,394151,54484,339667,694844,106730
2020/06/05,Toledo,Ávila,280,157640,21181,136459,694844,106730
2020/06/05,Valencia,Albacete,307,388167,46522,341645,2565124,540350
2020/06/05,Valencia,Cuenca,178,196329,24829,171500,2565124,540350
2020/06/05,Valencia,Murcia,21,1493898,276481,1217417,2565124,540350
2020/06/05,Valencia,Valencia,410686,2565124,552109,2013015,2565124,540350
2020/06/05,Valencia,Teruel,37,134137,12337,121800,2565124,540350
2020/06/05,Valencia,Cáceres,23,394151,54484,339667,2565124,540350
2020/06/05,Valencia,Alicante,1489,1858683,346221,1512462,2565124,540350
2020/06/05,Valencia,Castellón,693,579962,97602,482360,2565124,540350
2020/06/05,Valladolid,Segovia,365,153129,24007,129122,519546,100464
2020/06/05,Valladolid,Burgos,110,357072,56215,300857,519546,100464
2020/06/05,Valladolid,Soria,38,88636,10022,78614,519546,100464
2020/06/05,Valladolid,Ávila,31,157640,21181,136459,519546,100464
2020/06/05,Valladolid,Valladolid,78808,519546,103589,415957,519546,100464
2020/06/05,Valladolid,León,50,460001,79995,380006,519546,100464
2020/06/05,Valladolid,Zamora,105,172539,25784,146755,519546,100464
2020/06/05,Valladolid,Palencia,71,160866,27629,133237,519546,100464
2020/06/05,Zamora,Valladolid,91,519546,103589,415957,172539,25838
2020/06/05,Zamora,Salamanca,60,330119,56586,273533,172539,25838
2020/06/05,Zamora,Zamora,18107,172539,25784,146755,172539,25838
2020/06/05,Zamora,Ourense,56,307651,60883,246768,172539,25838
2020/06/05,Zamora,León,23,460001,79995,380006,172539,25838
2020/06/05,Zaragoza,Lleida,141,434930,76662,358268,964724,201140
2020/06/05,Zaragoza,Navarra,607,654183,125851,528332,964724,201140
2020/06/05,Zaragoza,Teruel,279,134137,12337,121800,964724,201140
2020/06/05,Zaragoza,Soria,63,88636,10022,78614,964724,201140
2020/06/05,Zaragoza,Tarragona,33,804664,140344,664320,964724,201140
2020/06/05,Zaragoza,Zaragoza,166743,964724,207990,756734,964724,201140
2020/06/05,Zaragoza,Huesca,318,220461,33341,187120,964724,201140
2020/06/06,Albacete,Alicante,228,1858683,316268,1542415,388167,43679
2020/06/06,Albacete,Valencia,429,2565124,497601,2067523,388167,43679
2020/06/06,Albacete,Cuenca,599,196329,21913,174416,388167,43679
2020/06/06,Albacete,Jaén,63,633564,77613,555951,388167,43679
2020/06/06,Albacete,Murcia,678,1493898,249271,1244627,388167,43679
2020/06/06,Albacete,Ciudad Real,659,495761,47715,448046,388167,43679
2020/06/06,Albacete,Albacete,30387,388167,42071,346096,388167,43679
2020/06/06,Alicante,Albacete,295,388167,42071,346096,1858683,320047
2020/06/06,Alicante,Murcia,3324,1493898,249271,1244627,1858683,320047
2020/06/06,Alicante,Alicante,257583,1858683,316268,1542415,1858683,320047
2020/06/06,Alicante,Valencia,1726,2565124,497601,2067523,1858683,320047
2020/06/06,Almería,Almería,83869,716820,100501,616319,716820,101015
2020/06/06,Almería,Granada,498,914678,149801,764877,716820,101015
2020/06/06,Almería,Murcia,1324,1493898,249271,1244627,716820,101015
2020/06/06,Araba,Rioja,1316,316798,50276,266522,331549,64731
2020/06/06,Araba,Navarra,161,654183,110702,543481,331549,64731
2020/06/06,Araba,Burgos,1181,357072,48234,308838,331549,64731
2020/06/06,Araba,Araba,52632,331549,62494,269055,331549,64731
2020/06/06,Araba,Gipuzkoa,275,723576,110584,612992,331549,64731
2020/06/06,Araba,Bizkaia,1031,1152934,218924,934010,331549,64731
2020/06/06,Asturias,León,44,460001,69287,390714,1022800,166521
2020/06/06,Asturias,Lugo,889,329587,44080,285507,1022800,166521
2020/06/06,Asturias,Asturias,139285,1022800,166469,856331,1022800,166521
2020/06/06,Asturias,Cantabria,255,580795,92670,488125,1022800,166521
2020/06/06,Ávila,Valladolid,78,519546,82854,436692,157640,19929
2020/06/06,Ávila,Toledo,234,694844,83441,611403,157640,19929
2020/06/06,Ávila,Segovia,101,153129,20221,132908,157640,19929
2020/06/06,Ávila,Ávila,12617,157640,17532,140108,157640,19929
2020/06/06,Ávila,Madrid,240,6663394,1105081,5558313,157640,19929
2020/06/06,Ávila,Salamanca,312,330119,47497,282622,157640,19929
2020/06/06,Ávila,Cáceres,136,394151,46300,347851,157640,19929
2020/06/06,Badajoz,Huelva,157,521870,73468,448402,673559,87301
2020/06/06,Badajoz,Sevilla,99,1942389,319440,1622949,673559,87301
2020/06/06,Badajoz,Cáceres,1116,394151,46300,347851,673559,87301
2020/06/06,Badajoz,Ciudad Real,59,495761,47715,448046,673559,87301
2020/06/06,Badajoz,Córdoba,90,782979,114835,668144,673559,87301
2020/06/06,Badajoz,Badajoz,68005,673559,87827,585732,673559,87301
2020/06/06,Balears,Valencia,25,2565124,497601,2067523,1149460,185669
2020/06/06,Balears,Balears,168250,1149460,185192,964268,1149460,185669
2020/06/06,Barcelona,Girona,3444,771044,112595,658449,5664579,1034345
2020/06/06,Barcelona,Barcelona,685165,5664579,1040299,4624280,5664579,1034345
2020/06/06,Barcelona,Tarragona,1796,804664,125335,679329,5664579,1034345
2020/06/06,Barcelona,Lleida,294,434930,64474,370456,5664579,1034345
2020/06/06,Bizkaia,Gipuzkoa,752,723576,110584,612992,1152934,214641
2020/06/06,Bizkaia,Burgos,61,357072,48234,308838,1152934,214641
2020/06/06,Bizkaia,Bizkaia,177388,1152934,218924,934010,1152934,214641
2020/06/06,Bizkaia,Araba,949,331549,62494,269055,1152934,214641
2020/06/06,Bizkaia,Cantabria,1183,580795,92670,488125,1152934,214641
2020/06/06,Burgos,Bizkaia,162,1152934,218924,934010,357072,50636
2020/06/06,Burgos,Palencia,192,160866,22758,138108,357072,50636
2020/06/06,Burgos,Soria,32,88636,8690,79946,357072,50636
2020/06/06,Burgos,Burgos,38995,357072,48234,308838,357072,50636
2020/06/06,Burgos,Valladolid,111,519546,82854,436692,357072,50636
2020/06/06,Burgos,Araba,2332,331549,62494,269055,357072,50636
2020/06/06,Burgos,Cantabria,31,580795,92670,488125,357072,50636
2020/06/06,Burgos,Segovia,46,153129,20221,132908,357072,50636
2020/06/06,Burgos,Rioja,19,316798,50276,266522,357072,50636
2020/06/06,Cáceres,Cáceres,33951,394151,46300,347851,394151,46320
2020/06/06,Cáceres,Salamanca,41,330119,47497,282622,394151,46320
2020/06/06,Cáceres,Toledo,187,694844,83441,611403,394151,46320
2020/06/06,Cáceres,Ávila,133,157640,17532,140108,394151,46320
2020/06/06,Cáceres,Valencia,22,2565124,497601,2067523,394151,46320
2020/06/06,Cáceres,Badajoz,1038,673559,87827,585732,394151,46320
2020/06/06,Cádiz,Málaga,1050,1661785,268966,1392819,1240155,214664
2020/06/06,Cádiz,Ceuta,168,84777,11359,73418,1240155,214664
2020/06/06,Cádiz,Cádiz,185555,1240155,212118,1028037,1240155,214664
2020/06/06,Cádiz,Sevilla,884,1942389,319440,1622949,1240155,214664
2020/06/06,Cádiz,Huelva,672,521870,73468,448402,1240155,214664
2020/06/06,Cantabria,Cantabria,72971,580795,92670,488125,580795,92139
2020/06/06,Cantabria,Palencia,90,160866,22758,138108,580795,92139
2020/06/06,Cantabria,Bizkaia,1157,1152934,218924,934010,580795,92139
2020/06/06,Cantabria,Asturias,205,1022800,166469,856331,580795,92139
2020/06/06,Castellón,Valencia,988,2565124,497601,2067523,579962,85678
2020/06/06,Castellón,Castellón,66544,579962,83276,496686,579962,85678
2020/06/06,Castellón,Teruel,38,134137,10714,123423,579962,85678
2020/06/06,Castellón,Tarragona,1001,804664,125335,679329,579962,85678
2020/06/06,Ceuta,Ceuta,10635,84777,11359,73418,84777,11189
2020/06/06,Ceuta,Cádiz,97,1240155,212118,1028037,84777,11189
2020/06/06,Ciudad Real,Jaén,24,633564,77613,555951,495761,47198
2020/06/06,Ciudad Real,Albacete,475,388167,42071,346096,495761,47198
2020/06/06,Ciudad Real,Cuenca,50,196329,21913,174416,495761,47198
2020/06/06,Ciudad Real,Córdoba,319,782979,114835,668144,495761,47198
2020/06/06,Ciudad Real,Badajoz,50,673559,87827,585732,495761,47198
2020/06/06,Ciudad Real,Toledo,321,694844,83441,611403,495761,47198
2020/06/06,Ciudad Real,Ciudad Real,32849,495761,47715,448046,495761,47198
2020/06/06,Córdoba,Ciudad Real,360,495761,47715,448046,782979,114589
2020/06/06,Córdoba,Jaén,782,633564,77613,555951,782979,114589
2020/06/06,Córdoba,Córdoba,87197,782979,114835,668144,782979,114589
2020/06/06,Córdoba,Granada,135,914678,149801,764877,782979,114589
2020/06/06,Córdoba,Sevilla,1781,1942389,319440,1622949,782979,114589
2020/06/06,Córdoba,Badajoz,170,673559,87827,585732,782979,114589
2020/06/06,Córdoba,Málaga,254,1661785,268966,1392819,782979,114589
2020/06/06,Coruña,Coruña,138760,1119596,179134,940462,1119596,181625
2020/06/06,Coruña,Pontevedra,4730,942665,159164,783501,1119596,181625
2020/06/06,Coruña,Lugo,582,329587,44080,285507,1119596,181625
2020/06/06,Cuenca,Toledo,126,694844,83441,611403,196329,23348
2020/06/06,Cuenca,Madrid,63,6663394,1105081,5558313,196329,23348
2020/06/06,Cuenca,Ciudad Real,121,495761,47715,448046,196329,23348
2020/06/06,Cuenca,Guadalajara,119,257762,39603,218159,196329,23348
2020/06/06,Cuenca,Albacete,810,388167,42071,346096,196329,23348
2020/06/06,Cuenca,Valencia,105,2565124,497601,2067523,196329,23348
2020/06/06,Cuenca,Cuenca,13951,196329,21913,174416,196329,23348
2020/06/06,Gipuzkoa,Navarra,307,654183,110702,543481,723576,111780
2020/06/06,Gipuzkoa,Araba,114,331549,62494,269055,723576,111780
2020/06/06,Gipuzkoa,Gipuzkoa,87470,723576,110584,612992,723576,111780
2020/06/06,Gipuzkoa,Bizkaia,1170,1152934,218924,934010,723576,111780
2020/06/06,Girona,Barcelona,2958,5664579,1040299,4624280,771044,118402
2020/06/06,Girona,Tarragona,18,804664,125335,679329,771044,118402
2020/06/06,Girona,Lleida,202,434930,64474,370456,771044,118402
2020/06/06,Girona,Girona,79244,771044,112595,658449,771044,118402
2020/06/06,Granada,Murcia,45,1493898,249271,1244627,914678,150834
2020/06/06,Granada,Córdoba,210,782979,114835,668144,914678,150834
2020/06/06,Granada,Málaga,235,1661785,268966,1392819,914678,150834
2020/06/06,Granada,Jaén,570,633564,77613,555951,914678,150834
2020/06/06,Granada,Almería,695,716820,100501,616319,914678,150834
2020/06/06,Granada,Granada,115579,914678,149801,764877,914678,150834
2020/06/06,Guadalajara,Teruel,21,134137,10714,123423,257762,42931
2020/06/06,Guadalajara,Cuenca,65,196329,21913,174416,257762,42931
2020/06/06,Guadalajara,Madrid,2287,6663394,1105081,5558313,257762,42931
2020/06/06,Guadalajara,Guadalajara,28379,257762,39603,218159,257762,42931
2020/06/06,Huelva,Huelva,60161,521870,73468,448402,521870,74516
2020/06/06,Huelva,Sevilla,671,1942389,319440,1622949,521870,74516
2020/06/06,Huelva,Badajoz,340,673559,87827,585732,521870,74516
2020/06/06,Huelva,Cádiz,617,1240155,212118,1028037,521870,74516
2020/06/06,Huesca,Huesca,22001,220461,29474,190987,220461,31829
2020/06/06,Huesca,Zaragoza,383,964724,178076,786648,220461,31829
2020/06/06,Huesca,Lleida,1111,434930,64474,370456,220461,31829
2020/06/06,Jaén,Jaén,57941,633564,77613,555951,633564,77170
2020/06/06,Jaén,Córdoba,836,782979,114835,668144,633564,77170
2020/06/06,Jaén,Granada,333,914678,149801,764877,633564,77170
2020/06/06,Jaén,Albacete,52,388167,42071,346096,633564,77170
2020/06/06,Las Palmas de Gran Canaria,Santa Cruz de Tenerife,39,1032983,164347,868636,1120406,185418
2020/06/06,Las Palmas de Gran Canaria,Las Palmas de Gran Canaria,174282,1120406,186079,934327,1120406,185418
2020/06/06,León,Lugo,32,329587,44080,285507,460001,69640
2020/06/06,León,Valladolid,63,519546,82854,436692,460001,69640
2020/06/06,León,Asturias,133,1022800,166469,856331,460001,69640
2020/06/06,León,Palencia,59,160866,22758,138108,460001,69640
2020/06/06,León,Ourense,228,307651,50810,256841,460001,69640
2020/06/06,León,León,54744,460001,69287,390714,460001,69640
2020/06/06,León,Zamora,112,172539,21896,150643,460001,69640
2020/06/06,Lleida,Girona,301,771044,112595,658449,434930,63900
2020/06/06,Lleida,Barcelona,390,5664579,1040299,4624280,434930,63900
2020/06/06,Lleida,Tarragona,55,804664,125335,679329,434930,63900
2020/06/06,Lleida,Lleida,46329,434930,64474,370456,434930,63900
2020/06/06,Lleida,Zaragoza,151,964724,178076,786648,434930,63900
2020/06/06,Lleida,Huesca,652,220461,29474,190987,434930,63900
2020/06/06,Lugo,Lugo,32652,329587,44080,285507,329587,45450
2020/06/06,Lugo,León,37,460001,69287,390714,329587,45450
2020/06/06,Lugo,Asturias,680,1022800,166469,856331,329587,45450
2020/06/06,Lugo,Coruña,459,1119596,179134,940462,329587,45450
2020/06/06,Lugo,Ourense,192,307651,50810,256841,329587,45450
2020/06/06,Madrid,Madrid,659664,6663394,1105081,5558313,6663394,1090510
2020/06/06,Madrid,Toledo,3412,694844,83441,611403,6663394,1090510
2020/06/06,Madrid,Guadalajara,2069,257762,39603,218159,6663394,1090510
2020/06/06,Madrid,Ávila,445,157640,17532,140108,6663394,1090510
2020/06/06,Madrid,Cuenca,94,196329,21913,174416,6663394,1090510
2020/06/06,Málaga,Málaga,231883,1661785,268966,1392819,1661785,269529
2020/06/06,Málaga,Córdoba,319,782979,114835,668144,1661785,269529
2020/06/06,Málaga,Sevilla,199,1942389,319440,1622949,1661785,269529
2020/06/06,Málaga,Cádiz,1093,1240155,212118,1028037,1661785,269529
2020/06/06,Málaga,Granada,287,914678,149801,764877,1661785,269529
2020/06/06,Melilla,Melilla,14142,86487,14326,72161,86487,14382
2020/06/06,Murcia,Albacete,317,388167,42071,346096,1493898,246068
2020/06/06,Murcia,Granada,33,914678,149801,764877,1493898,246068
2020/06/06,Murcia,Almería,1041,716820,100501,616319,1493898,246068
2020/06/06,Murcia,Murcia,205460,1493898,249271,1244627,1493898,246068
2020/06/06,Murcia,Alicante,2576,1858683,316268,1542415,1493898,246068
2020/06/06,Navarra,Araba,92,331549,62494,269055,654183,110170
2020/06/06,Navarra,Zaragoza,465,964724,178076,786648,654183,110170
2020/06/06,Navarra,Gipuzkoa,355,723576,110584,612992,654183,110170
2020/06/06,Navarra,Rioja,1499,316798,50276,266522,654183,110170
2020/06/06,Navarra,Navarra,84644,654183,110702,543481,654183,110170
2020/06/06,Ourense,Zamora,24,172539,21896,150643,307651,51708
2020/06/06,Ourense,Lugo,231,329587,44080,285507,307651,51708
2020/06/06,Ourense,Ourense,41755,307651,50810,256841,307651,51708
2020/06/06,Ourense,Pontevedra,227,942665,159164,783501,307651,51708
2020/06/06,Ourense,León,108,460001,69287,390714,307651,51708
2020/06/06,Palencia,Palencia,17328,160866,22758,138108,160866,23553
2020/06/06,Palencia,Cantabria,66,580795,92670,488125,160866,23553
2020/06/06,Palencia,Burgos,217,357072,48234,308838,160866,23553
2020/06/06,Palencia,Valladolid,173,519546,82854,436692,160866,23553
2020/06/06,Pontevedra,Coruña,4302,1119596,179134,940462,942665,159382
2020/06/06,Pontevedra,Pontevedra,126180,942665,159164,783501,942665,159382
2020/06/06,Pontevedra,Ourense,252,307651,50810,256841,942665,159382
2020/06/06,Pontevedra,Lugo,27,329587,44080,285507,942665,159382
2020/06/06,Rioja,Burgos,65,357072,48234,308838,316798,49671
2020/06/06,Rioja,Rioja,40996,316798,50276,266522,316798,49671
2020/06/06,Rioja,Araba,635,331549,62494,269055,316798,49671
2020/06/06,Rioja,Navarra,1626,654183,110702,543481,316798,49671
2020/06/06,Salamanca,Zamora,123,172539,21896,150643,330119,47179
2020/06/06,Salamanca,Salamanca,38953,330119,47497,282622,330119,47179
2020/06/06,Salamanca,Ávila,201,157640,17532,140108,330119,47179
2020/06/06,Santa Cruz de Tenerife,Santa Cruz de Tenerife,149973,1032983,164347,868636,1032983,164412
2020/06/06,Santa Cruz de Tenerife,Las Palmas de Gran Canaria,55,1120406,186079,934327,1032983,164412
2020/06/06,Segovia,Soria,23,88636,8690,79946,153129,21792
2020/06/06,Segovia,Ávila,76,157640,17532,140108,153129,21792
2020/06/06,Segovia,Valladolid,390,519546,82854,436692,153129,21792
2020/06/06,Segovia,Burgos,126,357072,48234,308838,153129,21792
2020/06/06,Segovia,Segovia,15057,153129,20221,132908,153129,21792
2020/06/06,Sevilla,Huelva,646,521870,73468,448402,1942389,317111
2020/06/06,Sevilla,Badajoz,80,673559,87827,585732,1942389,317111
2020/06/06,Sevilla,Sevilla,240832,1942389,319440,1622949,1942389,317111
2020/06/06,Sevilla,Cádiz,982,1240155,212118,1028037,1942389,317111
2020/06/06,Sevilla,Córdoba,1975,782979,114835,668144,1942389,317111
2020/06/06,Sevilla,Málaga,61,1661785,268966,1392819,1942389,317111
2020/06/06,Soria,Valladolid,40,519546,82854,436692,88636,9180
2020/06/06,Soria,Soria,7004,88636,8690,79946,88636,9180
2020/06/06,Soria,Segovia,17,153129,20221,132908,88636,9180
2020/06/06,Soria,Burgos,59,357072,48234,308838,88636,9180
2020/06/06,Soria,Zaragoza,48,964724,178076,786648,88636,9180
2020/06/06,Tarragona,Zaragoza,54,964724,178076,786648,804664,126759
2020/06/06,Tarragona,Teruel,65,134137,10714,123423,804664,126759
2020/06/06,Tarragona,Castellón,641,579962,83276,496686,804664,126759
2020/06/06,Tarragona,Tarragona,93710,804664,125335,679329,804664,126759
2020/06/06,Tarragona,Barcelona,1723,5664579,1040299,4624280,804664,126759
2020/06/06,Teruel,Castellón,22,579962,83276,496686,134137,12252
2020/06/06,Teruel,Valencia,40,2565124,497601,2067523,134137,12252
2020/06/06,Teruel,Teruel,6976,134137,10714,123423,134137,12252
2020/06/06,Teruel,Zaragoza,335,964724,178076,786648,134137,12252
2020/06/06,Teruel,Tarragona,83,804664,125335,679329,134137,12252
2020/06/06,Toledo,Ávila,404,157640,17532,140108,694844,87375
2020/06/06,Toledo,Ciudad Real,253,495761,47715,448046,694844,87375
2020/06/06,Toledo,Cáceres,211,394151,46300,347851,694844,87375
2020/06/06,Toledo,Cuenca,74,196329,21913,174416,694844,87375
2020/06/06,Toledo,Toledo,48814,694844,83441,611403,694844,87375
2020/06/06,Toledo,Madrid,2835,6663394,1105081,5558313,694844,87375
2020/06/06,Valencia,Teruel,102,134137,10714,123423,2565124,490818
2020/06/06,Valencia,Albacete,305,388167,42071,346096,2565124,490818
2020/06/06,Valencia,Cuenca,141,196329,21913,174416,2565124,490818
2020/06/06,Valencia,Castellón,751,579962,83276,496686,2565124,490818
2020/06/06,Valencia,Alicante,1221,1858683,316268,1542415,2565124,490818
2020/06/06,Valencia,Valencia,373948,2565124,497601,2067523,2565124,490818
2020/06/06,Valencia,Cáceres,21,394151,46300,347851,2565124,490818
2020/06/06,Valladolid,León,26,460001,69287,390714,519546,79890
2020/06/06,Valladolid,Ávila,32,157640,17532,140108,519546,79890
2020/06/06,Valladolid,Burgos,102,357072,48234,308838,519546,79890
2020/06/06,Valladolid,Soria,22,88636,8690,79946,519546,79890
2020/06/06,Valladolid,Segovia,322,153129,20221,132908,519546,79890
2020/06/06,Valladolid,Zamora,108,172539,21896,150643,519546,79890
2020/06/06,Valladolid,Valladolid,64447,519546,82854,436692,519546,79890
2020/06/06,Valladolid,Palencia,55,160866,22758,138108,519546,79890
2020/06/06,Zamora,Valladolid,98,519546,82854,436692,172539,22018
2020/06/06,Zamora,Zamora,16566,172539,21896,150643,172539,22018
2020/06/06,Zamora,Salamanca,18,330119,47497,282622,172539,22018
2020/06/06,Zamora,León,106,460001,69287,390714,172539,22018
2020/06/06,Zamora,Ourense,27,307651,50810,256841,172539,22018
2020/06/06,Zaragoza,Teruel,166,134137,10714,123423,964724,172781
2020/06/06,Zaragoza,Rioja,53,316798,50276,266522,964724,172781
2020/06/06,Zaragoza,Navarra,627,654183,110702,543481,964724,172781
2020/06/06,Zaragoza,Zaragoza,144479,964724,178076,786648,964724,172781
2020/06/06,Zaragoza,Lleida,142,434930,64474,370456,964724,172781
2020/06/06,Zaragoza,Soria,59,88636,8690,79946,964724,172781
2020/06/06,Zaragoza,Huesca,294,220461,29474,190987,964724,172781
2020/06/07,Albacete,Albacete,22166,388167,31179,356988,388167,31332
2020/06/07,Albacete,Alicante,214,1858683,272326,1586357,388167,31332
2020/06/07,Albacete,Murcia,243,1493898,204787,1289111,388167,31332
2020/06/07,Albacete,Valencia,238,2565124,402480,2162644,388167,31332
2020/06/07,Albacete,Cuenca,395,196329,16030,180299,388167,31332
2020/06/07,Albacete,Ciudad Real,377,495761,36143,459618,388167,31332
2020/06/07,Alicante,Murcia,2567,1493898,204787,1289111,1858683,272511
2020/06/07,Alicante,Albacete,245,388167,31179,356988,1858683,272511
2020/06/07,Alicante,Alicante,220699,1858683,272326,1586357,1858683,272511
2020/06/07,Alicante,Valencia,1243,2565124,402480,2162644,1858683,272511
2020/06/07,Almería,Murcia,836,1493898,204787,1289111,716820,77150
2020/06/07,Almería,Granada,337,914678,119059,795619,716820,77150
2020/06/07,Almería,Almería,64865,716820,79108,637712,716820,77150
2020/06/07,Araba,Gipuzkoa,94,723576,80648,642928,331549,42702
2020/06/07,Araba,Burgos,663,357072,29147,327925,331549,42702
2020/06/07,Araba,Bizkaia,620,1152934,169405,983529,331549,42702
2020/06/07,Araba,Araba,34774,331549,41122,290427,331549,42702
2020/06/07,Araba,Navarra,58,654183,77496,576687,331549,42702
2020/06/07,Araba,Rioja,766,316798,33922,282876,331549,42702
2020/06/07,Asturias,Cantabria,202,580795,73921,506874,1022800,120647
2020/06/07,Asturias,León,27,460001,51307,408694,1022800,120647
2020/06/07,Asturias,Lugo,731,329587,36963,292624,1022800,120647
2020/06/07,Asturias,Asturias,94781,1022800,120623,902177,1022800,120647
2020/06/07,Ávila,Ávila,9766,157640,13693,143947,157640,14374
2020/06/07,Ávila,Salamanca,255,330119,36389,293730,157640,14374
2020/06/07,Ávila,Toledo,310,694844,63203,631641,157640,14374
2020/06/07,Ávila,Madrid,175,6663394,890959,5772435,157640,14374
2020/06/07,Ávila,Segovia,81,153129,14519,138610,157640,14374
2020/06/07,Ávila,Valladolid,26,519546,59839,459707,157640,14374
2020/06/07,Ávila,Cáceres,107,394151,38161,355990,157640,14374
2020/06/07,Badajoz,Ciudad Real,45,495761,36143,459618,673559,70892
2020/06/07,Badajoz,Huelva,120,521870,58381,463489,673559,70892
2020/06/07,Badajoz,Córdoba,82,782979,94318,688661,673559,70892
2020/06/07,Badajoz,Sevilla,27,1942389,257924,1684465,673559,70892
2020/06/07,Badajoz,Badajoz,55240,673559,71837,601722,673559,70892
2020/06/07,Badajoz,Cáceres,916,394151,38161,355990,673559,70892
2020/06/07,Balears,Balears,130180,1149460,147766,1001694,1149460,147359
2020/06/07,Barcelona,Girona,2516,771044,84404,686640,5664579,756556
2020/06/07,Barcelona,Lleida,206,434930,48494,386436,5664579,756556
2020/06/07,Barcelona,Barcelona,495629,5664579,752336,4912243,5664579,756556
2020/06/07,Barcelona,Tarragona,1267,804664,96314,708350,5664579,756556
2020/06/07,Bizkaia,Araba,542,331549,41122,290427,1152934,167667
2020/06/07,Bizkaia,Bizkaia,134375,1152934,169405,983529,1152934,167667
2020/06/07,Bizkaia,Gipuzkoa,659,723576,80648,642928,1152934,167667
2020/06/07,Bizkaia,Cantabria,596,580795,73921,506874,1152934,167667
2020/06/07,Burgos,Bizkaia,32,1152934,169405,983529,357072,30085
2020/06/07,Burgos,Palencia,152,160866,16325,144541,357072,30085
2020/06/07,Burgos,Cantabria,19,580795,73921,506874,357072,30085
2020/06/07,Burgos,Rioja,26,316798,33922,282876,357072,30085
2020/06/07,Burgos,Huelva,18,521870,58381,463489,357072,30085
2020/06/07,Burgos,Araba,1122,331549,41122,290427,357072,30085
2020/06/07,Burgos,Burgos,22411,357072,29147,327925,357072,30085
2020/06/07,Burgos,Valladolid,104,519546,59839,459707,357072,30085
2020/06/07,Cáceres,Ávila,115,157640,13693,143947,394151,37399
2020/06/07,Cáceres,Cáceres,27014,394151,38161,355990,394151,37399
2020/06/07,Cáceres,Badajoz,801,673559,71837,601722,394151,37399
2020/06/07,Cáceres,Toledo,145,694844,63203,631641,394151,37399
2020/06/07,Cádiz,Ceuta,32,84777,8501,76276,1240155,175790
2020/06/07,Cádiz,Huelva,578,521870,58381,463489,1240155,175790
2020/06/07,Cádiz,Cádiz,151281,1240155,175344,1064811,1240155,175790
2020/06/07,Cádiz,Sevilla,771,1942389,257924,1684465,1240155,175790
2020/06/07,Cádiz,Málaga,748,1661785,217145,1444640,1240155,175790
2020/06/07,Cantabria,Cantabria,57020,580795,73921,506874,580795,73268
2020/06/07,Cantabria,Asturias,128,1022800,120623,902177,580795,73268
2020/06/07,Cantabria,Palencia,34,160866,16325,144541,580795,73268
2020/06/07,Cantabria,Bizkaia,733,1152934,169405,983529,580795,73268
2020/06/07,Castellón,Teruel,46,134137,7589,126548,579962,68362
2020/06/07,Castellón,Castellón,52977,579962,66575,513387,579962,68362
2020/06/07,Castellón,Valencia,875,2565124,402480,2162644,579962,68362
2020/06/07,Castellón,Tarragona,665,804664,96314,708350,579962,68362
2020/06/07,Ceuta,Ceuta,8001,84777,8501,76276,84777,8432
2020/06/07,Ceuta,Cádiz,42,1240155,175344,1064811,84777,8432
2020/06/07,Ciudad Real,Córdoba,329,782979,94318,688661,495761,35777
2020/06/07,Ciudad Real,Toledo,152,694844,63203,631641,495761,35777
2020/06/07,Ciudad Real,Albacete,382,388167,31179,356988,495761,35777
2020/06/07,Ciudad Real,Badajoz,57,673559,71837,601722,495761,35777
2020/06/07,Ciudad Real,Ciudad Real,24326,495761,36143,459618,495761,35777
2020/06/07,Ciudad Real,Cuenca,44,196329,16030,180299,495761,35777
2020/06/07,Córdoba,Ciudad Real,164,495761,36143,459618,782979,94096
2020/06/07,Córdoba,Badajoz,203,673559,71837,601722,782979,94096
2020/06/07,Córdoba,Jaén,521,633564,61918,571646,782979,94096
2020/06/07,Córdoba,Sevilla,1502,1942389,257924,1684465,782979,94096
2020/06/07,Córdoba,Málaga,126,1661785,217145,1444640,782979,94096
2020/06/07,Córdoba,Granada,131,914678,119059,795619,782979,94096
2020/06/07,Córdoba,Córdoba,71679,782979,94318,688661,782979,94096
2020/06/07,Coruña,Lugo,419,329587,36963,292624,1119596,152996
2020/06/07,Coruña,Pontevedra,4132,942665,133822,808843,1119596,152996
2020/06/07,Coruña,Coruña,114724,1119596,151696,967900,1119596,152996
2020/06/07,Cuenca,Albacete,630,388167,31179,356988,196329,16368
2020/06/07,Cuenca,Ciudad Real,43,495761,36143,459618,196329,16368
2020/06/07,Cuenca,Valencia,121,2565124,402480,2162644,196329,16368
2020/06/07,Cuenca,Cuenca,10176,196329,16030,180299,196329,16368
2020/06/07,Cuenca,Guadalajara,58,257762,28030,229732,196329,16368
2020/06/07,Cuenca,Madrid,27,6663394,890959,5772435,196329,16368
2020/06/07,Cuenca,Toledo,34,694844,63203,631641,196329,16368
2020/06/07,Gipuzkoa,Bizkaia,490,1152934,169405,983529,723576,81102
2020/06/07,Gipuzkoa,Gipuzkoa,63198,723576,80648,642928,723576,81102
2020/06/07,Gipuzkoa,Araba,49,331549,41122,290427,723576,81102
2020/06/07,Gipuzkoa,Navarra,176,654183,77496,576687,723576,81102
2020/06/07,Girona,Lleida,158,434930,48494,386436,771044,84021
2020/06/07,Girona,Barcelona,1978,5664579,752336,4912243,771044,84021
2020/06/07,Girona,Girona,56834,771044,84404,686640,771044,84021
2020/06/07,Granada,Murcia,37,1493898,204787,1289111,914678,118718
2020/06/07,Granada,Málaga,189,1661785,217145,1444640,914678,118718
2020/06/07,Granada,Granada,88526,914678,119059,795619,914678,118718
2020/06/07,Granada,Jaén,359,633564,61918,571646,914678,118718
2020/06/07,Granada,Córdoba,236,782979,94318,688661,914678,118718
2020/06/07,Granada,Almería,884,716820,79108,637712,914678,118718
2020/06/07,Guadalajara,Guadalajara,19353,257762,28030,229732,257762,28628
2020/06/07,Guadalajara,Madrid,1212,6663394,890959,5772435,257762,28628
2020/06/07,Guadalajara,Cuenca,70,196329,16030,180299,257762,28628
2020/06/07,Guadalajara,Zaragoza,27,964724,136231,828493,257762,28628
2020/06/07,Huelva,Huelva,46916,521870,58381,463489,521870,58788
2020/06/07,Huelva,Badajoz,283,673559,71837,601722,521870,58788
2020/06/07,Huelva,Sevilla,392,1942389,257924,1684465,521870,58788
2020/06/07,Huelva,Cádiz,594,1240155,175344,1064811,521870,58788
2020/06/07,Huesca,Lleida,833,434930,48494,386436,220461,24148
2020/06/07,Huesca,Huesca,16842,220461,22708,197753,220461,24148
2020/06/07,Huesca,Zaragoza,245,964724,136231,828493,220461,24148
2020/06/07,Jaén,Albacete,16,388167,31179,356988,633564,61676
2020/06/07,Jaén,Jaén,45812,633564,61918,571646,633564,61676
2020/06/07,Jaén,Córdoba,627,782979,94318,688661,633564,61676
2020/06/07,Jaén,Granada,279,914678,119059,795619,633564,61676
2020/06/07,Las Palmas de Gran Canaria,Santa Cruz de Tenerife,49,1032983,141367,891616,1120406,159536
2020/06/07,Las Palmas de Gran Canaria,Las Palmas de Gran Canaria,149290,1120406,160169,960237,1120406,159536
2020/06/07,León,Palencia,27,160866,16325,144541,460001,51165
2020/06/07,León,Lugo,37,329587,36963,292624,460001,51165
2020/06/07,León,Valladolid,60,519546,59839,459707,460001,51165
2020/06/07,León,Asturias,38,1022800,120623,902177,460001,51165
2020/06/07,León,León,39381,460001,51307,408694,460001,51165
2020/06/07,León,Zamora,46,172539,15826,156713,460001,51165
2020/06/07,León,Ourense,75,307651,40920,266731,460001,51165
2020/06/07,Lleida,Lleida,33900,434930,48494,386436,434930,47050
2020/06/07,Lleida,Tarragona,16,804664,96314,708350,434930,47050
2020/06/07,Lleida,Barcelona,141,5664579,752336,4912243,434930,47050
2020/06/07,Lleida,Girona,193,771044,84404,686640,434930,47050
2020/06/07,Lleida,Zaragoza,175,964724,136231,828493,434930,47050
2020/06/07,Lleida,Huesca,375,220461,22708,197753,434930,47050
2020/06/07,Lugo,Asturias,536,1022800,120623,902177,329587,37812
2020/06/07,Lugo,Ourense,102,307651,40920,266731,329587,37812
2020/06/07,Lugo,Coruña,445,1119596,151696,967900,329587,37812
2020/06/07,Lugo,León,78,460001,51307,408694,329587,37812
2020/06/07,Lugo,Lugo,27040,329587,36963,292624,329587,37812
2020/06/07,Madrid,Ávila,274,157640,13693,143947,6663394,892387
2020/06/07,Madrid,Guadalajara,1455,257762,28030,229732,6663394,892387
2020/06/07,Madrid,Toledo,2425,694844,63203,631641,6663394,892387
2020/06/07,Madrid,Cuenca,58,196329,16030,180299,6663394,892387
2020/06/07,Madrid,Madrid,539744,6663394,890959,5772435,6663394,892387
2020/06/07,Málaga,Sevilla,87,1942389,257924,1684465,1661785,216419
2020/06/07,Málaga,Granada,234,914678,119059,795619,1661785,216419
2020/06/07,Málaga,Cádiz,837,1240155,175344,1064811,1661785,216419
2020/06/07,Málaga,Córdoba,170,782979,94318,688661,1661785,216419
2020/06/07,Málaga,Málaga,182531,1661785,217145,1444640,1661785,216419
2020/06/07,Melilla,Melilla,11902,86487,12036,74451,86487,12035
2020/06/07,Murcia,Murcia,169839,1493898,204787,1289111,1493898,202605
2020/06/07,Murcia,Albacete,162,388167,31179,356988,1493898,202605
2020/06/07,Murcia,Granada,34,914678,119059,795619,1493898,202605
2020/06/07,Murcia,Alicante,2149,1858683,272326,1586357,1493898,202605
2020/06/07,Murcia,Almería,857,716820,79108,637712,1493898,202605
2020/06/07,Navarra,Zaragoza,318,964724,136231,828493,654183,78083
2020/06/07,Navarra,Araba,51,331549,41122,290427,654183,78083
2020/06/07,Navarra,Gipuzkoa,251,723576,80648,642928,654183,78083
2020/06/07,Navarra,Rioja,837,316798,33922,282876,654183,78083
2020/06/07,Navarra,Navarra,58092,654183,77496,576687,654183,78083
2020/06/07,Ourense,Ourense,32958,307651,40920,266731,307651,41228
2020/06/07,Ourense,León,128,460001,51307,408694,307651,41228
2020/06/07,Ourense,Pontevedra,150,942665,133822,808843,307651,41228
2020/06/07,Ourense,Lugo,232,329587,36963,292624,307651,41228
2020/06/07,Palencia,Palencia,11974,160866,16325,144541,160866,16512
2020/06/07,Palencia,Valladolid,20,519546,59839,459707,160866,16512
2020/06/07,Palencia,Burgos,147,357072,29147,327925,160866,16512
2020/06/07,Palencia,Cantabria,39,580795,73921,506874,160866,16512
2020/06/07,Pontevedra,Pontevedra,104075,942665,133822,808843,942665,133986
2020/06/07,Pontevedra,Coruña,3696,1119596,151696,967900,942665,133986
2020/06/07,Pontevedra,Ourense,236,307651,40920,266731,942665,133986
2020/06/07,Rioja,Burgos,19,357072,29147,327925,316798,33354
2020/06/07,Rioja,Araba,356,331549,41122,290427,316798,33354
2020/06/07,Rioja,Navarra,806,654183,77496,576687,316798,33354
2020/06/07,Rioja,Rioja,27429,316798,33922,282876,316798,33354
2020/06/07,Salamanca,Salamanca,28874,330119,36389,293730,330119,36270
2020/06/07,Salamanca,Valladolid,28,519546,59839,459707,330119,36270
2020/06/07,Salamanca,Ávila,153,157640,13693,143947,330119,36270
2020/06/07,Santa Cruz de Tenerife,Santa Cruz de Tenerife,128231,1032983,141367,891616,1032983,141188
2020/06/07,Santa Cruz de Tenerife,Las Palmas de Gran Canaria,120,1120406,160169,960237,1032983,141188
2020/06/07,Segovia,Segovia,10313,153129,14519,138610,153129,14924
2020/06/07,Segovia,Burgos,64,357072,29147,327925,153129,14924
2020/06/07,Segovia,Valladolid,204,519546,59839,459707,153129,14924
2020/06/07,Segovia,Ávila,53,157640,13693,143947,153129,14924
2020/06/07,Sevilla,Málaga,32,1661785,217145,1444640,1942389,256914
2020/06/07,Sevilla,Sevilla,188907,1942389,257924,1684465,1942389,256914
2020/06/07,Sevilla,Huelva,422,521870,58381,463489,1942389,256914
2020/06/07,Sevilla,Badajoz,65,673559,71837,601722,1942389,256914
2020/06/07,Sevilla,Córdoba,1797,782979,94318,688661,1942389,256914
2020/06/07,Sevilla,Cádiz,744,1240155,175344,1064811,1942389,256914
2020/06/07,Soria,Soria,4276,88636,5406,83230,88636,5713
2020/06/07,Soria,Valladolid,32,519546,59839,459707,88636,5713
2020/06/07,Soria,Burgos,24,357072,29147,327925,88636,5713
2020/06/07,Soria,Zaragoza,27,964724,136231,828493,88636,5713
2020/06/07,Tarragona,Castellón,484,579962,66575,513387,804664,95638
2020/06/07,Tarragona,Teruel,49,134137,7589,126548,804664,95638
2020/06/07,Tarragona,Lleida,32,434930,48494,386436,804664,95638
2020/06/07,Tarragona,Tarragona,71727,804664,96314,708350,804664,95638
2020/06/07,Tarragona,Barcelona,1203,5664579,752336,4912243,804664,95638
2020/06/07,Teruel,Teruel,4889,134137,7589,126548,134137,8360
2020/06/07,Teruel,Valencia,26,2565124,402480,2162644,134137,8360
2020/06/07,Teruel,Zaragoza,173,964724,136231,828493,134137,8360
2020/06/07,Teruel,Tarragona,73,804664,96314,708350,134137,8360
2020/06/07,Toledo,Madrid,2062,6663394,890959,5772435,694844,64301
2020/06/07,Toledo,Murcia,16,1493898,204787,1289111,694844,64301
2020/06/07,Toledo,Ávila,295,157640,13693,143947,694844,64301
2020/06/07,Toledo,Ciudad Real,162,495761,36143,459618,694844,64301
2020/06/07,Toledo,Cáceres,218,394151,38161,355990,694844,64301
2020/06/07,Toledo,Toledo,36395,694844,63203,631641,694844,64301
2020/06/07,Valencia,Alicante,998,1858683,272326,1586357,2565124,400417
2020/06/07,Valencia,Cuenca,120,196329,16030,180299,2565124,400417
2020/06/07,Valencia,Castellón,601,579962,66575,513387,2565124,400417
2020/06/07,Valencia,Valencia,294656,2565124,402480,2162644,2565124,400417
2020/06/07,Valencia,Albacete,199,388167,31179,356988,2565124,400417
2020/06/07,Valencia,Teruel,26,134137,7589,126548,2565124,400417
2020/06/07,Valladolid,León,27,460001,51307,408694,519546,58980
2020/06/07,Valladolid,Valladolid,44379,519546,59839,459707,519546,58980
2020/06/07,Valladolid,Soria,20,88636,5406,83230,519546,58980
2020/06/07,Valladolid,Segovia,426,153129,14519,138610,519546,58980
2020/06/07,Valladolid,Burgos,95,357072,29147,327925,519546,58980
2020/06/07,Valladolid,Ávila,36,157640,13693,143947,519546,58980
2020/06/07,Valladolid,Zamora,96,172539,15826,156713,519546,58980
2020/06/07,Valladolid,Salamanca,41,330119,36389,293730,519546,58980
2020/06/07,Valladolid,Palencia,60,160866,16325,144541,519546,58980
2020/06/07,Zamora,Salamanca,37,330119,36389,293730,172539,15982
2020/06/07,Zamora,Zamora,11853,172539,15826,156713,172539,15982
2020/06/07,Zamora,Ourense,33,307651,40920,266731,172539,15982
2020/06/07,Zamora,Valladolid,123,519546,59839,459707,172539,15982
2020/06/07,Zaragoza,Huesca,200,220461,22708,197753,964724,134123
2020/06/07,Zaragoza,Lleida,128,434930,48494,386436,964724,134123
2020/06/07,Zaragoza,Soria,51,88636,5406,83230,964724,134123
2020/06/07,Zaragoza,Teruel,112,134137,7589,126548,964724,134123
2020/06/07,Zaragoza,Zaragoza,106190,964724,136231,828493,964724,134123
2020/06/07,Zaragoza,Navarra,340,654183,77496,576687,964724,134123
2020/06/08,Albacete,Cuenca,802,196329,24090,172239,388167,43418
2020/06/08,Albacete,Murcia,521,1493898,236923,1256975,388167,43418
2020/06/08,Albacete,Alicante,225,1858683,303151,1555532,388167,43418
2020/06/08,Albacete,Valencia,298,2565124,465744,2099380,388167,43418
2020/06/08,Albacete,Albacete,27330,388167,43205,344962,388167,43418
2020/06/08,Albacete,Jaén,49,633564,83723,549841,388167,43418
2020/06/08,Albacete,Ciudad Real,646,495761,56998,438763,388167,43418
2020/06/08,Alicante,Murcia,2895,1493898,236923,1256975,1858683,306580
2020/06/08,Alicante,Valencia,1284,2565124,465744,2099380,1858683,306580
2020/06/08,Alicante,Albacete,382,388167,43205,344962,1858683,306580
2020/06/08,Alicante,Alicante,235888,1858683,303151,1555532,1858683,306580
2020/06/08,Almería,Alicante,17,1858683,303151,1555532,716820,106888
2020/06/08,Almería,Almería,84615,716820,104642,612178,716820,106888
2020/06/08,Almería,Granada,749,914678,153142,761536,716820,106888
2020/06/08,Almería,Murcia,1585,1493898,236923,1256975,716820,106888
2020/06/08,Araba,Gipuzkoa,524,723576,124324,599252,331549,73734
2020/06/08,Araba,Rioja,1902,316798,52945,263853,331549,73734
2020/06/08,Araba,Navarra,169,654183,116269,537914,331549,73734
2020/06/08,Araba,Araba,52655,331549,64698,266851,331549,73734
2020/06/08,Araba,Bizkaia,1863,1152934,250217,902717,331549,73734
2020/06/08,Araba,Burgos,2028,357072,51657,305415,331549,73734
2020/06/08,Asturias,Lugo,1080,329587,53561,276026,1022800,177757
2020/06/08,Asturias,Cantabria,236,580795,103528,477267,1022800,177757
2020/06/08,Asturias,Asturias,145356,1022800,179613,843187,1022800,177757
2020/06/08,Asturias,León,54,460001,78673,381328,1022800,177757
2020/06/08,Ávila,Segovia,86,153129,23050,130079,157640,22014
2020/06/08,Ávila,Madrid,89,6663394,1238786,5424608,157640,22014
2020/06/08,Ávila,Ávila,13821,157640,21395,136245,157640,22014
2020/06/08,Ávila,Valladolid,77,519546,98238,421308,157640,22014
2020/06/08,Ávila,Salamanca,357,330119,55483,274636,157640,22014
2020/06/08,Ávila,Toledo,312,694844,104087,590757,157640,22014
2020/06/08,Ávila,Cáceres,127,394151,53716,340435,157640,22014
2020/06/08,Badajoz,Ciudad Real,43,495761,56998,438763,673559,101213
2020/06/08,Badajoz,Huelva,233,521870,83654,438216,673559,101213
2020/06/08,Badajoz,Badajoz,76383,673559,103009,570550,673559,101213
2020/06/08,Badajoz,Córdoba,85,782979,131539,651440,673559,101213
2020/06/08,Badajoz,Sevilla,73,1942389,368060,1574329,673559,101213
2020/06/08,Badajoz,Cáceres,1416,394151,53716,340435,673559,101213
2020/06/08,Balears,Balears,161869,1149460,181845,967615,1149460,183485
2020/06/08,Balears,Valencia,28,2565124,465744,2099380,1149460,183485
2020/06/08,Barcelona,Girona,2775,771044,107419,663625,5664579,1059562
2020/06/08,Barcelona,Lleida,224,434930,69567,365363,5664579,1059562
2020/06/08,Barcelona,Tarragona,2399,804664,123251,681413,5664579,1059562
2020/06/08,Barcelona,Barcelona,660726,5664579,1058786,4605793,5664579,1059562
2020/06/08,Bizkaia,Araba,1156,331549,64698,266851,1152934,246836
2020/06/08,Bizkaia,Bizkaia,192977,1152934,250217,902717,1152934,246836
2020/06/08,Bizkaia,Burgos,100,357072,51657,305415,1152934,246836
2020/06/08,Bizkaia,Cantabria,3372,580795,103528,477267,1152934,246836
2020/06/08,Bizkaia,Gipuzkoa,1361,723576,124324,599252,1152934,246836
2020/06/08,Burgos,Burgos,38475,357072,51657,305415,357072,53771
2020/06/08,Burgos,Bizkaia,133,1152934,250217,902717,357072,53771
2020/06/08,Burgos,Segovia,88,153129,23050,130079,357072,53771
2020/06/08,Burgos,Cantabria,30,580795,103528,477267,357072,53771
2020/06/08,Burgos,Araba,915,331549,64698,266851,357072,53771
2020/06/08,Burgos,Palencia,180,160866,25606,135260,357072,53771
2020/06/08,Burgos,Rioja,94,316798,52945,263853,357072,53771
2020/06/08,Burgos,Valladolid,120,519546,98238,421308,357072,53771
2020/06/08,Burgos,Soria,54,88636,9183,79453,357072,53771
2020/06/08,Cáceres,Toledo,206,694844,104087,590757,394151,53597
2020/06/08,Cáceres,Ávila,150,157640,21395,136245,394151,53597
2020/06/08,Cáceres,Badajoz,1302,673559,103009,570550,394151,53597
2020/06/08,Cáceres,Cáceres,36845,394151,53716,340435,394151,53597
2020/06/08,Cádiz,Cádiz,175021,1240155,212094,1028061,1240155,217595
2020/06/08,Cádiz,Melilla,953,86487,14649,71838,1240155,217595
2020/06/08,Cádiz,Sevilla,1336,1942389,368060,1574329,1240155,217595
2020/06/08,Cádiz,Ceuta,84,84777,11673,73104,1240155,217595
2020/06/08,Cádiz,Málaga,1687,1661785,287232,1374553,1240155,217595
2020/06/08,Cádiz,Huelva,650,521870,83654,438216,1240155,217595
2020/06/08,Cantabria,Cantabria,75142,580795,103528,477267,580795,96351
2020/06/08,Cantabria,Asturias,202,1022800,179613,843187,580795,96351
2020/06/08,Cantabria,Palencia,86,160866,25606,135260,580795,96351
2020/06/08,Cantabria,Bizkaia,593,1152934,250217,902717,580795,96351
2020/06/08,Castellón,Valencia,684,2565124,465744,2099380,579962,88755
2020/06/08,Castellón,Teruel,42,134137,12457,121680,579962,88755
2020/06/08,Castellón,Tarragona,909,804664,123251,681413,579962,88755
2020/06/08,Castellón,Castellón,62668,579962,83240,496722,579962,88755
2020/06/08,Ceuta,Cádiz,116,1240155,212094,1028061,84777,11749
2020/06/08,Ceuta,Ceuta,11098,84777,11673,73104,84777,11749
2020/06/08,Ciudad Real,Albacete,411,388167,43205,344962,495761,52100
2020/06/08,Ciudad Real,Toledo,480,694844,104087,590757,495761,52100
2020/06/08,Ciudad Real,Cuenca,89,196329,24090,172239,495761,52100
2020/06/08,Ciudad Real,Ciudad Real,35079,495761,56998,438763,495761,52100
2020/06/08,Ciudad Real,Córdoba,360,782979,131539,651440,495761,52100
2020/06/08,Ciudad Real,Badajoz,79,673559,103009,570550,495761,52100
2020/06/08,Córdoba,Málaga,333,1661785,287232,1374553,782979,126954
2020/06/08,Córdoba,Badajoz,151,673559,103009,570550,782979,126954
2020/06/08,Córdoba,Ciudad Real,306,495761,56998,438763,782979,126954
2020/06/08,Córdoba,Córdoba,92267,782979,131539,651440,782979,126954
2020/06/08,Córdoba,Sevilla,2196,1942389,368060,1574329,782979,126954
2020/06/08,Córdoba,Jaén,864,633564,83723,549841,782979,126954
2020/06/08,Córdoba,Granada,106,914678,153142,761536,782979,126954
2020/06/08,Coruña,Lugo,745,329587,53561,276026,1119596,221210
2020/06/08,Coruña,Pontevedra,6294,942665,193929,748736,1119596,221210
2020/06/08,Coruña,Coruña,169812,1119596,222152,897444,1119596,221210
2020/06/08,Cuenca,Guadalajara,24,257762,43592,214170,196329,25234
2020/06/08,Cuenca,Cuenca,12882,196329,24090,172239,196329,25234
2020/06/08,Cuenca,Valencia,91,2565124,465744,2099380,196329,25234
2020/06/08,Cuenca,Albacete,746,388167,43205,344962,196329,25234
2020/06/08,Cuenca,Ciudad Real,64,495761,56998,438763,196329,25234
2020/06/08,Cuenca,Madrid,60,6663394,1238786,5424608,196329,25234
2020/06/08,Cuenca,Toledo,146,694844,104087,590757,196329,25234
2020/06/08,Gipuzkoa,Gipuzkoa,95768,723576,124324,599252,723576,130196
2020/06/08,Gipuzkoa,Navarra,620,654183,116269,537914,723576,130196
2020/06/08,Gipuzkoa,Araba,363,331549,64698,266851,723576,130196
2020/06/08,Gipuzkoa,Bizkaia,2005,1152934,250217,902717,723576,130196
2020/06/08,Girona,Lleida,214,434930,69567,365363,771044,112035
2020/06/08,Girona,Girona,71345,771044,107419,663625,771044,112035
2020/06/08,Girona,Barcelona,2800,5664579,1058786,4605793,771044,112035
2020/06/08,Granada,Almería,702,716820,104642,612178,914678,150521
2020/06/08,Granada,Murcia,49,1493898,236923,1256975,914678,150521
2020/06/08,Granada,Málaga,306,1661785,287232,1374553,914678,150521
2020/06/08,Granada,Córdoba,225,782979,131539,651440,914678,150521
2020/06/08,Granada,Granada,109539,914678,153142,761536,914678,150521
2020/06/08,Granada,Jaén,474,633564,83723,549841,914678,150521
2020/06/08,Guadalajara,Guadalajara,25450,257762,43592,214170,257762,46683
2020/06/08,Guadalajara,Teruel,25,134137,12457,121680,257762,46683
2020/06/08,Guadalajara,Madrid,2536,6663394,1238786,5424608,257762,46683
2020/06/08,Guadalajara,Cuenca,91,196329,24090,172239,257762,46683
2020/06/08,Huelva,Córdoba,16,782979,131539,651440,521870,88880
2020/06/08,Huelva,Huelva,64640,521870,83654,438216,521870,88880
2020/06/08,Huelva,Badajoz,342,673559,103009,570550,521870,88880
2020/06/08,Huelva,Sevilla,1374,1942389,368060,1574329,521870,88880
2020/06/08,Huelva,Cádiz,602,1240155,212094,1028061,521870,88880
2020/06/08,Huesca,Huesca,22055,220461,32588,187873,220461,37304
2020/06/08,Huesca,Lleida,1166,434930,69567,365363,220461,37304
2020/06/08,Huesca,Zaragoza,394,964724,185214,779510,220461,37304
2020/06/08,Jaén,Córdoba,971,782979,131539,651440,633564,79689
2020/06/08,Jaén,Granada,353,914678,153142,761536,633564,79689
2020/06/08,Jaén,Jaén,55658,633564,83723,549841,633564,79689
2020/06/08,Las Palmas de Gran Canaria,Las Palmas de Gran Canaria,189323,1120406,201486,918920,1120406,200902
2020/06/08,Las Palmas de Gran Canaria,Santa Cruz de Tenerife,16,1032983,180363,852620,1120406,200902
2020/06/08,León,Asturias,43,1022800,179613,843187,460001,78297
2020/06/08,León,Ourense,397,307651,60693,246958,460001,78297
2020/06/08,León,León,59645,460001,78673,381328,460001,78297
2020/06/08,León,Palencia,77,160866,25606,135260,460001,78297
2020/06/08,León,Lugo,74,329587,53561,276026,460001,78297
2020/06/08,León,Zamora,174,172539,25257,147282,460001,78297
2020/06/08,Lleida,Huesca,867,220461,32588,187873,434930,68722
2020/06/08,Lleida,Zaragoza,187,964724,185214,779510,434930,68722
2020/06/08,Lleida,Tarragona,26,804664,123251,681413,434930,68722
2020/06/08,Lleida,Barcelona,220,5664579,1058786,4605793,434930,68722
2020/06/08,Lleida,Lleida,46041,434930,69567,365363,434930,68722
2020/06/08,Lleida,Girona,199,771044,107419,663625,434930,68722
2020/06/08,Lugo,Coruña,800,1119596,222152,897444,329587,54726
2020/06/08,Lugo,Ourense,224,307651,60693,246958,329587,54726
2020/06/08,Lugo,Asturias,812,1022800,179613,843187,329587,54726
2020/06/08,Lugo,León,46,460001,78673,381328,329587,54726
2020/06/08,Lugo,Lugo,36821,329587,53561,276026,329587,54726
2020/06/08,Lugo,Pontevedra,30,942665,193929,748736,329587,54726
2020/06/08,Madrid,Segovia,84,153129,23050,130079,6663394,1243682
2020/06/08,Madrid,Ávila,312,157640,21395,136245,6663394,1243682
2020/06/08,Madrid,Cuenca,107,196329,24090,172239,6663394,1243682
2020/06/08,Madrid,Madrid,754702,6663394,1238786,5424608,6663394,1243682
2020/06/08,Madrid,Alicante,17,1858683,303151,1555532,6663394,1243682
2020/06/08,Madrid,Guadalajara,3409,257762,43592,214170,6663394,1243682
2020/06/08,Madrid,Toledo,4578,694844,104087,590757,6663394,1243682
2020/06/08,Málaga,Cádiz,1659,1240155,212094,1028061,1661785,295880
2020/06/08,Málaga,Málaga,238427,1661785,287232,1374553,1661785,295880
2020/06/08,Málaga,Córdoba,372,782979,131539,651440,1661785,295880
2020/06/08,Málaga,Sevilla,432,1942389,368060,1574329,1661785,295880
2020/06/08,Málaga,Granada,369,914678,153142,761536,1661785,295880
2020/06/08,Melilla,Melilla,13620,86487,14649,71838,86487,13897
2020/06/08,Murcia,Alicante,2752,1858683,303151,1555532,1493898,230928
2020/06/08,Murcia,Granada,30,914678,153142,761536,1493898,230928
2020/06/08,Murcia,Albacete,397,388167,43205,344962,1493898,230928
2020/06/08,Murcia,Almería,1248,716820,104642,612178,1493898,230928
2020/06/08,Murcia,Murcia,184298,1493898,236923,1256975,1493898,230928
2020/06/08,Navarra,Araba,106,331549,64698,266851,654183,118722
2020/06/08,Navarra,Navarra,85824,654183,116269,537914,654183,118722
2020/06/08,Navarra,Gipuzkoa,397,723576,124324,599252,654183,118722
2020/06/08,Navarra,Zaragoza,682,964724,185214,779510,654183,118722
2020/06/08,Navarra,Alicante,17,1858683,303151,1555532,654183,118722
2020/06/08,Navarra,Rioja,2404,316798,52945,263853,654183,118722
2020/06/08,Ourense,Pontevedra,189,942665,193929,748736,307651,61372
2020/06/08,Ourense,Lugo,320,329587,53561,276026,307651,61372
2020/06/08,Ourense,Zamora,45,172539,25257,147282,307651,61372
2020/06/08,Ourense,Ourense,45776,307651,60693,246958,307651,61372
2020/06/08,Ourense,León,330,460001,78673,381328,307651,61372
2020/06/08,Palencia,Burgos,254,357072,51657,305415,160866,27386
2020/06/08,Palencia,Palencia,18306,160866,25606,135260,160866,27386
2020/06/08,Palencia,Valladolid,336,519546,98238,421308,160866,27386
2020/06/08,Palencia,Cantabria,186,580795,103528,477267,160866,27386
2020/06/08,Palencia,León,53,460001,78673,381328,160866,27386
2020/06/08,Pontevedra,Ourense,312,307651,60693,246958,942665,190471
2020/06/08,Pontevedra,Pontevedra,151015,942665,193929,748736,942665,190471
2020/06/08,Pontevedra,Lugo,56,329587,53561,276026,942665,190471
2020/06/08,Pontevedra,Coruña,4716,1119596,222152,897444,942665,190471
2020/06/08,Rioja,Rioja,39135,316798,52945,263853,316798,50607
2020/06/08,Rioja,Burgos,136,357072,51657,305415,316798,50607
2020/06/08,Rioja,Araba,768,331549,64698,266851,316798,50607
2020/06/08,Rioja,Navarra,1691,654183,116269,537914,316798,50607
2020/06/08,Salamanca,Ávila,303,157640,21395,136245,330119,55318
2020/06/08,Salamanca,Zamora,55,172539,25257,147282,330119,55318
2020/06/08,Salamanca,Salamanca,43582,330119,55483,274636,330119,55318
2020/06/08,Santa Cruz de Tenerife,Santa Cruz de Tenerife,165340,1032983,180363,852620,1032983,180025
2020/06/08,Santa Cruz de Tenerife,Las Palmas de Gran Canaria,70,1120406,201486,918920,1032983,180025
2020/06/08,Segovia,Burgos,138,357072,51657,305415,153129,25581
2020/06/08,Segovia,Segovia,15080,153129,23050,130079,153129,25581
2020/06/08,Segovia,Valladolid,370,519546,98238,421308,153129,25581
2020/06/08,Segovia,Madrid,20,6663394,1238786,5424608,153129,25581
2020/06/08,Segovia,Ávila,85,157640,21395,136245,153129,25581
2020/06/08,Sevilla,Málaga,109,1661785,287232,1374553,1942389,357147
2020/06/08,Sevilla,Cádiz,1075,1240155,212094,1028061,1942389,357147
2020/06/08,Sevilla,Huelva,721,521870,83654,438216,1942389,357147
2020/06/08,Sevilla,Córdoba,2299,782979,131539,651440,1942389,357147
2020/06/08,Sevilla,Badajoz,71,673559,103009,570550,1942389,357147
2020/06/08,Sevilla,Sevilla,261342,1942389,368060,1574329,1942389,357147
2020/06/08,Soria,Segovia,23,153129,23050,130079,88636,11433
2020/06/08,Soria,Valladolid,21,519546,98238,421308,88636,11433
2020/06/08,Soria,Zaragoza,127,964724,185214,779510,88636,11433
2020/06/08,Soria,Burgos,80,357072,51657,305415,88636,11433
2020/06/08,Soria,Soria,7135,88636,9183,79453,88636,11433
2020/06/08,Tarragona,Tarragona,82109,804664,123251,681413,804664,122368
2020/06/08,Tarragona,Lleida,50,434930,69567,365363,804664,122368
2020/06/08,Tarragona,Castellón,672,579962,83240,496722,804664,122368
2020/06/08,Tarragona,Barcelona,1330,5664579,1058786,4605793,804664,122368
2020/06/08,Tarragona,Teruel,69,134137,12457,121680,804664,122368
2020/06/08,Teruel,Guadalajara,18,257762,43592,214170,134137,14920
2020/06/08,Teruel,Zaragoza,360,964724,185214,779510,134137,14920
2020/06/08,Teruel,Tarragona,72,804664,123251,681413,134137,14920
2020/06/08,Teruel,Teruel,7188,134137,12457,121680,134137,14920
2020/06/08,Teruel,Castellón,80,579962,83240,496722,134137,14920
2020/06/08,Toledo,Ciudad Real,398,495761,56998,438763,694844,98678
2020/06/08,Toledo,Cuenca,127,196329,24090,172239,694844,98678
2020/06/08,Toledo,Toledo,49638,694844,104087,590757,694844,98678
2020/06/08,Toledo,Madrid,3922,6663394,1238786,5424608,694844,98678
2020/06/08,Toledo,Ávila,291,157640,21395,136245,694844,98678
2020/06/08,Toledo,Cáceres,231,394151,53716,340435,694844,98678
2020/06/08,Valencia,Albacete,336,388167,43205,344962,2565124,453485
2020/06/08,Valencia,Castellón,578,579962,83240,496722,2565124,453485
2020/06/08,Valencia,Teruel,19,134137,12457,121680,2565124,453485
2020/06/08,Valencia,Valencia,320714,2565124,465744,2099380,2565124,453485
2020/06/08,Valencia,Alicante,1235,1858683,303151,1555532,2565124,453485
2020/06/08,Valencia,Cuenca,157,196329,24090,172239,2565124,453485
2020/06/08,Valladolid,Soria,35,88636,9183,79453,519546,96232
2020/06/08,Valladolid,Zamora,250,172539,25257,147282,519546,96232
2020/06/08,Valladolid,Valladolid,73213,519546,98238,421308,519546,96232
2020/06/08,Valladolid,Segovia,222,153129,23050,130079,519546,96232
2020/06/08,Valladolid,Ávila,57,157640,21395,136245,519546,96232
2020/06/08,Valladolid,Burgos,73,357072,51657,305415,519546,96232
2020/06/08,Valladolid,Palencia,101,160866,25606,135260,519546,96232
2020/06/08,Valladolid,León,35,460001,78673,381328,519546,96232
2020/06/08,Zamora,Salamanca,34,330119,55483,274636,172539,25938
2020/06/08,Zamora,Zamora,17661,172539,25257,147282,172539,25938
2020/06/08,Zamora,Ourense,41,307651,60693,246958,172539,25938
2020/06/08,Zamora,Valladolid,98,519546,98238,421308,172539,25938
2020/06/08,Zamora,León,68,460001,78673,381328,172539,25938
2020/06/08,Zaragoza,Tarragona,28,804664,123251,681413,964724,179543
2020/06/08,Zaragoza,Huesca,446,220461,32588,187873,964724,179543
2020/06/08,Zaragoza,Soria,78,88636,9183,79453,964724,179543
2020/06/08,Zaragoza,Lleida,77,434930,69567,365363,964724,179543
2020/06/08,Zaragoza,Navarra,487,654183,116269,537914,964724,179543
2020/06/08,Zaragoza,Zaragoza,141080,964724,185214,779510,964724,179543
2020/06/08,Zaragoza,Teruel,372,134137,12457,121680,964724,179543
2020/06/09,Albacete,Ciudad Real,658,495761,53831,441930,388167,42241
2020/06/09,Albacete,Jaén,39,633564,78876,554688,388167,42241
2020/06/09,Albacete,Cuenca,852,196329,22950,173379,388167,42241
2020/06/09,Albacete,Valencia,407,2565124,489350,2075774,388167,42241
2020/06/09,Albacete,Alicante,231,1858683,305318,1553365,388167,42241
2020/06/09,Albacete,Albacete,26554,388167,40979,347188,388167,42241
2020/06/09,Albacete,Murcia,725,1493898,189096,1304802,388167,42241
2020/06/09,Alicante,Albacete,465,388167,40979,347188,1858683,313547
2020/06/09,Alicante,Murcia,3357,1493898,189096,1304802,1858683,313547
2020/06/09,Alicante,Alicante,244225,1858683,305318,1553365,1858683,313547
2020/06/09,Alicante,Valencia,1572,2565124,489350,2075774,1858683,313547
2020/06/09,Almería,Murcia,1434,1493898,189096,1304802,716820,101417
2020/06/09,Almería,Almería,80758,716820,99624,617196,716820,101417
2020/06/09,Almería,Granada,612,914678,148235,766443,716820,101417
2020/06/09,Araba,Bizkaia,2295,1152934,253047,899887,331549,73709
2020/06/09,Araba,Gipuzkoa,559,723576,120812,602764,331549,73709
2020/06/09,Araba,Araba,52995,331549,65010,266539,331549,73709
2020/06/09,Araba,Burgos,2162,357072,51574,305498,331549,73709
2020/06/09,Araba,Navarra,235,654183,109618,544565,331549,73709
2020/06/09,Araba,Rioja,1758,316798,45255,271543,331549,73709
2020/06/09,Asturias,Lugo,1075,329587,52319,277268,1022800,174979
2020/06/09,Asturias,León,39,460001,76874,383127,1022800,174979
2020/06/09,Asturias,Asturias,143599,1022800,175882,846918,1022800,174979
2020/06/09,Asturias,Cantabria,214,580795,100860,479935,1022800,174979
2020/06/09,Ávila,Toledo,370,694844,100402,594442,157640,21358
2020/06/09,Ávila,Cáceres,143,394151,47238,346913,157640,21358
2020/06/09,Ávila,Ávila,13183,157640,20241,137399,157640,21358
2020/06/09,Ávila,Valladolid,58,519546,98677,420869,157640,21358
2020/06/09,Ávila,Salamanca,384,330119,53086,277033,157640,21358
2020/06/09,Ávila,Madrid,159,6663394,1214855,5448539,157640,21358
2020/06/09,Ávila,Segovia,80,153129,22169,130960,157640,21358
2020/06/09,Badajoz,Huelva,229,521870,81393,440477,673559,92828
2020/06/09,Badajoz,Ciudad Real,63,495761,53831,441930,673559,92828
2020/06/09,Badajoz,Cáceres,1199,394151,47238,346913,673559,92828
2020/06/09,Badajoz,Sevilla,87,1942389,359877,1582512,673559,92828
2020/06/09,Badajoz,Badajoz,69830,673559,94044,579515,673559,92828
2020/06/09,Badajoz,Córdoba,89,782979,127568,655411,673559,92828
2020/06/09,Balears,Balears,163601,1149460,183154,966306,1149460,183819
2020/06/09,Barcelona,Tarragona,2059,804664,124312,680352,5664579,1102137
2020/06/09,Barcelona,Girona,3073,771044,108000,663044,5664579,1102137
2020/06/09,Barcelona,Lleida,221,434930,69438,365492,5664579,1102137
2020/06/09,Barcelona,Barcelona,714549,5664579,1104274,4560305,5664579,1102137
2020/06/09,Bizkaia,Araba,1152,331549,65010,266539,1152934,246903
2020/06/09,Bizkaia,Gipuzkoa,1224,723576,120812,602764,1152934,246903
2020/06/09,Bizkaia,Cantabria,2922,580795,100860,479935,1152934,246903
2020/06/09,Bizkaia,Bizkaia,197794,1152934,253047,899887,1152934,246903
2020/06/09,Bizkaia,Burgos,72,357072,51574,305498,1152934,246903
2020/06/09,Burgos,Bizkaia,178,1152934,253047,899887,357072,52688
2020/06/09,Burgos,Rioja,37,316798,45255,271543,357072,52688
2020/06/09,Burgos,Araba,1122,331549,65010,266539,357072,52688
2020/06/09,Burgos,Segovia,67,153129,22169,130960,357072,52688
2020/06/09,Burgos,Cantabria,28,580795,100860,479935,357072,52688
2020/06/09,Burgos,Palencia,259,160866,25525,135341,357072,52688
2020/06/09,Burgos,Valladolid,87,519546,98677,420869,357072,52688
2020/06/09,Burgos,Soria,53,88636,9273,79363,357072,52688
2020/06/09,Burgos,Burgos,38206,357072,51574,305498,357072,52688
2020/06/09,Cáceres,Toledo,240,694844,100402,594442,394151,47380
2020/06/09,Cáceres,Ávila,149,157640,20241,137399,394151,47380
2020/06/09,Cáceres,Valencia,27,2565124,489350,2075774,394151,47380
2020/06/09,Cáceres,Cáceres,31638,394151,47238,346913,394151,47380
2020/06/09,Cáceres,Badajoz,1166,673559,94044,579515,394151,47380
2020/06/09,Cádiz,Sevilla,1294,1942389,359877,1582512,1240155,215568
2020/06/09,Cádiz,Ceuta,111,84777,12233,72544,1240155,215568
2020/06/09,Cádiz,Cádiz,173422,1240155,209535,1030620,1240155,215568
2020/06/09,Cádiz,Huelva,742,521870,81393,440477,1240155,215568
2020/06/09,Cádiz,Córdoba,17,782979,127568,655411,1240155,215568
2020/06/09,Cádiz,Málaga,1702,1661785,284419,1377366,1240155,215568
2020/06/09,Cantabria,Bizkaia,912,1152934,253047,899887,580795,96359
2020/06/09,Cantabria,Asturias,191,1022800,175882,846918,580795,96359
2020/06/09,Cantabria,Cantabria,74036,580795,100860,479935,580795,96359
2020/06/09,Cantabria,Palencia,71,160866,25525,135341,580795,96359
2020/06/09,Castellón,Tarragona,1047,804664,124312,680352,579962,92118
2020/06/09,Castellón,Teruel,42,134137,11559,122578,579962,92118
2020/06/09,Castellón,Valencia,780,2565124,489350,2075774,579962,92118
2020/06/09,Castellón,Castellón,66334,579962,86872,493090,579962,92118
2020/06/09,Ceuta,Ceuta,11642,84777,12233,72544,84777,12160
2020/06/09,Ciudad Real,Córdoba,365,782979,127568,655411,495761,49590
2020/06/09,Ciudad Real,Cuenca,55,196329,22950,173379,495761,49590
2020/06/09,Ciudad Real,Ciudad Real,33092,495761,53831,441930,495761,49590
2020/06/09,Ciudad Real,Albacete,440,388167,40979,347188,495761,49590
2020/06/09,Ciudad Real,Badajoz,58,673559,94044,579515,495761,49590
2020/06/09,Ciudad Real,Toledo,383,694844,100402,594442,495761,49590
2020/06/09,Córdoba,Ciudad Real,324,495761,53831,441930,782979,124674
2020/06/09,Córdoba,Sevilla,1992,1942389,359877,1582512,782979,124674
2020/06/09,Córdoba,Granada,118,914678,148235,766443,782979,124674
2020/06/09,Córdoba,Jaén,874,633564,78876,554688,782979,124674
2020/06/09,Córdoba,Badajoz,55,673559,94044,579515,782979,124674
2020/06/09,Córdoba,Málaga,390,1661785,284419,1377366,782979,124674
2020/06/09,Córdoba,Córdoba,91502,782979,127568,655411,782979,124674
2020/06/09,Coruña,Coruña,164955,1119596,216049,903547,1119596,218693
2020/06/09,Coruña,Lugo,858,329587,52319,277268,1119596,218693
2020/06/09,Coruña,Pontevedra,6712,942665,191406,751259,1119596,218693
2020/06/09,Cuenca,Albacete,897,388167,40979,347188,196329,24310
2020/06/09,Cuenca,Cuenca,12127,196329,22950,173379,196329,24310
2020/06/09,Cuenca,Toledo,190,694844,100402,594442,196329,24310
2020/06/09,Cuenca,Guadalajara,46,257762,41502,216260,196329,24310
2020/06/09,Cuenca,Madrid,68,6663394,1214855,5448539,196329,24310
2020/06/09,Cuenca,Valencia,55,2565124,489350,2075774,196329,24310
2020/06/09,Cuenca,Ciudad Real,195,495761,53831,441930,196329,24310
2020/06/09,Gipuzkoa,Araba,373,331549,65010,266539,723576,126720
2020/06/09,Gipuzkoa,Gipuzkoa,93529,723576,120812,602764,723576,126720
2020/06/09,Gipuzkoa,Bizkaia,2339,1152934,253047,899887,723576,126720
2020/06/09,Gipuzkoa,Navarra,405,654183,109618,544565,723576,126720
2020/06/09,Girona,Lleida,200,434930,69438,365492,771044,115458
2020/06/09,Girona,Tarragona,36,804664,124312,680352,771044,115458
2020/06/09,Girona,Girona,73327,771044,108000,663044,771044,115458
2020/06/09,Girona,Barcelona,2910,5664579,1104274,4560305,771044,115458
2020/06/09,Granada,Almería,591,716820,99624,617196,914678,146189
2020/06/09,Granada,Málaga,327,1661785,284419,1377366,914678,146189
2020/06/09,Granada,Córdoba,202,782979,127568,655411,914678,146189
2020/06/09,Granada,Granada,106655,914678,148235,766443,914678,146189
2020/06/09,Granada,Jaén,418,633564,78876,554688,914678,146189
2020/06/09,Granada,Murcia,72,1493898,189096,1304802,914678,146189
2020/06/09,Guadalajara,Madrid,2746,6663394,1214855,5448539,257762,44621
2020/06/09,Guadalajara,Cuenca,56,196329,22950,173379,257762,44621
2020/06/09,Guadalajara,Guadalajara,24210,257762,41502,216260,257762,44621
2020/06/09,Huelva,Cádiz,576,1240155,209535,1030620,521870,86993
2020/06/09,Huelva,Huelva,62080,521870,81393,440477,521870,86993
2020/06/09,Huelva,Sevilla,1611,1942389,359877,1582512,521870,86993
2020/06/09,Huelva,Badajoz,324,673559,94044,579515,521870,86993
2020/06/09,Huesca,Zaragoza,423,964724,183133,781591,220461,35852
2020/06/09,Huesca,Huesca,20485,220461,31361,189100,220461,35852
2020/06/09,Huesca,Lleida,1227,434930,69438,365492,220461,35852
2020/06/09,Jaén,Albacete,43,388167,40979,347188,633564,77681
2020/06/09,Jaén,Granada,288,914678,148235,766443,633564,77681
2020/06/09,Jaén,Jaén,53602,633564,78876,554688,633564,77681
2020/06/09,Jaén,Córdoba,933,782979,127568,655411,633564,77681
2020/06/09,Las Palmas de Gran Canaria,Santa Cruz de Tenerife,16,1032983,180438,852545,1120406,199391
2020/06/09,Las Palmas de Gran Canaria,Las Palmas de Gran Canaria,187472,1120406,200156,920250,1120406,199391
2020/06/09,León,Asturias,87,1022800,175882,846918,460001,76573
2020/06/09,León,Ourense,390,307651,58881,248770,460001,76573
2020/06/09,León,Valladolid,50,519546,98677,420869,460001,76573
2020/06/09,León,Zamora,155,172539,24931,147608,460001,76573
2020/06/09,León,Lugo,33,329587,52319,277268,460001,76573
2020/06/09,León,León,58648,460001,76874,383127,460001,76573
2020/06/09,León,Palencia,35,160866,25525,135341,460001,76573
2020/06/09,Lleida,Lleida,45572,434930,69438,365492,434930,67487
2020/06/09,Lleida,Huesca,736,220461,31361,189100,434930,67487
2020/06/09,Lleida,Barcelona,288,5664579,1104274,4560305,434930,67487
2020/06/09,Lleida,Girona,210,771044,108000,663044,434930,67487
2020/06/09,Lleida,Zaragoza,179,964724,183133,781591,434930,67487
2020/06/09,Lugo,Pontevedra,38,942665,191406,751259,329587,54776
2020/06/09,Lugo,Coruña,798,1119596,216049,903547,329587,54776
2020/06/09,Lugo,Asturias,832,1022800,175882,846918,329587,54776
2020/06/09,Lugo,Lugo,36430,329587,52319,277268,329587,54776
2020/06/09,Lugo,Ourense,322,307651,58881,248770,329587,54776
2020/06/09,Lugo,León,51,460001,76874,383127,329587,54776
2020/06/09,Madrid,Guadalajara,3024,257762,41502,216260,6663394,1214638
2020/06/09,Madrid,Cuenca,87,196329,22950,173379,6663394,1214638
2020/06/09,Madrid,Ciudad Real,26,495761,53831,441930,6663394,1214638
2020/06/09,Madrid,Segovia,56,153129,22169,130960,6663394,1214638
2020/06/09,Madrid,Madrid,735229,6663394,1214855,5448539,6663394,1214638
2020/06/09,Madrid,Toledo,4648,694844,100402,594442,6663394,1214638
2020/06/09,Madrid,Ávila,277,157640,20241,137399,6663394,1214638
2020/06/09,Málaga,Málaga,236902,1661785,284419,1377366,1661785,289157
2020/06/09,Málaga,Cádiz,1724,1240155,209535,1030620,1661785,289157
2020/06/09,Málaga,Almería,16,716820,99624,617196,1661785,289157
2020/06/09,Málaga,Sevilla,429,1942389,359877,1582512,1661785,289157
2020/06/09,Málaga,Granada,346,914678,148235,766443,1661785,289157
2020/06/09,Málaga,Córdoba,306,782979,127568,655411,1661785,289157
2020/06/09,Melilla,Melilla,14663,86487,14833,71654,86487,14921
2020/06/09,Murcia,Albacete,313,388167,40979,347188,1493898,178924
2020/06/09,Murcia,Almería,923,716820,99624,617196,1493898,178924
2020/06/09,Murcia,Alicante,2241,1858683,305318,1553365,1493898,178924
2020/06/09,Murcia,Murcia,140714,1493898,189096,1304802,1493898,178924
2020/06/09,Murcia,Granada,82,914678,148235,766443,1493898,178924
2020/06/09,Navarra,Zaragoza,672,964724,183133,781591,654183,111902
2020/06/09,Navarra,Araba,61,331549,65010,266539,654183,111902
2020/06/09,Navarra,Navarra,80108,654183,109618,544565,654183,111902
2020/06/09,Navarra,Rioja,2210,316798,45255,271543,654183,111902
2020/06/09,Navarra,Gipuzkoa,397,723576,120812,602764,654183,111902
2020/06/09,Ourense,Lugo,249,329587,52319,277268,307651,58943
2020/06/09,Ourense,León,327,460001,76874,383127,307651,58943
2020/06/09,Ourense,Ourense,44076,307651,58881,248770,307651,58943
2020/06/09,Ourense,Zamora,43,172539,24931,147608,307651,58943
2020/06/09,Ourense,Pontevedra,308,942665,191406,751259,307651,58943
2020/06/09,Palencia,Cantabria,194,580795,100860,479935,160866,27085
2020/06/09,Palencia,Valladolid,426,519546,98677,420869,160866,27085
2020/06/09,Palencia,Burgos,268,357072,51574,305498,160866,27085
2020/06/09,Palencia,Palencia,18533,160866,25525,135341,160866,27085
2020/06/09,Pontevedra,Coruña,5238,1119596,216049,903547,942665,190198
2020/06/09,Pontevedra,Ourense,316,307651,58881,248770,942665,190198
2020/06/09,Pontevedra,Lugo,32,329587,52319,277268,942665,190198
2020/06/09,Pontevedra,Pontevedra,149216,942665,191406,751259,942665,190198
2020/06/09,Rioja,Navarra,1329,654183,109618,544565,316798,41744
2020/06/09,Rioja,Rioja,32386,316798,45255,271543,316798,41744
2020/06/09,Rioja,Burgos,70,357072,51574,305498,316798,41744
2020/06/09,Rioja,Bizkaia,17,1152934,253047,899887,316798,41744
2020/06/09,Rioja,Araba,543,331549,65010,266539,316798,41744
2020/06/09,Salamanca,Zamora,40,172539,24931,147608,330119,52386
2020/06/09,Salamanca,Ávila,208,157640,20241,137399,330119,52386
2020/06/09,Salamanca,Valladolid,24,519546,98677,420869,330119,52386
2020/06/09,Salamanca,Salamanca,41984,330119,53086,277033,330119,52386
2020/06/09,Santa Cruz de Tenerife,Santa Cruz de Tenerife,166232,1032983,180438,852545,1032983,179886
2020/06/09,Santa Cruz de Tenerife,Las Palmas de Gran Canaria,105,1120406,200156,920250,1032983,179886
2020/06/09,Segovia,Ávila,107,157640,20241,137399,153129,24285
2020/06/09,Segovia,Valladolid,414,519546,98677,420869,153129,24285
2020/06/09,Segovia,Segovia,14590,153129,22169,130960,153129,24285
2020/06/09,Segovia,Madrid,40,6663394,1214855,5448539,153129,24285
2020/06/09,Segovia,Burgos,122,357072,51574,305498,153129,24285
2020/06/09,Sevilla,Córdoba,2290,782979,127568,655411,1942389,349318
2020/06/09,Sevilla,Huelva,560,521870,81393,440477,1942389,349318
2020/06/09,Sevilla,Sevilla,257485,1942389,359877,1582512,1942389,349318
2020/06/09,Sevilla,Cádiz,979,1240155,209535,1030620,1942389,349318
2020/06/09,Sevilla,Badajoz,85,673559,94044,579515,1942389,349318
2020/06/09,Sevilla,Málaga,130,1661785,284419,1377366,1942389,349318
2020/06/09,Soria,Valladolid,41,519546,98677,420869,88636,10276
2020/06/09,Soria,Zaragoza,103,964724,183133,781591,88636,10276
2020/06/09,Soria,Burgos,25,357072,51574,305498,88636,10276
2020/06/09,Soria,Soria,6875,88636,9273,79363,88636,10276
2020/06/09,Tarragona,Teruel,68,134137,11559,122578,804664,124508
2020/06/09,Tarragona,Tarragona,83691,804664,124312,680352,804664,124508
2020/06/09,Tarragona,Barcelona,1317,5664579,1104274,4560305,804664,124508
2020/06/09,Tarragona,Castellón,993,579962,86872,493090,804664,124508
2020/06/09,Teruel,Teruel,6398,134137,11559,122578,134137,14082
2020/06/09,Teruel,Guadalajara,20,257762,41502,216260,134137,14082
2020/06/09,Teruel,Castellón,66,579962,86872,493090,134137,14082
2020/06/09,Teruel,Tarragona,54,804664,124312,680352,134137,14082
2020/06/09,Teruel,Zaragoza,299,964724,183133,781591,134137,14082
2020/06/09,Teruel,Valencia,25,2565124,489350,2075774,134137,14082
2020/06/09,Toledo,Ávila,179,157640,20241,137399,694844,96096
2020/06/09,Toledo,Cuenca,90,196329,22950,173379,694844,96096
2020/06/09,Toledo,Madrid,3890,6663394,1214855,5448539,694844,96096
2020/06/09,Toledo,Cáceres,208,394151,47238,346913,694844,96096
2020/06/09,Toledo,Ciudad Real,397,495761,53831,441930,694844,96096
2020/06/09,Toledo,Toledo,49394,694844,100402,594442,694844,96096
2020/06/09,Valencia,Albacete,353,388167,40979,347188,2565124,477157
2020/06/09,Valencia,Cáceres,19,394151,47238,346913,2565124,477157
2020/06/09,Valencia,Alicante,1328,1858683,305318,1553365,2565124,477157
2020/06/09,Valencia,Valencia,352040,2565124,489350,2075774,2565124,477157
2020/06/09,Valencia,Castellón,670,579962,86872,493090,2565124,477157
2020/06/09,Valencia,Cuenca,131,196329,22950,173379,2565124,477157
2020/06/09,Valladolid,Zamora,303,172539,24931,147608,519546,95064
2020/06/09,Valladolid,Ávila,26,157640,20241,137399,519546,95064
2020/06/09,Valladolid,Soria,28,88636,9273,79363,519546,95064
2020/06/09,Valladolid,Segovia,349,153129,22169,130960,519546,95064
2020/06/09,Valladolid,Valladolid,73751,519546,98677,420869,519546,95064
2020/06/09,Valladolid,Burgos,128,357072,51574,305498,519546,95064
2020/06/09,Valladolid,León,70,460001,76874,383127,519546,95064
2020/06/09,Valladolid,Palencia,109,160866,25525,135341,519546,95064
2020/06/09,Zamora,Salamanca,83,330119,53086,277033,172539,25046
2020/06/09,Zamora,Valladolid,186,519546,98677,420869,172539,25046
2020/06/09,Zamora,Ourense,107,307651,58881,248770,172539,25046
2020/06/09,Zamora,León,69,460001,76874,383127,172539,25046
2020/06/09,Zamora,Zamora,17287,172539,24931,147608,172539,25046
2020/06/09,Zaragoza,Huesca,430,220461,31361,189100,964724,176491
2020/06/09,Zaragoza,Tarragona,35,804664,124312,680352,964724,176491
2020/06/09,Zaragoza,Navarra,485,654183,109618,544565,964724,176491
2020/06/09,Zaragoza,Teruel,293,134137,11559,122578,964724,176491
2020/06/09,Zaragoza,Zaragoza,140568,964724,183133,781591,964724,176491
2020/06/09,Zaragoza,Lleida,131,434930,69438,365492,964724,176491
2020/06/09,Zaragoza,Soria,70,88636,9273,79363,964724,176491
2020/06/10,Albacete,Albacete,35534,388167,52338,335829,388167,53140
2020/06/10,Albacete,Ciudad Real,682,495761,60560,435201,388167,53140
2020/06/10,Albacete,Alicante,302,1858683,360049,1498634,388167,53140
2020/06/10,Albacete,Jaén,72,633564,91540,542024,388167,53140
2020/06/10,Albacete,Murcia,673,1493898,278520,1215378,388167,53140
2020/06/10,Albacete,Cuenca,943,196329,26715,169614,388167,53140
2020/06/10,Albacete,Valencia,410,2565124,569092,1996032,388167,53140
2020/06/10,Alicante,Alicante,287712,1858683,360049,1498634,1858683,365438
2020/06/10,Alicante,Valencia,1797,2565124,569092,1996032,1858683,365438
2020/06/10,Alicante,Murcia,3551,1493898,278520,1215378,1858683,365438
2020/06/10,Alicante,Albacete,418,388167,52338,335829,1858683,365438
2020/06/10,Almería,Murcia,2073,1493898,278520,1215378,716820,122490
2020/06/10,Almería,Almería,99234,716820,120156,596664,716820,122490
2020/06/10,Almería,Granada,673,914678,175800,738878,716820,122490
2020/06/10,Araba,Bizkaia,2852,1152934,284106,868828,331549,83942
2020/06/10,Araba,Gipuzkoa,621,723576,142037,581539,331549,83942
2020/06/10,Araba,Araba,60586,331549,74649,256900,331549,83942
2020/06/10,Araba,Burgos,2554,357072,59255,297817,331549,83942
2020/06/10,Araba,Rioja,2199,316798,58596,258202,331549,83942
2020/06/10,Araba,Navarra,237,654183,132362,521821,331549,83942
2020/06/10,Asturias,León,43,460001,84986,375015,1022800,203631
2020/06/10,Asturias,Asturias,171056,1022800,204900,817900,1022800,203631
2020/06/10,Asturias,Lugo,1144,329587,56724,272863,1022800,203631
2020/06/10,Asturias,Cantabria,281,580795,118564,462231,1022800,203631
2020/06/10,Ávila,Valladolid,76,519546,110100,409446,157640,24062
2020/06/10,Ávila,Cáceres,176,394151,57116,337035,157640,24062
2020/06/10,Ávila,Ávila,14831,157640,22526,135114,157640,24062
2020/06/10,Ávila,Toledo,322,694844,114244,580600,157640,24062
2020/06/10,Ávila,Madrid,202,6663394,1420125,5243269,157640,24062
2020/06/10,Ávila,Segovia,128,153129,25083,128046,157640,24062
2020/06/10,Ávila,Salamanca,436,330119,60100,270019,157640,24062
2020/06/10,Badajoz,Ciudad Real,55,495761,60560,435201,673559,107551
2020/06/10,Badajoz,Huelva,232,521870,91349,430521,673559,107551
2020/06/10,Badajoz,Cáceres,1460,394151,57116,337035,673559,107551
2020/06/10,Badajoz,Sevilla,68,1942389,406973,1535416,673559,107551
2020/06/10,Badajoz,Córdoba,122,782979,140685,642294,673559,107551
2020/06/10,Badajoz,Badajoz,81533,673559,108103,565456,673559,107551
2020/06/10,Balears,Barcelona,18,5664579,1247110,4417469,1149460,210271
2020/06/10,Balears,Balears,189557,1149460,209827,939633,1149460,210271
2020/06/10,Balears,Valencia,89,2565124,569092,1996032,1149460,210271
2020/06/10,Barcelona,Lleida,286,434930,78976,355954,5664579,1241310
2020/06/10,Barcelona,Tarragona,2610,804664,143313,661351,5664579,1241310
2020/06/10,Barcelona,Valencia,19,2565124,569092,1996032,5664579,1241310
2020/06/10,Barcelona,Girona,3674,771044,125988,645056,5664579,1241310
2020/06/10,Barcelona,Barcelona,822894,5664579,1247110,4417469,5664579,1241310
2020/06/10,Bizkaia,Araba,1608,331549,74649,256900,1152934,277654
2020/06/10,Bizkaia,Burgos,130,357072,59255,297817,1152934,277654
2020/06/10,Bizkaia,Gipuzkoa,1490,723576,142037,581539,1152934,277654
2020/06/10,Bizkaia,Cantabria,3820,580795,118564,462231,1152934,277654
2020/06/10,Bizkaia,Bizkaia,223249,1152934,284106,868828,1152934,277654
2020/06/10,Burgos,Segovia,103,153129,25083,128046,357072,60299
2020/06/10,Burgos,Valladolid,104,519546,110100,409446,357072,60299
2020/06/10,Burgos,Soria,57,88636,10625,78011,357072,60299
2020/06/10,Burgos,Araba,1194,331549,74649,256900,357072,60299
2020/06/10,Burgos,Cantabria,33,580795,118564,462231,357072,60299
2020/06/10,Burgos,Palencia,283,160866,28800,132066,357072,60299
2020/06/10,Burgos,Burgos,44846,357072,59255,297817,357072,60299
2020/06/10,Burgos,Rioja,97,316798,58596,258202,357072,60299
2020/06/10,Burgos,Bizkaia,187,1152934,284106,868828,357072,60299
2020/06/10,Cáceres,Toledo,310,694844,114244,580600,394151,57865
2020/06/10,Cáceres,Badajoz,1327,673559,108103,565456,394151,57865
2020/06/10,Cáceres,Cáceres,40340,394151,57116,337035,394151,57865
2020/06/10,Cáceres,Ávila,154,157640,22526,135114,394151,57865
2020/06/10,Cádiz,Málaga,1989,1661785,325874,1335911,1240155,249335
2020/06/10,Cádiz,Sevilla,1816,1942389,406973,1535416,1240155,249335
2020/06/10,Cádiz,Ceuta,22,84777,13563,71214,1240155,249335
2020/06/10,Cádiz,Córdoba,16,782979,140685,642294,1240155,249335
2020/06/10,Cádiz,Huelva,801,521870,91349,430521,1240155,249335
2020/06/10,Cádiz,Cádiz,201456,1240155,239176,1000979,1240155,249335
2020/06/10,Cantabria,Asturias,212,1022800,204900,817900,580795,112611
2020/06/10,Cantabria,Palencia,71,160866,28800,132066,580795,112611
2020/06/10,Cantabria,Cantabria,89356,580795,118564,462231,580795,112611
2020/06/10,Cantabria,Bizkaia,955,1152934,284106,868828,580795,112611
2020/06/10,Castellón,Tarragona,983,804664,143313,661351,579962,107268
2020/06/10,Castellón,Castellón,78929,579962,101319,478643,579962,107268
2020/06/10,Castellón,Teruel,107,134137,13991,120146,579962,107268
2020/06/10,Castellón,Valencia,1028,2565124,569092,1996032,579962,107268
2020/06/10,Ceuta,Cádiz,60,1240155,239176,1000979,84777,13647
2020/06/10,Ceuta,Ceuta,12995,84777,13563,71214,84777,13647
2020/06/10,Ciudad Real,Toledo,656,694844,114244,580600,495761,57508
2020/06/10,Ciudad Real,Albacete,550,388167,52338,335829,495761,57508
2020/06/10,Ciudad Real,Córdoba,379,782979,140685,642294,495761,57508
2020/06/10,Ciudad Real,Cuenca,121,196329,26715,169614,495761,57508
2020/06/10,Ciudad Real,Badajoz,71,673559,108103,565456,495761,57508
2020/06/10,Ciudad Real,Ciudad Real,38580,495761,60560,435201,495761,57508
2020/06/10,Córdoba,Málaga,318,1661785,325874,1335911,782979,137261
2020/06/10,Córdoba,Granada,200,914678,175800,738878,782979,137261
2020/06/10,Córdoba,Jaén,954,633564,91540,542024,782979,137261
2020/06/10,Córdoba,Sevilla,2193,1942389,406973,1535416,782979,137261
2020/06/10,Córdoba,Córdoba,100864,782979,140685,642294,782979,137261
2020/06/10,Córdoba,Badajoz,124,673559,108103,565456,782979,137261
2020/06/10,Córdoba,Ciudad Real,336,495761,60560,435201,782979,137261
2020/06/10,Coruña,Pontevedra,6890,942665,210457,732208,1119596,238325
2020/06/10,Coruña,Coruña,183027,1119596,238281,881315,1119596,238325
2020/06/10,Coruña,Lugo,873,329587,56724,272863,1119596,238325
2020/06/10,Cuenca,Toledo,251,694844,114244,580600,196329,28679
2020/06/10,Cuenca,Madrid,123,6663394,1420125,5243269,196329,28679
2020/06/10,Cuenca,Albacete,1038,388167,52338,335829,196329,28679
2020/06/10,Cuenca,Guadalajara,92,257762,48743,209019,196329,28679
2020/06/10,Cuenca,Ciudad Real,116,495761,60560,435201,196329,28679
2020/06/10,Cuenca,Cuenca,14999,196329,26715,169614,196329,28679
2020/06/10,Cuenca,Valencia,116,2565124,569092,1996032,196329,28679
2020/06/10,Gipuzkoa,Gipuzkoa,110964,723576,142037,581539,723576,147920
2020/06/10,Gipuzkoa,Araba,519,331549,74649,256900,723576,147920
2020/06/10,Gipuzkoa,Navarra,717,654183,132362,521821,723576,147920
2020/06/10,Gipuzkoa,Bizkaia,2673,1152934,284106,868828,723576,147920
2020/06/10,Girona,Lleida,259,434930,78976,355954,771044,133736
2020/06/10,Girona,Girona,86993,771044,125988,645056,771044,133736
2020/06/10,Girona,Barcelona,3509,5664579,1247110,4417469,771044,133736
2020/06/10,Granada,Almería,699,716820,120156,596664,914678,173681
2020/06/10,Granada,Jaén,576,633564,91540,542024,914678,173681
2020/06/10,Granada,Murcia,177,1493898,278520,1215378,914678,173681
2020/06/10,Granada,Málaga,386,1661785,325874,1335911,914678,173681
2020/06/10,Granada,Granada,131207,914678,175800,738878,914678,173681
2020/06/10,Granada,Córdoba,288,782979,140685,642294,914678,173681
2020/06/10,Guadalajara,Teruel,24,134137,13991,120146,257762,52000
2020/06/10,Guadalajara,Guadalajara,28855,257762,48743,209019,257762,52000
2020/06/10,Guadalajara,Madrid,3514,6663394,1420125,5243269,257762,52000
2020/06/10,Guadalajara,Cuenca,49,196329,26715,169614,257762,52000
2020/06/10,Huelva,Huelva,71267,521870,91349,430521,521870,98999
2020/06/10,Huelva,Badajoz,393,673559,108103,565456,521870,98999
2020/06/10,Huelva,Sevilla,1950,1942389,406973,1535416,521870,98999
2020/06/10,Huelva,Cádiz,635,1240155,239176,1000979,521870,98999
2020/06/10,Huesca,Lleida,1456,434930,78976,355954,220461,41135
2020/06/10,Huesca,Huesca,24842,220461,36177,184284,220461,41135
2020/06/10,Huesca,Zaragoza,644,964724,215504,749220,220461,41135
2020/06/10,Jaén,Albacete,16,388167,52338,335829,633564,90072
2020/06/10,Jaén,Granada,498,914678,175800,738878,633564,90072
2020/06/10,Jaén,Jaén,63850,633564,91540,542024,633564,90072
2020/06/10,Jaén,Córdoba,909,782979,140685,642294,633564,90072
2020/06/10,Las Palmas de Gran Canaria,Las Palmas de Gran Canaria,210528,1120406,223461,896945,1120406,222945
2020/06/10,León,León,65813,460001,84986,375015,460001,84917
2020/06/10,León,Asturias,77,1022800,204900,817900,460001,84917
2020/06/10,León,Ourense,360,307651,62101,245550,460001,84917
2020/06/10,León,Lugo,35,329587,56724,272863,460001,84917
2020/06/10,León,Zamora,178,172539,26959,145580,460001,84917
2020/06/10,León,Palencia,81,160866,28800,132066,460001,84917
2020/06/10,León,Valladolid,54,519546,110100,409446,460001,84917
2020/06/10,Lleida,Lleida,53401,434930,78976,355954,434930,77063
2020/06/10,Lleida,Barcelona,291,5664579,1247110,4417469,434930,77063
2020/06/10,Lleida,Tarragona,24,804664,143313,661351,434930,77063
2020/06/10,Lleida,Huesca,842,220461,36177,184284,434930,77063
2020/06/10,Lleida,Girona,280,771044,125988,645056,434930,77063
2020/06/10,Lleida,Zaragoza,163,964724,215504,749220,434930,77063
2020/06/10,Lugo,Asturias,927,1022800,204900,817900,329587,58465
2020/06/10,Lugo,Lugo,39929,329587,56724,272863,329587,58465
2020/06/10,Lugo,Pontevedra,27,942665,210457,732208,329587,58465
2020/06/10,Lugo,Coruña,783,1119596,238281,881315,329587,58465
2020/06/10,Lugo,Ourense,364,307651,62101,245550,329587,58465
2020/06/10,Madrid,Murcia,25,1493898,278520,1215378,6663394,1411205
2020/06/10,Madrid,Ávila,260,157640,22526,135114,6663394,1411205
2020/06/10,Madrid,Segovia,116,153129,25083,128046,6663394,1411205
2020/06/10,Madrid,Madrid,908426,6663394,1420125,5243269,6663394,1411205
2020/06/10,Madrid,Ciudad Real,37,495761,60560,435201,6663394,1411205
2020/06/10,Madrid,Cuenca,97,196329,26715,169614,6663394,1411205
2020/06/10,Madrid,Guadalajara,4228,257762,48743,209019,6663394,1411205
2020/06/10,Madrid,Toledo,5575,694844,114244,580600,6663394,1411205
2020/06/10,Málaga,Málaga,274843,1661785,325874,1335911,1661785,334214
2020/06/10,Málaga,Sevilla,310,1942389,406973,1535416,1661785,334214
2020/06/10,Málaga,Córdoba,509,782979,140685,642294,1661785,334214
2020/06/10,Málaga,Cádiz,2067,1240155,239176,1000979,1661785,334214
2020/06/10,Málaga,Granada,461,914678,175800,738878,1661785,334214
2020/06/10,Melilla,Córdoba,16,782979,140685,642294,86487,17203
2020/06/10,Melilla,Melilla,16944,86487,17050,69437,86487,17203
2020/06/10,Murcia,Murcia,222473,1493898,278520,1215378,1493898,276484
2020/06/10,Murcia,Almería,1488,716820,120156,596664,1493898,276484
2020/06/10,Murcia,Córdoba,16,782979,140685,642294,1493898,276484
2020/06/10,Murcia,Albacete,591,388167,52338,335829,1493898,276484
2020/06/10,Murcia,Granada,16,914678,175800,738878,1493898,276484
2020/06/10,Murcia,Alicante,3414,1858683,360049,1498634,1493898,276484
2020/06/10,Navarra,Zaragoza,742,964724,215504,749220,654183,133344
2020/06/10,Navarra,Gipuzkoa,474,723576,142037,581539,654183,133344
2020/06/10,Navarra,Navarra,99374,654183,132362,521821,654183,133344
2020/06/10,Navarra,Rioja,2756,316798,58596,258202,654183,133344
2020/06/10,Navarra,Araba,45,331549,74649,256900,654183,133344
2020/06/10,Ourense,León,362,460001,84986,375015,307651,62348
2020/06/10,Ourense,Lugo,293,329587,56724,272863,307651,62348
2020/06/10,Ourense,Pontevedra,259,942665,210457,732208,307651,62348
2020/06/10,Ourense,Zamora,62,172539,26959,145580,307651,62348
2020/06/10,Ourense,Ourense,47194,307651,62101,245550,307651,62348
2020/06/10,Palencia,León,23,460001,84986,375015,160866,30665
2020/06/10,Palencia,Cantabria,214,580795,118564,462231,160866,30665
2020/06/10,Palencia,Palencia,21183,160866,28800,132066,160866,30665
2020/06/10,Palencia,Burgos,323,357072,59255,297817,160866,30665
2020/06/10,Palencia,Valladolid,478,519546,110100,409446,160866,30665
2020/06/10,Pontevedra,Coruña,5242,1119596,238281,881315,942665,206606
2020/06/10,Pontevedra,Ourense,260,307651,62101,245550,942665,206606
2020/06/10,Pontevedra,Lugo,62,329587,56724,272863,942665,206606
2020/06/10,Pontevedra,Pontevedra,165111,942665,210457,732208,942665,206606
2020/06/10,Rioja,Navarra,2242,654183,132362,521821,316798,57310
2020/06/10,Rioja,Araba,883,331549,74649,256900,316798,57310
2020/06/10,Rioja,Burgos,120,357072,59255,297817,316798,57310
2020/06/10,Rioja,Rioja,43728,316798,58596,258202,316798,57310
2020/06/10,Salamanca,Zamora,179,172539,26959,145580,330119,59852
2020/06/10,Salamanca,Salamanca,48300,330119,60100,270019,330119,59852
2020/06/10,Salamanca,Ávila,251,157640,22526,135114,330119,59852
2020/06/10,Santa Cruz de Tenerife,Las Palmas de Gran Canaria,53,1120406,223461,896945,1032983,202285
2020/06/10,Santa Cruz de Tenerife,Santa Cruz de Tenerife,187094,1032983,202892,830091,1032983,202285
2020/06/10,Segovia,Valladolid,448,519546,110100,409446,153129,27903
2020/06/10,Segovia,Burgos,157,357072,59255,297817,153129,27903
2020/06/10,Segovia,Madrid,17,6663394,1420125,5243269,153129,27903
2020/06/10,Segovia,Segovia,16750,153129,25083,128046,153129,27903
2020/06/10,Segovia,Ávila,122,157640,22526,135114,153129,27903
2020/06/10,Sevilla,Córdoba,2678,782979,140685,642294,1942389,397127
2020/06/10,Sevilla,Sevilla,295654,1942389,406973,1535416,1942389,397127
2020/06/10,Sevilla,Cádiz,1182,1240155,239176,1000979,1942389,397127
2020/06/10,Sevilla,Badajoz,75,673559,108103,565456,1942389,397127
2020/06/10,Sevilla,Huelva,671,521870,91349,430521,1942389,397127
2020/06/10,Sevilla,Málaga,221,1661785,325874,1335911,1942389,397127
2020/06/10,Soria,Burgos,80,357072,59255,297817,88636,12002
2020/06/10,Soria,Zaragoza,161,964724,215504,749220,88636,12002
2020/06/10,Soria,Valladolid,47,519546,110100,409446,88636,12002
2020/06/10,Soria,Segovia,22,153129,25083,128046,88636,12002
2020/06/10,Soria,Navarra,33,654183,132362,521821,88636,12002
2020/06/10,Soria,Soria,8057,88636,10625,78011,88636,12002
2020/06/10,Tarragona,Barcelona,1698,5664579,1247110,4417469,804664,144144
2020/06/10,Tarragona,Castellón,979,579962,101319,478643,804664,144144
2020/06/10,Tarragona,Zaragoza,34,964724,215504,749220,804664,144144
2020/06/10,Tarragona,Teruel,56,134137,13991,120146,804664,144144
2020/06/10,Tarragona,Tarragona,99868,804664,143313,661351,804664,144144
2020/06/10,Teruel,Castellón,55,579962,101319,478643,134137,16651
2020/06/10,Teruel,Teruel,8718,134137,13991,120146,134137,16651
2020/06/10,Teruel,Tarragona,85,804664,143313,661351,134137,16651
2020/06/10,Teruel,Valencia,74,2565124,569092,1996032,134137,16651
2020/06/10,Teruel,Zaragoza,364,964724,215504,749220,134137,16651
2020/06/10,Toledo,Madrid,4524,6663394,1420125,5243269,694844,111073
2020/06/10,Toledo,Toledo,57236,694844,114244,580600,694844,111073
2020/06/10,Toledo,Ciudad Real,442,495761,60560,435201,694844,111073
2020/06/10,Toledo,Cáceres,223,394151,57116,337035,694844,111073
2020/06/10,Toledo,Cuenca,169,196329,26715,169614,694844,111073
2020/06/10,Toledo,Ávila,311,157640,22526,135114,694844,111073
2020/06/10,Valencia,Valencia,421085,2565124,569092,1996032,2565124,554463
2020/06/10,Valencia,Castellón,789,579962,101319,478643,2565124,554463
2020/06/10,Valencia,Albacete,406,388167,52338,335829,2565124,554463
2020/06/10,Valencia,Teruel,19,134137,13991,120146,2565124,554463
2020/06/10,Valencia,Cáceres,23,394151,57116,337035,2565124,554463
2020/06/10,Valencia,Cuenca,147,196329,26715,169614,2565124,554463
2020/06/10,Valencia,Alicante,1457,1858683,360049,1498634,2565124,554463
2020/06/10,Valladolid,Soria,42,88636,10625,78011,519546,105991
2020/06/10,Valladolid,Segovia,365,153129,25083,128046,519546,105991
2020/06/10,Valladolid,Palencia,115,160866,28800,132066,519546,105991
2020/06/10,Valladolid,Córdoba,16,782979,140685,642294,519546,105991
2020/06/10,Valladolid,Valladolid,83729,519546,110100,409446,519546,105991
2020/06/10,Valladolid,León,35,460001,84986,375015,519546,105991
2020/06/10,Valladolid,Zamora,159,172539,26959,145580,519546,105991
2020/06/10,Valladolid,Burgos,71,357072,59255,297817,519546,105991
2020/06/10,Valladolid,Ávila,36,157640,22526,135114,519546,105991
2020/06/10,Zamora,León,33,460001,84986,375015,172539,26464
2020/06/10,Zamora,Valladolid,118,519546,110100,409446,172539,26464
2020/06/10,Zamora,Ourense,98,307651,62101,245550,172539,26464
2020/06/10,Zamora,Zamora,18648,172539,26959,145580,172539,26464
2020/06/10,Zaragoza,Teruel,388,134137,13991,120146,964724,206949
2020/06/10,Zaragoza,Huesca,429,220461,36177,184284,964724,206949
2020/06/10,Zaragoza,Lleida,101,434930,78976,355954,964724,206949
2020/06/10,Zaragoza,Zaragoza,170090,964724,215504,749220,964724,206949
2020/06/10,Zaragoza,Soria,87,88636,10625,78011,964724,206949
2020/06/10,Zaragoza,Navarra,702,654183,132362,521821,964724,206949
2020/06/11,Albacete,Albacete,27168,388167,42179,345988,388167,40893
2020/06/11,Albacete,Murcia,547,1493898,286190,1207708,388167,40893
2020/06/11,Albacete,Valencia,316,2565124,575340,1989784,388167,40893
2020/06/11,Albacete,Alicante,209,1858683,365295,1493388,388167,40893
2020/06/11,Albacete,Cuenca,418,196329,22782,173547,388167,40893
2020/06/11,Albacete,Jaén,50,633564,85880,547684,388167,40893
2020/06/11,Albacete,Ciudad Real,612,495761,47449,448312,388167,40893
2020/06/11,Alicante,Valencia,2002,2565124,575340,1989784,1858683,372639
2020/06/11,Alicante,Alicante,291794,1858683,365295,1493388,1858683,372639
2020/06/11,Alicante,Murcia,4030,1493898,286190,1207708,1858683,372639
2020/06/11,Alicante,Albacete,501,388167,42179,345988,1858683,372639
2020/06/11,Almería,Córdoba,36,782979,142092,640887,716820,123852
2020/06/11,Almería,Almería,99323,716820,120284,596536,716820,123852
2020/06/11,Almería,Granada,658,914678,174665,740013,716820,123852
2020/06/11,Almería,Murcia,2219,1493898,286190,1207708,716820,123852
2020/06/11,Araba,Gipuzkoa,591,723576,142210,581366,331549,82541
2020/06/11,Araba,Bizkaia,2576,1152934,283827,869107,331549,82541
2020/06/11,Araba,Rioja,2035,316798,53357,263441,331549,82541
2020/06/11,Araba,Navarra,250,654183,131530,522653,331549,82541
2020/06/11,Araba,Burgos,2384,357072,58559,298513,331549,82541
2020/06/11,Araba,Araba,59953,331549,73359,258190,331549,82541
2020/06/11,Asturias,Asturias,163061,1022800,196349,826451,1022800,195610
2020/06/11,Asturias,León,39,460001,83219,376782,1022800,195610
2020/06/11,Asturias,Cantabria,239,580795,114613,466182,1022800,195610
2020/06/11,Asturias,Lugo,1069,329587,55857,273730,1022800,195610
2020/06/11,Ávila,Ávila,14726,157640,21990,135650,157640,24097
2020/06/11,Ávila,Valladolid,72,519546,109750,409796,157640,24097
2020/06/11,Ávila,Madrid,216,6663394,1416336,5247058,157640,24097
2020/06/11,Ávila,Salamanca,478,330119,59327,270792,157640,24097
2020/06/11,Ávila,Segovia,155,153129,25177,127952,157640,24097
2020/06/11,Ávila,Toledo,397,694844,94814,600030,157640,24097
2020/06/11,Ávila,Cáceres,125,394151,56918,337233,157640,24097
2020/06/11,Badajoz,Huelva,233,521870,91885,429985,673559,107496
2020/06/11,Badajoz,Cáceres,1451,394151,56918,337233,673559,107496
2020/06/11,Badajoz,Córdoba,88,782979,142092,640887,673559,107496
2020/06/11,Badajoz,Ciudad Real,73,495761,47449,448312,673559,107496
2020/06/11,Badajoz,Badajoz,82113,673559,109350,564209,673559,107496
2020/06/11,Badajoz,Sevilla,83,1942389,346111,1596278,673559,107496
2020/06/11,Balears,Barcelona,36,5664579,1272256,4392323,1149460,212406
2020/06/11,Balears,Valencia,59,2565124,575340,1989784,1149460,212406
2020/06/11,Balears,Balears,190600,1149460,210323,939137,1149460,212406
2020/06/11,Barcelona,Tarragona,2837,804664,143332,661332,5664579,1267486
2020/06/11,Barcelona,Girona,3524,771044,126268,644776,5664579,1267486
2020/06/11,Barcelona,Barcelona,845877,5664579,1272256,4392323,5664579,1267486
2020/06/11,Barcelona,Lleida,217,434930,79009,355921,5664579,1267486
2020/06/11,Bizkaia,Gipuzkoa,1748,723576,142210,581366,1152934,278673
2020/06/11,Bizkaia,Araba,1497,331549,73359,258190,1152934,278673
2020/06/11,Bizkaia,Burgos,131,357072,58559,298513,1152934,278673
2020/06/11,Bizkaia,Cantabria,3785,580795,114613,466182,1152934,278673
2020/06/11,Bizkaia,Bizkaia,223839,1152934,283827,869107,1152934,278673
2020/06/11,Burgos,Soria,30,88636,10454,78182,357072,59901
2020/06/11,Burgos,Valladolid,105,519546,109750,409796,357072,59901
2020/06/11,Burgos,Cantabria,22,580795,114613,466182,357072,59901
2020/06/11,Burgos,Rioja,95,316798,53357,263441,357072,59901
2020/06/11,Burgos,Araba,1156,331549,73359,258190,357072,59901
2020/06/11,Burgos,Palencia,231,160866,28156,132710,357072,59901
2020/06/11,Burgos,Segovia,92,153129,25177,127952,357072,59901
2020/06/11,Burgos,Burgos,44532,357072,58559,298513,357072,59901
2020/06/11,Burgos,Bizkaia,151,1152934,283827,869107,357072,59901
2020/06/11,Cáceres,Cáceres,39627,394151,56918,337233,394151,56704
2020/06/11,Cáceres,Toledo,267,694844,94814,600030,394151,56704
2020/06/11,Cáceres,Valencia,22,2565124,575340,1989784,394151,56704
2020/06/11,Cáceres,Ávila,143,157640,21990,135650,394151,56704
2020/06/11,Cáceres,Badajoz,1396,673559,109350,564209,394151,56704
2020/06/11,Cádiz,Cádiz,197540,1240155,235798,1004357,1240155,248606
2020/06/11,Cádiz,Córdoba,18,782979,142092,640887,1240155,248606
2020/06/11,Cádiz,Huelva,775,521870,91885,429985,1240155,248606
2020/06/11,Cádiz,Málaga,2020,1661785,322622,1339163,1240155,248606
2020/06/11,Cádiz,Ceuta,123,84777,9985,74792,1240155,248606
2020/06/11,Cádiz,Sevilla,2847,1942389,346111,1596278,1240155,248606
2020/06/11,Cantabria,Cantabria,86070,580795,114613,466182,580795,109235
2020/06/11,Cantabria,Bizkaia,949,1152934,283827,869107,580795,109235
2020/06/11,Cantabria,Asturias,211,1022800,196349,826451,580795,109235
2020/06/11,Cantabria,Palencia,86,160866,28156,132710,580795,109235
2020/06/11,Castellón,Teruel,48,134137,13948,120189,579962,108760
2020/06/11,Castellón,Castellón,79828,579962,102077,477885,579962,108760
2020/06/11,Castellón,Tarragona,955,804664,143332,661332,579962,108760
2020/06/11,Castellón,Valencia,955,2565124,575340,1989784,579962,108760
2020/06/11,Ceuta,Cádiz,59,1240155,235798,1004357,84777,9612
2020/06/11,Ceuta,Ceuta,9225,84777,9985,74792,84777,9612
2020/06/11,Ciudad Real,Badajoz,70,673559,109350,564209,495761,42710
2020/06/11,Ciudad Real,Cuenca,36,196329,22782,173547,495761,42710
2020/06/11,Ciudad Real,Albacete,397,388167,42179,345988,495761,42710
2020/06/11,Ciudad Real,Ciudad Real,28398,495761,47449,448312,495761,42710
2020/06/11,Ciudad Real,Córdoba,433,782979,142092,640887,495761,42710
2020/06/11,Ciudad Real,Toledo,296,694844,94814,600030,495761,42710
2020/06/11,Córdoba,Córdoba,101373,782979,142092,640887,782979,139160
2020/06/11,Córdoba,Jaén,896,633564,85880,547684,782979,139160
2020/06/11,Córdoba,Sevilla,2437,1942389,346111,1596278,782979,139160
2020/06/11,Córdoba,Granada,124,914678,174665,740013,782979,139160
2020/06/11,Córdoba,Ciudad Real,289,495761,47449,448312,782979,139160
2020/06/11,Córdoba,Badajoz,144,673559,109350,564209,782979,139160
2020/06/11,Córdoba,Málaga,339,1661785,322622,1339163,782979,139160
2020/06/11,Coruña,Lugo,854,329587,55857,273730,1119596,239892
2020/06/11,Coruña,Coruña,181707,1119596,233783,885813,1119596,239892
2020/06/11,Coruña,Pontevedra,6759,942665,205142,737523,1119596,239892
2020/06/11,Cuenca,Albacete,721,388167,42179,345988,196329,23124
2020/06/11,Cuenca,Guadalajara,76,257762,43676,214086,196329,23124
2020/06/11,Cuenca,Toledo,128,694844,94814,600030,196329,23124
2020/06/11,Cuenca,Madrid,46,6663394,1416336,5247058,196329,23124
2020/06/11,Cuenca,Valencia,107,2565124,575340,1989784,196329,23124
2020/06/11,Cuenca,Cuenca,12610,196329,22782,173547,196329,23124
2020/06/11,Cuenca,Ciudad Real,204,495761,47449,448312,196329,23124
2020/06/11,Gipuzkoa,Navarra,638,654183,131530,522653,723576,147125
2020/06/11,Gipuzkoa,Araba,545,331549,73359,258190,723576,147125
2020/06/11,Gipuzkoa,Gipuzkoa,111407,723576,142210,581366,723576,147125
2020/06/11,Gipuzkoa,Bizkaia,2530,1152934,283827,869107,723576,147125
2020/06/11,Girona,Lleida,235,434930,79009,355921,771044,134821
2020/06/11,Girona,Barcelona,3596,5664579,1272256,4392323,771044,134821
2020/06/11,Girona,Girona,87604,771044,126268,644776,771044,134821
2020/06/11,Granada,Almería,684,716820,120284,596536,914678,173508
2020/06/11,Granada,Jaén,758,633564,85880,547684,914678,173508
2020/06/11,Granada,Málaga,291,1661785,322622,1339163,914678,173508
2020/06/11,Granada,Murcia,91,1493898,286190,1207708,914678,173508
2020/06/11,Granada,Córdoba,218,782979,142092,640887,914678,173508
2020/06/11,Granada,Granada,129442,914678,174665,740013,914678,173508
2020/06/11,Guadalajara,Teruel,33,134137,13948,120189,257762,43017
2020/06/11,Guadalajara,Guadalajara,23234,257762,43676,214086,257762,43017
2020/06/11,Guadalajara,Cuenca,80,196329,22782,173547,257762,43017
2020/06/11,Guadalajara,Madrid,2669,6663394,1416336,5247058,257762,43017
2020/06/11,Huelva,Badajoz,404,673559,109350,564209,521870,102365
2020/06/11,Huelva,Huelva,72309,521870,91885,429985,521870,102365
2020/06/11,Huelva,Sevilla,3619,1942389,346111,1596278,521870,102365
2020/06/11,Huelva,Cádiz,707,1240155,235798,1004357,521870,102365
2020/06/11,Huesca,Huesca,23869,220461,35188,185273,220461,39548
2020/06/11,Huesca,Zaragoza,579,964724,213347,751377,220461,39548
2020/06/11,Huesca,Lleida,1429,434930,79009,355921,220461,39548
2020/06/11,Jaén,Granada,387,914678,174665,740013,633564,82344
2020/06/11,Jaén,Jaén,56791,633564,85880,547684,633564,82344
2020/06/11,Jaén,Albacete,62,388167,42179,345988,633564,82344
2020/06/11,Jaén,Córdoba,1101,782979,142092,640887,633564,82344
2020/06/11,Las Palmas de Gran Canaria,Las Palmas de Gran Canaria,209799,1120406,222802,897604,1120406,223074
2020/06/11,Las Palmas de Gran Canaria,Santa Cruz de Tenerife,51,1032983,202036,830947,1120406,223074
2020/06/11,León,Asturias,107,1022800,196349,826451,460001,83369
2020/06/11,León,Ourense,367,307651,62852,244799,460001,83369
2020/06/11,León,León,64253,460001,83219,376782,460001,83369
2020/06/11,León,Lugo,31,329587,55857,273730,460001,83369
2020/06/11,León,Palencia,32,160866,28156,132710,460001,83369
2020/06/11,León,Zamora,124,172539,26595,145944,460001,83369
2020/06/11,Lleida,Huesca,804,220461,35188,185273,434930,77302
2020/06/11,Lleida,Lleida,53378,434930,79009,355921,434930,77302
2020/06/11,Lleida,Girona,242,771044,126268,644776,434930,77302
2020/06/11,Lleida,Barcelona,421,5664579,1272256,4392323,434930,77302
2020/06/11,Lleida,Zaragoza,150,964724,213347,751377,434930,77302
2020/06/11,Lleida,Tarragona,31,804664,143332,661332,434930,77302
2020/06/11,Lugo,Lugo,39577,329587,55857,273730,329587,58552
2020/06/11,Lugo,Coruña,789,1119596,233783,885813,329587,58552
2020/06/11,Lugo,Ourense,379,307651,62852,244799,329587,58552
2020/06/11,Lugo,Pontevedra,57,942665,205142,737523,329587,58552
2020/06/11,Lugo,Asturias,905,1022800,196349,826451,329587,58552
2020/06/11,Madrid,Ávila,320,157640,21990,135650,6663394,1424360
2020/06/11,Madrid,Segovia,71,153129,25177,127952,6663394,1424360
2020/06/11,Madrid,Zaragoza,83,964724,213347,751377,6663394,1424360
2020/06/11,Madrid,Madrid,911955,6663394,1416336,5247058,6663394,1424360
2020/06/11,Madrid,Ciudad Real,39,495761,47449,448312,6663394,1424360
2020/06/11,Madrid,Guadalajara,4324,257762,43676,214086,6663394,1424360
2020/06/11,Madrid,Toledo,5886,694844,94814,600030,6663394,1424360
2020/06/11,Madrid,Cuenca,85,196329,22782,173547,6663394,1424360
2020/06/11,Málaga,Córdoba,558,782979,142092,640887,1661785,328948
2020/06/11,Málaga,Sevilla,361,1942389,346111,1596278,1661785,328948
2020/06/11,Málaga,Cádiz,1887,1240155,235798,1004357,1661785,328948
2020/06/11,Málaga,Granada,427,914678,174665,740013,1661785,328948
2020/06/11,Málaga,Jaén,42,633564,85880,547684,1661785,328948
2020/06/11,Málaga,Málaga,266714,1661785,322622,1339163,1661785,328948
2020/06/11,Málaga,Almería,19,716820,120284,596536,1661785,328948
2020/06/11,Melilla,Melilla,16521,86487,16850,69637,86487,16682
2020/06/11,Murcia,Albacete,579,388167,42179,345988,1493898,282637
2020/06/11,Murcia,Murcia,229092,1493898,286190,1207708,1493898,282637
2020/06/11,Murcia,Alicante,3384,1858683,365295,1493388,1493898,282637
2020/06/11,Murcia,Almería,1479,716820,120284,596536,1493898,282637
2020/06/11,Murcia,Granada,32,914678,174665,740013,1493898,282637
2020/06/11,Murcia,Córdoba,18,782979,142092,640887,1493898,282637
2020/06/11,Navarra,Navarra,99120,654183,131530,522653,654183,133680
2020/06/11,Navarra,Zaragoza,806,964724,213347,751377,654183,133680
2020/06/11,Navarra,Rioja,2690,316798,53357,263441,654183,133680
2020/06/11,Navarra,Gipuzkoa,541,723576,142210,581366,654183,133680
2020/06/11,Navarra,Araba,85,331549,73359,258190,654183,133680
2020/06/11,Ourense,Lugo,281,329587,55857,273730,307651,63903
2020/06/11,Ourense,León,349,460001,83219,376782,307651,63903
2020/06/11,Ourense,Zamora,63,172539,26595,145944,307651,63903
2020/06/11,Ourense,Pontevedra,208,942665,205142,737523,307651,63903
2020/06/11,Ourense,Ourense,48521,307651,62852,244799,307651,63903
2020/06/11,Palencia,León,29,460001,83219,376782,160866,30099
2020/06/11,Palencia,Burgos,302,357072,58559,298513,160866,30099
2020/06/11,Palencia,Palencia,20581,160866,28156,132710,160866,30099
2020/06/11,Palencia,Cantabria,251,580795,114613,466182,160866,30099
2020/06/11,Palencia,Valladolid,431,519546,109750,409796,160866,30099
2020/06/11,Pontevedra,Ourense,357,307651,62852,244799,942665,206123
2020/06/11,Pontevedra,Pontevedra,161019,942665,205142,737523,942665,206123
2020/06/11,Pontevedra,Coruña,4819,1119596,233783,885813,942665,206123
2020/06/11,Pontevedra,Lugo,29,329587,55857,273730,942665,206123
2020/06/11,Rioja,Navarra,2034,654183,131530,522653,316798,50379
2020/06/11,Rioja,Rioja,39071,316798,53357,263441,316798,50379
2020/06/11,Rioja,Araba,613,331549,73359,258190,316798,50379
2020/06/11,Rioja,Burgos,83,357072,58559,298513,316798,50379
2020/06/11,Salamanca,Ávila,210,157640,21990,135650,330119,59561
2020/06/11,Salamanca,Zamora,63,172539,26595,145944,330119,59561
2020/06/11,Salamanca,Salamanca,47788,330119,59327,270792,330119,59561
2020/06/11,Santa Cruz de Tenerife,Santa Cruz de Tenerife,186441,1032983,202036,830947,1032983,201590
2020/06/11,Santa Cruz de Tenerife,Las Palmas de Gran Canaria,31,1120406,222802,897604,1032983,201590
2020/06/11,Segovia,Burgos,159,357072,58559,298513,153129,28057
2020/06/11,Segovia,Madrid,24,6663394,1416336,5247058,153129,28057
2020/06/11,Segovia,Valladolid,430,519546,109750,409796,153129,28057
2020/06/11,Segovia,Soria,30,88636,10454,78182,153129,28057
2020/06/11,Segovia,Segovia,16882,153129,25177,127952,153129,28057
2020/06/11,Segovia,Ávila,169,157640,21990,135650,153129,28057
2020/06/11,Sevilla,Sevilla,220786,1942389,346111,1596278,1942389,311034
2020/06/11,Sevilla,Huelva,724,521870,91885,429985,1942389,311034
2020/06/11,Sevilla,Cádiz,1175,1240155,235798,1004357,1942389,311034
2020/06/11,Sevilla,Córdoba,2978,782979,142092,640887,1942389,311034
2020/06/11,Sevilla,Badajoz,50,673559,109350,564209,1942389,311034
2020/06/11,Sevilla,Málaga,193,1661785,322622,1339163,1942389,311034
2020/06/11,Soria,Valladolid,27,519546,109750,409796,88636,11721
2020/06/11,Soria,Burgos,90,357072,58559,298513,88636,11721
2020/06/11,Soria,Soria,7992,88636,10454,78182,88636,11721
2020/06/11,Soria,Segovia,21,153129,25177,127952,88636,11721
2020/06/11,Soria,Zaragoza,172,964724,213347,751377,88636,11721
2020/06/11,Tarragona,Barcelona,1907,5664579,1272256,4392323,804664,144807
2020/06/11,Tarragona,Castellón,1016,579962,102077,477885,804664,144807
2020/06/11,Tarragona,Teruel,78,134137,13948,120189,804664,144807
2020/06/11,Tarragona,Zaragoza,56,964724,213347,751377,804664,144807
2020/06/11,Tarragona,Tarragona,100299,804664,143332,661332,804664,144807
2020/06/11,Tarragona,Lleida,48,434930,79009,355921,804664,144807
2020/06/11,Teruel,Valencia,22,2565124,575340,1989784,134137,16591
2020/06/11,Teruel,Zaragoza,310,964724,213347,751377,134137,16591
2020/06/11,Teruel,Castellón,51,579962,102077,477885,134137,16591
2020/06/11,Teruel,Tarragona,95,804664,143332,661332,134137,16591
2020/06/11,Teruel,Teruel,8547,134137,13948,120189,134137,16591
2020/06/11,Teruel,Guadalajara,18,257762,43676,214086,134137,16591
2020/06/11,Toledo,Ciudad Real,205,495761,47449,448312,694844,83723
2020/06/11,Toledo,Córdoba,18,782979,142092,640887,694844,83723
2020/06/11,Toledo,Cáceres,164,394151,56918,337233,694844,83723
2020/06/11,Toledo,Ávila,274,157640,21990,135650,694844,83723
2020/06/11,Toledo,Toledo,40567,694844,94814,600030,694844,83723
2020/06/11,Toledo,Cuenca,56,196329,22782,173547,694844,83723
2020/06/11,Toledo,Madrid,3739,6663394,1416336,5247058,694844,83723
2020/06/11,Valencia,Cuenca,165,196329,22782,173547,2565124,562298
2020/06/11,Valencia,Albacete,327,388167,42179,345988,2565124,562298
2020/06/11,Valencia,Alicante,1532,1858683,365295,1493388,2565124,562298
2020/06/11,Valencia,Cáceres,21,394151,56918,337233,2565124,562298
2020/06/11,Valencia,Castellón,810,579962,102077,477885,2565124,562298
2020/06/11,Valencia,Valencia,427045,2565124,575340,1989784,2565124,562298
2020/06/11,Valladolid,Valladolid,83521,519546,109750,409796,519546,105857
2020/06/11,Valladolid,Segovia,433,153129,25177,127952,519546,105857
2020/06/11,Valladolid,Zamora,111,172539,26595,145944,519546,105857
2020/06/11,Valladolid,Burgos,103,357072,58559,298513,519546,105857
2020/06/11,Valladolid,Palencia,121,160866,28156,132710,519546,105857
2020/06/11,Valladolid,León,32,460001,83219,376782,519546,105857
2020/06/11,Valladolid,Soria,40,88636,10454,78182,519546,105857
2020/06/11,Valladolid,Ávila,55,157640,21990,135650,519546,105857
2020/06/11,Zamora,Ourense,146,307651,62852,244799,172539,27181
2020/06/11,Zamora,Valladolid,124,519546,109750,409796,172539,27181
2020/06/11,Zamora,Zamora,18613,172539,26595,145944,172539,27181
2020/06/11,Zamora,Salamanca,16,330119,59327,270792,172539,27181
2020/06/11,Zamora,León,57,460001,83219,376782,172539,27181
2020/06/11,Zaragoza,Teruel,439,134137,13948,120189,964724,205554
2020/06/11,Zaragoza,Zaragoza,167664,964724,213347,751377,964724,205554
2020/06/11,Zaragoza,Soria,92,88636,10454,78182,964724,205554
2020/06/11,Zaragoza,Navarra,673,654183,131530,522653,964724,205554
2020/06/11,Zaragoza,Lleida,115,434930,79009,355921,964724,205554
2020/06/11,Zaragoza,Huesca,399,220461,35188,185273,964724,205554
2020/06/12,Albacete,Alicante,251,1858683,356900,1501783,388167,44518
2020/06/12,Albacete,Albacete,29451,388167,43296,344871,388167,44518
2020/06/12,Albacete,Cuenca,776,196329,23337,172992,388167,44518
2020/06/12,Albacete,Ciudad Real,544,495761,53864,441897,388167,44518
2020/06/12,Albacete,Murcia,720,1493898,280745,1213153,388167,44518
2020/06/12,Albacete,Valencia,376,2565124,546659,2018465,388167,44518
2020/06/12,Alicante,Albacete,443,388167,43296,344871,1858683,362425
2020/06/12,Alicante,Alicante,296130,1858683,356900,1501783,1858683,362425
2020/06/12,Alicante,Murcia,3602,1493898,280745,1213153,1858683,362425
2020/06/12,Alicante,Valencia,1866,2565124,546659,2018465,1858683,362425
2020/06/12,Almería,Granada,595,914678,160573,754105,716820,115659
2020/06/12,Almería,Murcia,2013,1493898,280745,1213153,716820,115659
2020/06/12,Almería,Almería,95900,716820,113915,602905,716820,115659
2020/06/12,Araba,Rioja,1817,316798,53806,262992,331549,77137
2020/06/12,Araba,Navarra,235,654183,124410,529773,331549,77137
2020/06/12,Araba,Gipuzkoa,506,723576,137519,586057,331549,77137
2020/06/12,Araba,Bizkaia,2075,1152934,265168,887766,331549,77137
2020/06/12,Araba,Araba,58378,331549,70057,261492,331549,77137
2020/06/12,Araba,Burgos,2203,357072,54112,302960,331549,77137
2020/06/12,Asturias,León,48,460001,78386,381615,1022800,187349
2020/06/12,Asturias,Cantabria,382,580795,108660,472135,1022800,187349
2020/06/12,Asturias,Asturias,158325,1022800,186994,835806,1022800,187349
2020/06/12,Asturias,Lugo,1041,329587,51618,277969,1022800,187349
2020/06/12,Ávila,Madrid,199,6663394,1296869,5366525,157640,22240
2020/06/12,Ávila,Segovia,121,153129,22883,130246,157640,22240
2020/06/12,Ávila,Toledo,239,694844,100922,593922,157640,22240
2020/06/12,Ávila,Salamanca,347,330119,45549,284570,157640,22240
2020/06/12,Ávila,Cáceres,110,394151,53061,341090,157640,22240
2020/06/12,Ávila,Valladolid,45,519546,102495,417051,157640,22240
2020/06/12,Ávila,Ávila,14421,157640,21007,136633,157640,22240
2020/06/12,Badajoz,Sevilla,74,1942389,350380,1592009,673559,100987
2020/06/12,Badajoz,Badajoz,79591,673559,101914,571645,673559,100987
2020/06/12,Badajoz,Ciudad Real,52,495761,53864,441897,673559,100987
2020/06/12,Badajoz,Cáceres,1366,394151,53061,341090,673559,100987
2020/06/12,Badajoz,Huelva,220,521870,86493,435377,673559,100987
2020/06/12,Badajoz,Córdoba,151,782979,131821,651158,673559,100987
2020/06/12,Balears,Valencia,67,2565124,546659,2018465,1149460,211288
2020/06/12,Balears,Barcelona,24,5664579,1212449,4452130,1149460,211288
2020/06/12,Balears,Balears,191314,1149460,210237,939223,1149460,211288
2020/06/12,Barcelona,Tarragona,2664,804664,138875,665789,5664579,1207951
2020/06/12,Barcelona,Lleida,257,434930,77023,357907,5664579,1207951
2020/06/12,Barcelona,Barcelona,846906,5664579,1212449,4452130,5664579,1207951
2020/06/12,Barcelona,Girona,3611,771044,123396,647648,5664579,1207951
2020/06/12,Bizkaia,Cantabria,3338,580795,108660,472135,1152934,261927
2020/06/12,Bizkaia,Gipuzkoa,1593,723576,137519,586057,1152934,261927
2020/06/12,Bizkaia,Bizkaia,214308,1152934,265168,887766,1152934,261927
2020/06/12,Bizkaia,Araba,1330,331549,70057,261492,1152934,261927
2020/06/12,Bizkaia,Burgos,85,357072,54112,302960,1152934,261927
2020/06/12,Burgos,Soria,30,88636,9926,78710,357072,54730
2020/06/12,Burgos,Rioja,271,316798,53806,262992,357072,54730
2020/06/12,Burgos,Burgos,41940,357072,54112,302960,357072,54730
2020/06/12,Burgos,Palencia,227,160866,26334,134532,357072,54730
2020/06/12,Burgos,Segovia,93,153129,22883,130246,357072,54730
2020/06/12,Burgos,Araba,1195,331549,70057,261492,357072,54730
2020/06/12,Burgos,Valladolid,87,519546,102495,417051,357072,54730
2020/06/12,Burgos,Bizkaia,138,1152934,265168,887766,357072,54730
2020/06/12,Cáceres,Toledo,258,694844,100922,593922,394151,53219
2020/06/12,Cáceres,Badajoz,1246,673559,101914,571645,394151,53219
2020/06/12,Cáceres,Valencia,22,2565124,546659,2018465,394151,53219
2020/06/12,Cáceres,Cáceres,38633,394151,53061,341090,394151,53219
2020/06/12,Cáceres,Ávila,152,157640,21007,136633,394151,53219
2020/06/12,Cádiz,Sevilla,1705,1942389,350380,1592009,1240155,226573
2020/06/12,Cádiz,Málaga,1852,1661785,310709,1351076,1240155,226573
2020/06/12,Cádiz,Ceuta,17,84777,9546,75231,1240155,226573
2020/06/12,Cádiz,Cádiz,188762,1240155,219391,1020764,1240155,226573
2020/06/12,Cádiz,Huelva,723,521870,86493,435377,1240155,226573
2020/06/12,Cantabria,Cantabria,84775,580795,108660,472135,580795,104244
2020/06/12,Cantabria,Bizkaia,1243,1152934,265168,887766,580795,104244
2020/06/12,Cantabria,Asturias,182,1022800,186994,835806,580795,104244
2020/06/12,Cantabria,Palencia,48,160866,26334,134532,580795,104244
2020/06/12,Castellón,Teruel,103,134137,13309,120828,579962,101959
2020/06/12,Castellón,Castellón,79498,579962,98892,481070,579962,101959
2020/06/12,Castellón,Tarragona,1001,804664,138875,665789,579962,101959
2020/06/12,Castellón,Valencia,882,2565124,546659,2018465,579962,101959
2020/06/12,Ceuta,Ceuta,9170,84777,9546,75231,84777,9541
2020/06/12,Ceuta,Cádiz,65,1240155,219391,1020764,84777,9541
2020/06/12,Ciudad Real,Córdoba,401,782979,131821,651158,495761,51149
2020/06/12,Ciudad Real,Cuenca,54,196329,23337,172992,495761,51149
2020/06/12,Ciudad Real,Ciudad Real,36041,495761,53864,441897,495761,51149
2020/06/12,Ciudad Real,Toledo,517,694844,100922,593922,495761,51149
2020/06/12,Ciudad Real,Albacete,590,388167,43296,344871,495761,51149
2020/06/12,Ciudad Real,Badajoz,57,673559,101914,571645,495761,51149
2020/06/12,Córdoba,Ciudad Real,337,495761,53864,441897,782979,129598
2020/06/12,Córdoba,Málaga,330,1661785,310709,1351076,782979,129598
2020/06/12,Córdoba,Sevilla,2255,1942389,350380,1592009,782979,129598
2020/06/12,Córdoba,Jaén,956,633564,82211,551353,782979,129598
2020/06/12,Córdoba,Córdoba,98173,782979,131821,651158,782979,129598
2020/06/12,Córdoba,Granada,142,914678,160573,754105,782979,129598
2020/06/12,Córdoba,Badajoz,56,673559,101914,571645,782979,129598
2020/06/12,Coruña,Coruña,177149,1119596,221393,898203,1119596,223417
2020/06/12,Coruña,Pontevedra,6349,942665,194807,747858,1119596,223417
2020/06/12,Coruña,Lugo,784,329587,51618,277969,1119596,223417
2020/06/12,Cuenca,Madrid,79,6663394,1296869,5366525,196329,23993
2020/06/12,Cuenca,Cuenca,13802,196329,23337,172992,196329,23993
2020/06/12,Cuenca,Albacete,813,388167,43296,344871,196329,23993
2020/06/12,Cuenca,Guadalajara,89,257762,42884,214878,196329,23993
2020/06/12,Cuenca,Valencia,98,2565124,546659,2018465,196329,23993
2020/06/12,Cuenca,Toledo,144,694844,100922,593922,196329,23993
2020/06/12,Cuenca,Ciudad Real,144,495761,53864,441897,196329,23993
2020/06/12,Gipuzkoa,Bizkaia,2326,1152934,265168,887766,723576,140233
2020/06/12,Gipuzkoa,Navarra,624,654183,124410,529773,723576,140233
2020/06/12,Gipuzkoa,Araba,426,331549,70057,261492,723576,140233
2020/06/12,Gipuzkoa,Gipuzkoa,110745,723576,137519,586057,723576,140233
2020/06/12,Girona,Lleida,256,434930,77023,357907,771044,129530
2020/06/12,Girona,Girona,88503,771044,123396,647648,771044,129530
2020/06/12,Girona,Barcelona,3355,5664579,1212449,4452130,771044,129530
2020/06/12,Granada,Jaén,427,633564,82211,551353,914678,159585
2020/06/12,Granada,Málaga,273,1661785,310709,1351076,914678,159585
2020/06/12,Granada,Almería,669,716820,113915,602905,914678,159585
2020/06/12,Granada,Córdoba,174,782979,131821,651158,914678,159585
2020/06/12,Granada,Granada,123539,914678,160573,754105,914678,159585
2020/06/12,Granada,Murcia,142,1493898,280745,1213153,914678,159585
2020/06/12,Guadalajara,Cuenca,65,196329,23337,172992,257762,45174
2020/06/12,Guadalajara,Madrid,2849,6663394,1296869,5366525,257762,45174
2020/06/12,Guadalajara,Guadalajara,26249,257762,42884,214878,257762,45174
2020/06/12,Huelva,Huelva,68974,521870,86493,435377,521870,91734
2020/06/12,Huelva,Cádiz,587,1240155,219391,1020764,521870,91734
2020/06/12,Huelva,Sevilla,1830,1942389,350380,1592009,521870,91734
2020/06/12,Huelva,Badajoz,378,673559,101914,571645,521870,91734
2020/06/12,Huesca,Huesca,24413,220461,34366,186095,220461,38217
2020/06/12,Huesca,Lleida,1303,434930,77023,357907,220461,38217
2020/06/12,Huesca,Zaragoza,531,964724,206969,757755,220461,38217
2020/06/12,Jaén,Córdoba,983,782979,131821,651158,633564,81338
2020/06/12,Jaén,Granada,365,914678,160573,754105,633564,81338
2020/06/12,Jaén,Jaén,59176,633564,82211,551353,633564,81338
2020/06/12,Jaén,Albacete,45,388167,43296,344871,633564,81338
2020/06/12,Las Palmas de Gran Canaria,Las Palmas de Gran Canaria,208015,1120406,220433,899973,1120406,220136
2020/06/12,León,Lugo,32,329587,51618,277969,460001,78320
2020/06/12,León,León,62293,460001,78386,381615,460001,78320
2020/06/12,León,Zamora,108,172539,24593,147946,460001,78320
2020/06/12,León,Palencia,28,160866,26334,134532,460001,78320
2020/06/12,León,Valladolid,77,519546,102495,417051,460001,78320
2020/06/12,León,Asturias,87,1022800,186994,835806,460001,78320
2020/06/12,León,Ourense,304,307651,58719,248932,460001,78320
2020/06/12,Lleida,Huesca,880,220461,34366,186095,434930,75153
2020/06/12,Lleida,Girona,248,771044,123396,647648,434930,75153
2020/06/12,Lleida,Barcelona,395,5664579,1212449,4452130,434930,75153
2020/06/12,Lleida,Tarragona,72,804664,138875,665789,434930,75153
2020/06/12,Lleida,Lleida,54285,434930,77023,357907,434930,75153
2020/06/12,Lleida,Zaragoza,184,964724,206969,757755,434930,75153
2020/06/12,Lugo,Coruña,832,1119596,221393,898203,329587,53305
2020/06/12,Lugo,Asturias,873,1022800,186994,835806,329587,53305
2020/06/12,Lugo,Ourense,214,307651,58719,248932,329587,53305
2020/06/12,Lugo,Lugo,37606,329587,51618,277969,329587,53305
2020/06/12,Madrid,Madrid,860386,6663394,1296869,5366525,6663394,1298756
2020/06/12,Madrid,Guadalajara,3709,257762,42884,214878,6663394,1298756
2020/06/12,Madrid,Ávila,319,157640,21007,136633,6663394,1298756
2020/06/12,Madrid,Segovia,50,153129,22883,130246,6663394,1298756
2020/06/12,Madrid,Toledo,5301,694844,100922,593922,6663394,1298756
2020/06/12,Madrid,Ciudad Real,26,495761,53864,441897,6663394,1298756
2020/06/12,Madrid,Cuenca,73,196329,23337,172992,6663394,1298756
2020/06/12,Málaga,Sevilla,321,1942389,350380,1592009,1661785,315116
2020/06/12,Málaga,Cádiz,1850,1240155,219391,1020764,1661785,315116
2020/06/12,Málaga,Málaga,264861,1661785,310709,1351076,1661785,315116
2020/06/12,Málaga,Córdoba,423,782979,131821,651158,1661785,315116
2020/06/12,Málaga,Granada,403,914678,160573,754105,1661785,315116
2020/06/12,Melilla,Melilla,16497,86487,16740,69747,86487,16621
2020/06/12,Murcia,Albacete,561,388167,43296,344871,1493898,275197
2020/06/12,Murcia,Granada,28,914678,160573,754105,1493898,275197
2020/06/12,Murcia,Alicante,3034,1858683,356900,1501783,1493898,275197
2020/06/12,Murcia,Almería,1342,716820,113915,602905,1493898,275197
2020/06/12,Murcia,Murcia,231105,1493898,280745,1213153,1493898,275197
2020/06/12,Navarra,Zaragoza,775,964724,206969,757755,654183,124358
2020/06/12,Navarra,Navarra,96897,654183,124410,529773,654183,124358
2020/06/12,Navarra,Rioja,2243,316798,53806,262992,654183,124358
2020/06/12,Navarra,Araba,97,331549,70057,261492,654183,124358
2020/06/12,Navarra,Gipuzkoa,488,723576,137519,586057,654183,124358
2020/06/12,Ourense,Pontevedra,188,942665,194807,747858,307651,59031
2020/06/12,Ourense,Ourense,46681,307651,58719,248932,307651,59031
2020/06/12,Ourense,Lugo,273,329587,51618,277969,307651,59031
2020/06/12,Ourense,León,320,460001,78386,381615,307651,59031
2020/06/12,Ourense,Zamora,54,172539,24593,147946,307651,59031
2020/06/12,Palencia,Valladolid,331,519546,102495,417051,160866,27737
2020/06/12,Palencia,Palencia,20182,160866,26334,134532,160866,27737
2020/06/12,Palencia,León,56,460001,78386,381615,160866,27737
2020/06/12,Palencia,Cantabria,219,580795,108660,472135,160866,27737
2020/06/12,Palencia,Burgos,245,357072,54112,302960,160866,27737
2020/06/12,Pontevedra,Pontevedra,158202,942665,194807,747858,942665,193156
2020/06/12,Pontevedra,Coruña,4939,1119596,221393,898203,942665,193156
2020/06/12,Pontevedra,Ourense,294,307651,58719,248932,942665,193156
2020/06/12,Pontevedra,Lugo,48,329587,51618,277969,942665,193156
2020/06/12,Rioja,Burgos,39,357072,54112,302960,316798,51949
2020/06/12,Rioja,Rioja,41369,316798,53806,262992,316798,51949
2020/06/12,Rioja,Navarra,2157,654183,124410,529773,316798,51949
2020/06/12,Rioja,Araba,729,331549,70057,261492,316798,51949
2020/06/12,Salamanca,Ávila,249,157640,21007,136633,330119,43961
2020/06/12,Salamanca,Zamora,56,172539,24593,147946,330119,43961
2020/06/12,Salamanca,Salamanca,35694,330119,45549,284570,330119,43961
2020/06/12,Santa Cruz de Tenerife,Las Palmas de Gran Canaria,74,1120406,220433,899973,1032983,197988
2020/06/12,Santa Cruz de Tenerife,Santa Cruz de Tenerife,184065,1032983,198432,834551,1032983,197988
2020/06/12,Segovia,Segovia,15900,153129,22883,130246,153129,24911
2020/06/12,Segovia,Burgos,142,357072,54112,302960,153129,24911
2020/06/12,Segovia,Valladolid,343,519546,102495,417051,153129,24911
2020/06/12,Segovia,Madrid,22,6663394,1296869,5366525,153129,24911
2020/06/12,Segovia,Ávila,119,157640,21007,136633,153129,24911
2020/06/12,Sevilla,Huelva,685,521870,86493,435377,1942389,339167
2020/06/12,Sevilla,Málaga,204,1661785,310709,1351076,1942389,339167
2020/06/12,Sevilla,Sevilla,258115,1942389,350380,1592009,1942389,339167
2020/06/12,Sevilla,Badajoz,80,673559,101914,571645,1942389,339167
2020/06/12,Sevilla,Cádiz,985,1240155,219391,1020764,1942389,339167
2020/06/12,Sevilla,Córdoba,2305,782979,131821,651158,1942389,339167
2020/06/12,Soria,Soria,7700,88636,9926,78710,88636,10419
2020/06/12,Soria,Zaragoza,119,964724,206969,757755,88636,10419
2020/06/12,Soria,Valladolid,43,519546,102495,417051,88636,10419
2020/06/12,Soria,Burgos,71,357072,54112,302960,88636,10419
2020/06/12,Soria,Navarra,22,654183,124410,529773,88636,10419
2020/06/12,Tarragona,Barcelona,1940,5664579,1212449,4452130,804664,139358
2020/06/12,Tarragona,Tarragona,101184,804664,138875,665789,804664,139358
2020/06/12,Tarragona,Zaragoza,61,964724,206969,757755,804664,139358
2020/06/12,Tarragona,Teruel,73,134137,13309,120828,804664,139358
2020/06/12,Tarragona,Castellón,951,579962,98892,481070,804664,139358
2020/06/12,Teruel,Teruel,8471,134137,13309,120828,134137,15329
2020/06/12,Teruel,Guadalajara,23,257762,42884,214878,134137,15329
2020/06/12,Teruel,Tarragona,129,804664,138875,665789,134137,15329
2020/06/12,Teruel,Valencia,26,2565124,546659,2018465,134137,15329
2020/06/12,Teruel,Castellón,56,579962,98892,481070,134137,15329
2020/06/12,Teruel,Zaragoza,467,964724,206969,757755,134137,15329
2020/06/12,Toledo,Ávila,257,157640,21007,136633,694844,97012
2020/06/12,Toledo,Cuenca,70,196329,23337,172992,694844,97012
2020/06/12,Toledo,Toledo,53192,694844,100922,593922,694844,97012
2020/06/12,Toledo,Cáceres,97,394151,53061,341090,694844,97012
2020/06/12,Toledo,Ciudad Real,327,495761,53864,441897,694844,97012
2020/06/12,Toledo,Madrid,3937,6663394,1296869,5366525,694844,97012
2020/06/12,Valencia,Albacete,288,388167,43296,344871,2565124,539445
2020/06/12,Valencia,Alicante,1651,1858683,356900,1501783,2565124,539445
2020/06/12,Valencia,Cuenca,125,196329,23337,172992,2565124,539445
2020/06/12,Valencia,Castellón,811,579962,98892,481070,2565124,539445
2020/06/12,Valencia,Cáceres,23,394151,53061,341090,2565124,539445
2020/06/12,Valencia,Valencia,425514,2565124,546659,2018465,2565124,539445
2020/06/12,Valladolid,Ávila,28,157640,21007,136633,519546,99443
2020/06/12,Valladolid,Zamora,163,172539,24593,147946,519546,99443
2020/06/12,Valladolid,Burgos,127,357072,54112,302960,519546,99443
2020/06/12,Valladolid,Valladolid,80744,519546,102495,417051,519546,99443
2020/06/12,Valladolid,Soria,22,88636,9926,78710,519546,99443
2020/06/12,Valladolid,León,58,460001,78386,381615,519546,99443
2020/06/12,Valladolid,Segovia,316,153129,22883,130246,519546,99443
2020/06/12,Valladolid,Palencia,92,160866,26334,134532,519546,99443
2020/06/12,Zamora,León,89,460001,78386,381615,172539,24814
2020/06/12,Zamora,Zamora,17769,172539,24593,147946,172539,24814
2020/06/12,Zamora,Valladolid,113,519546,102495,417051,172539,24814
2020/06/12,Zamora,Salamanca,54,330119,45549,284570,172539,24814
2020/06/12,Zamora,Ourense,101,307651,58719,248932,172539,24814
2020/06/12,Zaragoza,Soria,98,88636,9926,78710,964724,198639
2020/06/12,Zaragoza,Teruel,355,134137,13309,120828,964724,198639
2020/06/12,Zaragoza,Zaragoza,166724,964724,206969,757755,964724,198639
2020/06/12,Zaragoza,Navarra,578,654183,124410,529773,964724,198639
2020/06/12,Zaragoza,Lleida,142,434930,77023,357907,964724,198639
2020/06/12,Zaragoza,Huesca,319,220461,34366,186095,964724,198639
2020/06/12,Zaragoza,Tarragona,44,804664,138875,665789,964724,198639
2020/06/13,Albacete,Alicante,184,1858683,325381,1533302,388167,42209
2020/06/13,Albacete,Jaén,67,633564,81638,551926,388167,42209
2020/06/13,Albacete,Murcia,628,1493898,253319,1240579,388167,42209
2020/06/13,Albacete,Valencia,289,2565124,506091,2059033,388167,42209
2020/06/13,Albacete,Ciudad Real,628,495761,46954,448807,388167,42209
2020/06/13,Albacete,Albacete,29085,388167,40472,347695,388167,42209
2020/06/13,Albacete,Cuenca,538,196329,20870,175459,388167,42209
2020/06/13,Alicante,Albacete,249,388167,40472,347695,1858683,329878
2020/06/13,Alicante,Valencia,1571,2565124,506091,2059033,1858683,329878
2020/06/13,Alicante,Alicante,265896,1858683,325381,1533302,1858683,329878
2020/06/13,Alicante,Murcia,3563,1493898,253319,1240579,1858683,329878
2020/06/13,Almería,Murcia,1367,1493898,253319,1240579,716820,106897
2020/06/13,Almería,Almería,85048,716820,106911,609909,716820,106897
2020/06/13,Almería,Granada,709,914678,156621,758057,716820,106897
2020/06/13,Araba,Gipuzkoa,750,723576,114949,608627,331549,66990
2020/06/13,Araba,Rioja,1274,316798,48101,268697,331549,66990
2020/06/13,Araba,Burgos,1064,357072,46727,310345,331549,66990
2020/06/13,Araba,Navarra,154,654183,106977,547206,331549,66990
2020/06/13,Araba,Bizkaia,1819,1152934,225169,927765,331549,66990
2020/06/13,Araba,Araba,49138,331549,63182,268367,331549,66990
2020/06/13,Asturias,Cantabria,222,580795,98004,482791,1022800,167076
2020/06/13,Asturias,León,35,460001,67100,392901,1022800,167076
2020/06/13,Asturias,Asturias,139544,1022800,167154,855646,1022800,167076
2020/06/13,Asturias,Lugo,864,329587,44799,284788,1022800,167076
2020/06/13,Ávila,Salamanca,280,330119,45295,284824,157640,20500
2020/06/13,Ávila,Madrid,263,6663394,1196981,5466413,157640,20500
2020/06/13,Ávila,Ávila,12648,157640,17695,139945,157640,20500
2020/06/13,Ávila,Toledo,262,694844,83037,611807,157640,20500
2020/06/13,Ávila,Cáceres,145,394151,45856,348295,157640,20500
2020/06/13,Ávila,Segovia,81,153129,19758,133371,157640,20500
2020/06/13,Ávila,Valladolid,59,519546,81255,438291,157640,20500
2020/06/13,Badajoz,Córdoba,99,782979,123417,659562,673559,87968
2020/06/13,Badajoz,Cáceres,1059,394151,45856,348295,673559,87968
2020/06/13,Badajoz,Sevilla,79,1942389,326777,1615612,673559,87968
2020/06/13,Badajoz,Huelva,202,521870,77558,444312,673559,87968
2020/06/13,Badajoz,Ciudad Real,57,495761,46954,448807,673559,87968
2020/06/13,Badajoz,Badajoz,67933,673559,88594,584965,673559,87968
2020/06/13,Balears,Balears,178152,1149460,196863,952597,1149460,197537
2020/06/13,Balears,Valencia,23,2565124,506091,2059033,1149460,197537
2020/06/13,Barcelona,Barcelona,749255,5664579,1150994,4513585,5664579,1138363
2020/06/13,Barcelona,Tarragona,2036,804664,129421,675243,5664579,1138363
2020/06/13,Barcelona,Girona,3344,771044,113233,657811,5664579,1138363
2020/06/13,Barcelona,Lleida,310,434930,66693,368237,5664579,1138363
2020/06/13,Bizkaia,Cantabria,1072,580795,98004,482791,1152934,219075
2020/06/13,Bizkaia,Araba,1690,331549,63182,268367,1152934,219075
2020/06/13,Bizkaia,Bizkaia,173412,1152934,225169,927765,1152934,219075
2020/06/13,Bizkaia,Gipuzkoa,1224,723576,114949,608627,1152934,219075
2020/06/13,Bizkaia,Burgos,28,357072,46727,310345,1152934,219075
2020/06/13,Burgos,Bizkaia,170,1152934,225169,927765,357072,49335
2020/06/13,Burgos,Valladolid,81,519546,81255,438291,357072,49335
2020/06/13,Burgos,Burgos,37285,357072,46727,310345,357072,49335
2020/06/13,Burgos,Palencia,217,160866,22552,138314,357072,49335
2020/06/13,Burgos,Araba,2028,331549,63182,268367,357072,49335
2020/06/13,Burgos,Segovia,18,153129,19758,133371,357072,49335
2020/06/13,Burgos,Rioja,41,316798,48101,268697,357072,49335
2020/06/13,Burgos,Cantabria,33,580795,98004,482791,357072,49335
2020/06/13,Cáceres,Badajoz,1032,673559,88594,584965,394151,45916
2020/06/13,Cáceres,Cáceres,32512,394151,45856,348295,394151,45916
2020/06/13,Cáceres,Ávila,132,157640,17695,139945,394151,45916
2020/06/13,Cáceres,Toledo,200,694844,83037,611807,394151,45916
2020/06/13,Cádiz,Ceuta,127,84777,9604,75173,1240155,229991
2020/06/13,Cádiz,Córdoba,16,782979,123417,659562,1240155,229991
2020/06/13,Cádiz,Sevilla,3854,1942389,326777,1615612,1240155,229991
2020/06/13,Cádiz,Málaga,2373,1661785,285180,1376605,1240155,229991
2020/06/13,Cádiz,Cádiz,177214,1240155,213291,1026864,1240155,229991
2020/06/13,Cádiz,Huelva,764,521870,77558,444312,1240155,229991
2020/06/13,Cantabria,Cantabria,78365,580795,98004,482791,580795,97635
2020/06/13,Cantabria,Bizkaia,1160,1152934,225169,927765,580795,97635
2020/06/13,Cantabria,Palencia,77,160866,22552,138314,580795,97635
2020/06/13,Cantabria,Asturias,217,1022800,167154,855646,580795,97635
2020/06/13,Castellón,Valencia,1075,2565124,506091,2059033,579962,87592
2020/06/13,Castellón,Castellón,68376,579962,85418,494544,579962,87592
2020/06/13,Castellón,Teruel,79,134137,12482,121655,579962,87592
2020/06/13,Castellón,Tarragona,909,804664,129421,675243,579962,87592
2020/06/13,Ceuta,Ceuta,8939,84777,9604,75173,84777,9350
2020/06/13,Ceuta,Cádiz,38,1240155,213291,1026864,84777,9350
2020/06/13,Ciudad Real,Badajoz,73,673559,88594,584965,495761,46862
2020/06/13,Ciudad Real,Albacete,475,388167,40472,347695,495761,46862
2020/06/13,Ciudad Real,Córdoba,433,782979,123417,659562,495761,46862
2020/06/13,Ciudad Real,Toledo,346,694844,83037,611807,495761,46862
2020/06/13,Ciudad Real,Cuenca,34,196329,20870,175459,495761,46862
2020/06/13,Ciudad Real,Ciudad Real,32239,495761,46954,448807,495761,46862
2020/06/13,Córdoba,Sevilla,2157,1942389,326777,1615612,782979,121487
2020/06/13,Córdoba,Ciudad Real,257,495761,46954,448807,782979,121487
2020/06/13,Córdoba,Córdoba,84930,782979,123417,659562,782979,121487
2020/06/13,Córdoba,Badajoz,105,673559,88594,584965,782979,121487
2020/06/13,Córdoba,Granada,148,914678,156621,758057,782979,121487
2020/06/13,Córdoba,Jaén,791,633564,81638,551926,782979,121487
2020/06/13,Córdoba,Málaga,371,1661785,285180,1376605,782979,121487
2020/06/13,Coruña,Lugo,963,329587,44799,284788,1119596,182762
2020/06/13,Coruña,Ourense,20,307651,51045,256606,1119596,182762
2020/06/13,Coruña,Pontevedra,5299,942665,157285,785380,1119596,182762
2020/06/13,Coruña,Coruña,132920,1119596,181458,938138,1119596,182762
2020/06/13,Cuenca,Valencia,121,2565124,506091,2059033,196329,23024
2020/06/13,Cuenca,Guadalajara,106,257762,38804,218958,196329,23024
2020/06/13,Cuenca,Albacete,873,388167,40472,347695,196329,23024
2020/06/13,Cuenca,Madrid,26,6663394,1196981,5466413,196329,23024
2020/06/13,Cuenca,Toledo,149,694844,83037,611807,196329,23024
2020/06/13,Cuenca,Ciudad Real,111,495761,46954,448807,196329,23024
2020/06/13,Cuenca,Cuenca,13100,196329,20870,175459,196329,23024
2020/06/13,Gipuzkoa,Gipuzkoa,85886,723576,114949,608627,723576,115481
2020/06/13,Gipuzkoa,Navarra,251,654183,106977,547206,723576,115481
2020/06/13,Gipuzkoa,Araba,285,331549,63182,268367,723576,115481
2020/06/13,Gipuzkoa,Bizkaia,1486,1152934,225169,927765,723576,115481
2020/06/13,Girona,Girona,79507,771044,113233,657811,771044,121446
2020/06/13,Girona,Barcelona,3134,5664579,1150994,4513585,771044,121446
2020/06/13,Girona,Lleida,195,434930,66693,368237,771044,121446
2020/06/13,Granada,Murcia,96,1493898,253319,1240579,914678,160490
2020/06/13,Granada,Córdoba,264,782979,123417,659562,914678,160490
2020/06/13,Granada,Granada,110820,914678,156621,758057,914678,160490
2020/06/13,Granada,Almería,1421,716820,106911,609909,914678,160490
2020/06/13,Granada,Jaén,650,633564,81638,551926,914678,160490
2020/06/13,Granada,Málaga,547,1661785,285180,1376605,914678,160490
2020/06/13,Guadalajara,Teruel,23,134137,12482,121655,257762,42366
2020/06/13,Guadalajara,Guadalajara,26866,257762,38804,218958,257762,42366
2020/06/13,Guadalajara,Madrid,2091,6663394,1196981,5466413,257762,42366
2020/06/13,Guadalajara,Cuenca,64,196329,20870,175459,257762,42366
2020/06/13,Huelva,Córdoba,16,782979,123417,659562,521870,87958
2020/06/13,Huelva,Sevilla,3881,1942389,326777,1615612,521870,87958
2020/06/13,Huelva,Cádiz,722,1240155,213291,1026864,521870,87958
2020/06/13,Huelva,Huelva,58983,521870,77558,444312,521870,87958
2020/06/13,Huelva,Badajoz,337,673559,88594,584965,521870,87958
2020/06/13,Huesca,Huesca,22469,220461,32327,188134,220461,41543
2020/06/13,Huesca,Lleida,849,434930,66693,368237,220461,41543
2020/06/13,Huesca,Zaragoza,4631,964724,183728,780996,220461,41543
2020/06/13,Jaén,Jaén,55056,633564,81638,551926,633564,80675
2020/06/13,Jaén,Granada,547,914678,156621,758057,633564,80675
2020/06/13,Jaén,Córdoba,942,782979,123417,659562,633564,80675
2020/06/13,Las Palmas de Gran Canaria,Santa Cruz de Tenerife,64,1032983,180450,852533,1120406,191197
2020/06/13,Las Palmas de Gran Canaria,Las Palmas de Gran Canaria,178274,1120406,192408,927998,1120406,191197
2020/06/13,León,León,52136,460001,67100,392901,460001,67296
2020/06/13,León,Ourense,165,307651,51045,256606,460001,67296
2020/06/13,León,Zamora,72,172539,20595,151944,460001,67296
2020/06/13,León,Valladolid,30,519546,81255,438291,460001,67296
2020/06/13,León,Asturias,63,1022800,167154,855646,460001,67296
2020/06/13,Lleida,Tarragona,60,804664,129421,675243,434930,66094
2020/06/13,Lleida,Zaragoza,134,964724,183728,780996,434930,66094
2020/06/13,Lleida,Girona,310,771044,113233,657811,434930,66094
2020/06/13,Lleida,Barcelona,551,5664579,1150994,4513585,434930,66094
2020/06/13,Lleida,Lleida,47336,434930,66693,368237,434930,66094
2020/06/13,Lleida,Huesca,628,220461,32327,188134,434930,66094
2020/06/13,Lugo,Ourense,254,307651,51045,256606,329587,48583
2020/06/13,Lugo,Coruña,776,1119596,181458,938138,329587,48583
2020/06/13,Lugo,Asturias,706,1022800,167154,855646,329587,48583
2020/06/13,Lugo,Lugo,30407,329587,44799,284788,329587,48583
2020/06/13,Madrid,Guadalajara,2105,257762,38804,218958,6663394,1177947
2020/06/13,Madrid,Cuenca,111,196329,20870,175459,6663394,1177947
2020/06/13,Madrid,Ávila,378,157640,17695,139945,6663394,1177947
2020/06/13,Madrid,Toledo,3220,694844,83037,611807,6663394,1177947
2020/06/13,Madrid,Madrid,720388,6663394,1196981,5466413,6663394,1177947
2020/06/13,Madrid,Córdoba,16,782979,123417,659562,6663394,1177947
2020/06/13,Málaga,Sevilla,314,1942389,326777,1615612,1661785,287028
2020/06/13,Málaga,Almería,17,716820,106911,609909,1661785,287028
2020/06/13,Málaga,Granada,806,914678,156621,758057,1661785,287028
2020/06/13,Málaga,Málaga,226943,1661785,285180,1376605,1661785,287028
2020/06/13,Málaga,Córdoba,537,782979,123417,659562,1661785,287028
2020/06/13,Málaga,Cádiz,2125,1240155,213291,1026864,1661785,287028
2020/06/13,Melilla,Melilla,14504,86487,14703,71784,86487,14730
2020/06/13,Murcia,Albacete,306,388167,40472,347695,1493898,248978
2020/06/13,Murcia,Almería,1081,716820,106911,609909,1493898,248978
2020/06/13,Murcia,Alicante,2591,1858683,325381,1533302,1493898,248978
2020/06/13,Murcia,Granada,21,914678,156621,758057,1493898,248978
2020/06/13,Murcia,Murcia,210081,1493898,253319,1240579,1493898,248978
2020/06/13,Navarra,Zaragoza,550,964724,183728,780996,654183,106469
2020/06/13,Navarra,Navarra,80729,654183,106977,547206,654183,106469
2020/06/13,Navarra,Rioja,1252,316798,48101,268697,654183,106469
2020/06/13,Navarra,Araba,83,331549,63182,268367,654183,106469
2020/06/13,Navarra,Gipuzkoa,301,723576,114949,608627,654183,106469
2020/06/13,Ourense,Lugo,297,329587,44799,284788,307651,53774
2020/06/13,Ourense,León,125,460001,67100,392901,307651,53774
2020/06/13,Ourense,Ourense,38245,307651,51045,256606,307651,53774
2020/06/13,Ourense,Pontevedra,324,942665,157285,785380,307651,53774
2020/06/13,Palencia,Valladolid,155,519546,81255,438291,160866,23155
2020/06/13,Palencia,Cantabria,120,580795,98004,482791,160866,23155
2020/06/13,Palencia,Palencia,17046,160866,22552,138314,160866,23155
2020/06/13,Palencia,Burgos,196,357072,46727,310345,160866,23155
2020/06/13,Pontevedra,Ourense,277,307651,51045,256606,942665,154280
2020/06/13,Pontevedra,Lugo,39,329587,44799,284788,942665,154280
2020/06/13,Pontevedra,Pontevedra,115865,942665,157285,785380,942665,154280
2020/06/13,Pontevedra,Coruña,4585,1119596,181458,938138,942665,154280
2020/06/13,Rioja,Burgos,33,357072,46727,310345,316798,47730
2020/06/13,Rioja,Araba,582,331549,63182,268367,316798,47730
2020/06/13,Rioja,Rioja,39118,316798,48101,268697,316798,47730
2020/06/13,Rioja,Navarra,1370,654183,106977,547206,316798,47730
2020/06/13,Salamanca,Cantabria,16,580795,98004,482791,330119,45758
2020/06/13,Salamanca,Ávila,238,157640,17695,139945,330119,45758
2020/06/13,Salamanca,Salamanca,36606,330119,45295,284824,330119,45758
2020/06/13,Santa Cruz de Tenerife,Santa Cruz de Tenerife,163994,1032983,180450,852533,1032983,180969
2020/06/13,Santa Cruz de Tenerife,Las Palmas de Gran Canaria,78,1120406,192408,927998,1032983,180969
2020/06/13,Segovia,Valladolid,292,519546,81255,438291,153129,22586
2020/06/13,Segovia,Segovia,14291,153129,19758,133371,153129,22586
2020/06/13,Segovia,Burgos,125,357072,46727,310345,153129,22586
2020/06/13,Segovia,Ávila,78,157640,17695,139945,153129,22586
2020/06/13,Sevilla,Sevilla,210803,1942389,326777,1615612,1942389,300997
2020/06/13,Sevilla,Córdoba,2449,782979,123417,659562,1942389,300997
2020/06/13,Sevilla,Cádiz,1342,1240155,213291,1026864,1942389,300997
2020/06/13,Sevilla,Málaga,99,1661785,285180,1376605,1942389,300997
2020/06/13,Sevilla,Huelva,820,521870,77558,444312,1942389,300997
2020/06/13,Sevilla,Badajoz,87,673559,88594,584965,1942389,300997
2020/06/13,Soria,Soria,6693,88636,8230,80406,88636,8757
2020/06/13,Soria,Burgos,58,357072,46727,310345,88636,8757
2020/06/13,Soria,Valladolid,56,519546,81255,438291,88636,8757
2020/06/13,Soria,Zaragoza,16,964724,183728,780996,88636,8757
2020/06/13,Soria,Segovia,18,153129,19758,133371,88636,8757
2020/06/13,Tarragona,Castellón,657,579962,85418,494544,804664,133643
2020/06/13,Tarragona,Teruel,84,134137,12482,121655,804664,133643
2020/06/13,Tarragona,Barcelona,2418,5664579,1150994,4513585,804664,133643
2020/06/13,Tarragona,Lleida,53,434930,66693,368237,804664,133643
2020/06/13,Tarragona,Tarragona,94069,804664,129421,675243,804664,133643
2020/06/13,Tarragona,Zaragoza,37,964724,183728,780996,804664,133643
2020/06/13,Teruel,Teruel,7672,134137,12482,121655,134137,17741
2020/06/13,Teruel,Valencia,41,2565124,506091,2059033,134137,17741
2020/06/13,Teruel,Tarragona,91,804664,129421,675243,134137,17741
2020/06/13,Teruel,Zaragoza,2124,964724,183728,780996,134137,17741
2020/06/13,Teruel,Castellón,40,579962,85418,494544,134137,17741
2020/06/13,Toledo,Ciudad Real,232,495761,46954,448807,694844,88574
2020/06/13,Toledo,Cáceres,257,394151,45856,348295,694844,88574
2020/06/13,Toledo,Madrid,3297,6663394,1196981,5466413,694844,88574
2020/06/13,Toledo,Toledo,48040,694844,83037,611807,694844,88574
2020/06/13,Toledo,Ávila,290,157640,17695,139945,694844,88574
2020/06/13,Toledo,Cuenca,60,196329,20870,175459,694844,88574
2020/06/13,Valencia,Alicante,1271,1858683,325381,1533302,2565124,499243
2020/06/13,Valencia,Albacete,261,388167,40472,347695,2565124,499243
2020/06/13,Valencia,Cuenca,117,196329,20870,175459,2565124,499243
2020/06/13,Valencia,Castellón,715,579962,85418,494544,2565124,499243
2020/06/13,Valencia,Cáceres,19,394151,45856,348295,2565124,499243
2020/06/13,Valencia,Teruel,50,134137,12482,121655,2565124,499243
2020/06/13,Valencia,Valencia,382558,2565124,506091,2059033,2565124,499243
2020/06/13,Valladolid,Soria,23,88636,8230,80406,519546,79164
2020/06/13,Valladolid,Segovia,333,153129,19758,133371,519546,79164
2020/06/13,Valladolid,Burgos,114,357072,46727,310345,519546,79164
2020/06/13,Valladolid,León,51,460001,67100,392901,519546,79164
2020/06/13,Valladolid,Ávila,32,157640,17695,139945,519546,79164
2020/06/13,Valladolid,Zamora,109,172539,20595,151944,519546,79164
2020/06/13,Valladolid,Palencia,60,160866,22552,138314,519546,79164
2020/06/13,Valladolid,Valladolid,63717,519546,81255,438291,519546,79164
2020/06/13,Zamora,Salamanca,37,330119,45295,284824,172539,20665
2020/06/13,Zamora,Valladolid,89,519546,81255,438291,172539,20665
2020/06/13,Zamora,Zamora,15164,172539,20595,151944,172539,20665
2020/06/13,Zamora,León,26,460001,67100,392901,172539,20665
2020/06/13,Zaragoza,Soria,50,88636,8230,80406,964724,167647
2020/06/13,Zaragoza,Huesca,742,220461,32327,188134,964724,167647
2020/06/13,Zaragoza,Lleida,97,434930,66693,368237,964724,167647
2020/06/13,Zaragoza,Teruel,274,134137,12482,121655,964724,167647
2020/06/13,Zaragoza,Zaragoza,135015,964724,183728,780996,964724,167647
2020/06/13,Zaragoza,Tarragona,34,804664,129421,675243,964724,167647
2020/06/13,Zaragoza,Navarra,520,654183,106977,547206,964724,167647
2020/06/14,Albacete,Cuenca,486,196329,17616,178713,388167,33356
2020/06/14,Albacete,Ciudad Real,467,495761,38784,456977,388167,33356
2020/06/14,Albacete,Valencia,237,2565124,444259,2120865,388167,33356
2020/06/14,Albacete,Albacete,22951,388167,32753,355414,388167,33356
2020/06/14,Albacete,Murcia,318,1493898,213723,1280175,388167,33356
2020/06/14,Albacete,Jaén,97,633564,71613,561951,388167,33356
2020/06/14,Albacete,Alicante,255,1858683,291731,1566952,388167,33356
2020/06/14,Alicante,Albacete,289,388167,32753,355414,1858683,293563
2020/06/14,Alicante,Alicante,237018,1858683,291731,1566952,1858683,293563
2020/06/14,Alicante,Valencia,1736,2565124,444259,2120865,1858683,293563
2020/06/14,Alicante,Murcia,2615,1493898,213723,1280175,1858683,293563
2020/06/14,Almería,Almería,70604,716820,91708,625112,716820,87852
2020/06/14,Almería,Murcia,1022,1493898,213723,1280175,716820,87852
2020/06/14,Almería,Granada,494,914678,138045,776633,716820,87852
2020/06/14,Araba,Navarra,194,654183,98690,555493,331549,63953
2020/06/14,Araba,Burgos,1067,357072,40317,316755,331549,63953
2020/06/14,Araba,Rioja,1232,316798,44625,272173,331549,63953
2020/06/14,Araba,Bizkaia,2645,1152934,209943,942991,331549,63953
2020/06/14,Araba,Gipuzkoa,669,723576,112097,611479,331549,63953
2020/06/14,Araba,Araba,46700,331549,59207,272342,331549,63953
2020/06/14,Asturias,León,25,460001,56284,403717,1022800,153185
2020/06/14,Asturias,Asturias,126832,1022800,153463,869337,1022800,153185
2020/06/14,Asturias,Cantabria,279,580795,90698,490097,1022800,153185
2020/06/14,Asturias,Lugo,846,329587,39576,290011,1022800,153185
2020/06/14,Ávila,Salamanca,230,330119,40500,289619,157640,16545
2020/06/14,Ávila,Cáceres,107,394151,39210,354941,157640,16545
2020/06/14,Ávila,Ávila,11027,157640,15465,142175,157640,16545
2020/06/14,Ávila,Toledo,239,694844,67533,627311,157640,16545
2020/06/14,Ávila,Valladolid,42,519546,68409,451137,157640,16545
2020/06/14,Ávila,Madrid,164,6663394,1034626,5628768,157640,16545
2020/06/14,Ávila,Segovia,91,153129,16897,136232,157640,16545
2020/06/14,Badajoz,Cáceres,773,394151,39210,354941,673559,75282
2020/06/14,Badajoz,Huelva,184,521870,66140,455730,673559,75282
2020/06/14,Badajoz,Córdoba,80,782979,103348,679631,673559,75282
2020/06/14,Badajoz,Ciudad Real,59,495761,38784,456977,673559,75282
2020/06/14,Badajoz,Badajoz,59261,673559,76457,597102,673559,75282
2020/06/14,Badajoz,Sevilla,47,1942389,256014,1686375,673559,75282
2020/06/14,Balears,Balears,165860,1149460,183339,966121,1149460,182998
2020/06/14,Barcelona,Barcelona,626052,5664579,986450,4678129,5664579,982532
2020/06/14,Barcelona,Tarragona,1555,804664,117259,687405,5664579,982532
2020/06/14,Barcelona,Lleida,296,434930,58255,376675,5664579,982532
2020/06/14,Barcelona,Girona,3435,771044,112272,658772,5664579,982532
2020/06/14,Bizkaia,Cantabria,774,580795,90698,490097,1152934,201844
2020/06/14,Bizkaia,Gipuzkoa,1086,723576,112097,611479,1152934,201844
2020/06/14,Bizkaia,Araba,1294,331549,59207,272342,1152934,201844
2020/06/14,Bizkaia,Bizkaia,162442,1152934,209943,942991,1152934,201844
2020/06/14,Burgos,Cantabria,78,580795,90698,490097,357072,43210
2020/06/14,Burgos,Palencia,186,160866,19476,141390,357072,43210
2020/06/14,Burgos,Araba,2142,331549,59207,272342,357072,43210
2020/06/14,Burgos,Soria,46,88636,7638,80998,357072,43210
2020/06/14,Burgos,Burgos,32303,357072,40317,316755,357072,43210
2020/06/14,Burgos,Valladolid,118,519546,68409,451137,357072,43210
2020/06/14,Burgos,Segovia,17,153129,16897,136232,357072,43210
2020/06/14,Burgos,Bizkaia,82,1152934,209943,942991,357072,43210
2020/06/14,Cáceres,Badajoz,872,673559,76457,597102,394151,39310
2020/06/14,Cáceres,Toledo,139,694844,67533,627311,394151,39310
2020/06/14,Cáceres,Cáceres,28012,394151,39210,354941,394151,39310
2020/06/14,Cáceres,Ávila,143,157640,15465,142175,394151,39310
2020/06/14,Cádiz,Huelva,646,521870,66140,455730,1240155,190364
2020/06/14,Cádiz,Málaga,1833,1661785,241489,1420296,1240155,190364
2020/06/14,Cádiz,Sevilla,1287,1942389,256014,1686375,1240155,190364
2020/06/14,Cádiz,Ceuta,60,84777,8424,76353,1240155,190364
2020/06/14,Cádiz,Cádiz,151885,1240155,186377,1053778,1240155,190364
2020/06/14,Cantabria,Burgos,23,357072,40317,316755,580795,90650
2020/06/14,Cantabria,Palencia,63,160866,19476,141390,580795,90650
2020/06/14,Cantabria,Bizkaia,1588,1152934,209943,942991,580795,90650
2020/06/14,Cantabria,Asturias,226,1022800,153463,869337,580795,90650
2020/06/14,Cantabria,Cantabria,73404,580795,90698,490097,580795,90650
2020/06/14,Castellón,Tarragona,653,804664,117259,687405,579962,78256
2020/06/14,Castellón,Castellón,61310,579962,75808,504154,579962,78256
2020/06/14,Castellón,Valencia,1106,2565124,444259,2120865,579962,78256
2020/06/14,Ceuta,Ceuta,7871,84777,8424,76353,84777,8281
2020/06/14,Ceuta,Cádiz,29,1240155,186377,1053778,84777,8281
2020/06/14,Ciudad Real,Ciudad Real,26150,495761,38784,456977,495761,37806
2020/06/14,Ciudad Real,Córdoba,393,782979,103348,679631,495761,37806
2020/06/14,Ciudad Real,Cuenca,32,196329,17616,178713,495761,37806
2020/06/14,Ciudad Real,Toledo,162,694844,67533,627311,495761,37806
2020/06/14,Ciudad Real,Badajoz,51,673559,76457,597102,495761,37806
2020/06/14,Ciudad Real,Albacete,464,388167,32753,355414,495761,37806
2020/06/14,Córdoba,Córdoba,70991,782979,103348,679631,782979,100904
2020/06/14,Córdoba,Jaén,766,633564,71613,561951,782979,100904
2020/06/14,Córdoba,Badajoz,213,673559,76457,597102,782979,100904
2020/06/14,Córdoba,Ciudad Real,231,495761,38784,456977,782979,100904
2020/06/14,Córdoba,Granada,114,914678,138045,776633,782979,100904
2020/06/14,Córdoba,Málaga,267,1661785,241489,1420296,782979,100904
2020/06/14,Córdoba,Sevilla,1838,1942389,256014,1686375,782979,100904
2020/06/14,Coruña,Pontevedra,4557,942665,131361,811304,1119596,153210
2020/06/14,Coruña,Lugo,537,329587,39576,290011,1119596,153210
2020/06/14,Coruña,Coruña,110964,1119596,152784,966812,1119596,153210
2020/06/14,Cuenca,Albacete,767,388167,32753,355414,196329,18862
2020/06/14,Cuenca,Guadalajara,114,257762,32253,225509,196329,18862
2020/06/14,Cuenca,Madrid,37,6663394,1034626,5628768,196329,18862
2020/06/14,Cuenca,Ciudad Real,46,495761,38784,456977,196329,18862
2020/06/14,Cuenca,Toledo,67,694844,67533,627311,196329,18862
2020/06/14,Cuenca,Cuenca,11054,196329,17616,178713,196329,18862
2020/06/14,Cuenca,Valencia,123,2565124,444259,2120865,196329,18862
2020/06/14,Gipuzkoa,Navarra,275,654183,98690,555493,723576,113631
2020/06/14,Gipuzkoa,Gipuzkoa,86178,723576,112097,611479,723576,113631
2020/06/14,Gipuzkoa,Araba,420,331549,59207,272342,723576,113631
2020/06/14,Gipuzkoa,Bizkaia,1470,1152934,209943,942991,723576,113631
2020/06/14,Girona,Lleida,202,434930,58255,376675,771044,116314
2020/06/14,Girona,Girona,78115,771044,112272,658772,771044,116314
2020/06/14,Girona,Barcelona,2934,5664579,986450,4678129,771044,116314
2020/06/14,Granada,Jaén,615,633564,71613,561951,914678,140189
2020/06/14,Granada,Almería,2182,716820,91708,625112,914678,140189
2020/06/14,Granada,Granada,96320,914678,138045,776633,914678,140189
2020/06/14,Granada,Córdoba,306,782979,103348,679631,914678,140189
2020/06/14,Granada,Murcia,54,1493898,213723,1280175,914678,140189
2020/06/14,Granada,Málaga,519,1661785,241489,1420296,914678,140189
2020/06/14,Guadalajara,Teruel,22,134137,10483,123654,257762,34205
2020/06/14,Guadalajara,Cuenca,76,196329,17616,178713,257762,34205
2020/06/14,Guadalajara,Madrid,1523,6663394,1034626,5628768,257762,34205
2020/06/14,Guadalajara,Guadalajara,22055,257762,32253,225509,257762,34205
2020/06/14,Huelva,Badajoz,328,673559,76457,597102,521870,68568
2020/06/14,Huelva,Sevilla,1480,1942389,256014,1686375,521870,68568
2020/06/14,Huelva,Huelva,47444,521870,66140,455730,521870,68568
2020/06/14,Huelva,Cádiz,636,1240155,186377,1053778,521870,68568
2020/06/14,Huesca,Lleida,675,434930,58255,376675,220461,37337
2020/06/14,Huesca,Huesca,22064,220461,30233,190228,220461,37337
2020/06/14,Huesca,Zaragoza,2822,964724,151822,812902,220461,37337
2020/06/14,Jaén,Albacete,32,388167,32753,355414,633564,70441
2020/06/14,Jaén,Almería,17,716820,91708,625112,633564,70441
2020/06/14,Jaén,Córdoba,863,782979,103348,679631,633564,70441
2020/06/14,Jaén,Navarra,22,654183,98690,555493,633564,70441
2020/06/14,Jaén,Granada,508,914678,138045,776633,633564,70441
2020/06/14,Jaén,Jaén,49125,633564,71613,561951,633564,70441
2020/06/14,Las Palmas de Gran Canaria,Santa Cruz de Tenerife,24,1032983,153784,879199,1120406,164685
2020/06/14,Las Palmas de Gran Canaria,Las Palmas de Gran Canaria,152626,1120406,165615,954791,1120406,164685
2020/06/14,León,León,43217,460001,56284,403717,460001,56238
2020/06/14,León,Ourense,64,307651,43930,263721,460001,56238
2020/06/14,León,Zamora,72,172539,16907,155632,460001,56238
2020/06/14,León,Valladolid,29,519546,68409,451137,460001,56238
2020/06/14,León,Asturias,99,1022800,153463,869337,460001,56238
2020/06/14,Lleida,Girona,313,771044,112272,658772,434930,57754
2020/06/14,Lleida,Barcelona,531,5664579,986450,4678129,434930,57754
2020/06/14,Lleida,Huesca,501,220461,30233,190228,434930,57754
2020/06/14,Lleida,Zaragoza,92,964724,151822,812902,434930,57754
2020/06/14,Lleida,Lleida,41665,434930,58255,376675,434930,57754
2020/06/14,Lleida,Tarragona,126,804664,117259,687405,434930,57754
2020/06/14,Lugo,Ourense,355,307651,43930,263721,329587,41978
2020/06/14,Lugo,Coruña,586,1119596,152784,966812,329587,41978
2020/06/14,Lugo,Lugo,27239,329587,39576,290011,329587,41978
2020/06/14,Lugo,Asturias,621,1022800,153463,869337,329587,41978
2020/06/14,Madrid,Valencia,17,2565124,444259,2120865,6663394,1029760
2020/06/14,Madrid,Cuenca,105,196329,17616,178713,6663394,1029760
2020/06/14,Madrid,Ávila,299,157640,15465,142175,6663394,1029760
2020/06/14,Madrid,Guadalajara,1638,257762,32253,225509,6663394,1029760
2020/06/14,Madrid,Toledo,2541,694844,67533,627311,6663394,1029760
2020/06/14,Madrid,Madrid,616858,6663394,1034626,5628768,6663394,1029760
2020/06/14,Málaga,Cádiz,2093,1240155,186377,1053778,1661785,241898
2020/06/14,Málaga,Córdoba,293,782979,103348,679631,1661785,241898
2020/06/14,Málaga,Sevilla,163,1942389,256014,1686375,1661785,241898
2020/06/14,Málaga,Málaga,191155,1661785,241489,1420296,1661785,241898
2020/06/14,Málaga,Granada,620,914678,138045,776633,1661785,241898
2020/06/14,Málaga,Almería,17,716820,91708,625112,1661785,241898
2020/06/14,Melilla,Melilla,12570,86487,12684,73803,86487,12638
2020/06/14,Murcia,Alicante,2245,1858683,291731,1566952,1493898,210599
2020/06/14,Murcia,Granada,32,914678,138045,776633,1493898,210599
2020/06/14,Murcia,Almería,911,716820,91708,625112,1493898,210599
2020/06/14,Murcia,Albacete,147,388167,32753,355414,1493898,210599
2020/06/14,Murcia,Murcia,177038,1493898,213723,1280175,1493898,210599
2020/06/14,Navarra,Zaragoza,392,964724,151822,812902,654183,99218
2020/06/14,Navarra,Araba,116,331549,59207,272342,654183,99218
2020/06/14,Navarra,Gipuzkoa,455,723576,112097,611479,654183,99218
2020/06/14,Navarra,Rioja,972,316798,44625,272173,654183,99218
2020/06/14,Navarra,Navarra,76153,654183,98690,555493,654183,99218
2020/06/14,Ourense,Pontevedra,250,942665,131361,811304,307651,45263
2020/06/14,Ourense,Ourense,32976,307651,43930,263721,307651,45263
2020/06/14,Ourense,Lugo,323,329587,39576,290011,307651,45263
2020/06/14,Ourense,León,138,460001,56284,403717,307651,45263
2020/06/14,Palencia,León,29,460001,56284,403717,160866,19717
2020/06/14,Palencia,Valladolid,152,519546,68409,451137,160866,19717
2020/06/14,Palencia,Burgos,152,357072,40317,316755,160866,19717
2020/06/14,Palencia,Cantabria,45,580795,90698,490097,160866,19717
2020/06/14,Palencia,Palencia,14708,160866,19476,141390,160866,19717
2020/06/14,Pontevedra,Pontevedra,96236,942665,131361,811304,942665,130698
2020/06/14,Pontevedra,Lugo,29,329587,39576,290011,942665,130698
2020/06/14,Pontevedra,Ourense,249,307651,43930,263721,942665,130698
2020/06/14,Pontevedra,Coruña,4456,1119596,152784,966812,942665,130698
2020/06/14,Rioja,Rioja,36941,316798,44625,272173,316798,43993
2020/06/14,Rioja,Navarra,1018,654183,98690,555493,316798,43993
2020/06/14,Rioja,Burgos,36,357072,40317,316755,316798,43993
2020/06/14,Rioja,Araba,414,331549,59207,272342,316798,43993
2020/06/14,Salamanca,Zamora,30,172539,16907,155632,330119,40067
2020/06/14,Salamanca,Salamanca,32459,330119,40500,289619,330119,40067
2020/06/14,Salamanca,Ávila,220,157640,15465,142175,330119,40067
2020/06/14,Salamanca,Cáceres,30,394151,39210,354941,330119,40067
2020/06/14,Santa Cruz de Tenerife,Las Palmas de Gran Canaria,65,1120406,165615,954791,1032983,153792
2020/06/14,Santa Cruz de Tenerife,Santa Cruz de Tenerife,138963,1032983,153784,879199,1032983,153792
2020/06/14,Segovia,Ávila,43,157640,15465,142175,153129,19241
2020/06/14,Segovia,Valladolid,207,519546,68409,451137,153129,19241
2020/06/14,Segovia,Madrid,18,6663394,1034626,5628768,153129,19241
2020/06/14,Segovia,Burgos,128,357072,40317,316755,153129,19241
2020/06/14,Segovia,Segovia,12172,153129,16897,136232,153129,19241
2020/06/14,Sevilla,Huelva,571,521870,66140,455730,1942389,252601
2020/06/14,Sevilla,Córdoba,2113,782979,103348,679631,1942389,252601
2020/06/14,Sevilla,Cádiz,1392,1240155,186377,1053778,1942389,252601
2020/06/14,Sevilla,Málaga,92,1661785,241489,1420296,1942389,252601
2020/06/14,Sevilla,Sevilla,168530,1942389,256014,1686375,1942389,252601
2020/06/14,Sevilla,Badajoz,93,673559,76457,597102,1942389,252601
2020/06/14,Soria,Zaragoza,42,964724,151822,812902,88636,7986
2020/06/14,Soria,Valladolid,42,519546,68409,451137,88636,7986
2020/06/14,Soria,Burgos,24,357072,40317,316755,88636,7986
2020/06/14,Soria,Soria,6318,88636,7638,80998,88636,7986
2020/06/14,Tarragona,Zaragoza,46,964724,151822,812902,804664,118732
2020/06/14,Tarragona,Lleida,30,434930,58255,376675,804664,118732
2020/06/14,Tarragona,Teruel,87,134137,10483,123654,804664,118732
2020/06/14,Tarragona,Castellón,516,579962,75808,504154,804664,118732
2020/06/14,Tarragona,Barcelona,1916,5664579,986450,4678129,804664,118732
2020/06/14,Tarragona,Tarragona,85344,804664,117259,687405,804664,118732
2020/06/14,Teruel,Zaragoza,942,964724,151822,812902,134137,13797
2020/06/14,Teruel,Tarragona,103,804664,117259,687405,134137,13797
2020/06/14,Teruel,Castellón,43,579962,75808,504154,134137,13797
2020/06/14,Teruel,Teruel,6423,134137,10483,123654,134137,13797
2020/06/14,Toledo,Ciudad Real,166,495761,38784,456977,694844,69311
2020/06/14,Toledo,Ávila,353,157640,15465,142175,694844,69311
2020/06/14,Toledo,Toledo,38612,694844,67533,627311,694844,69311
2020/06/14,Toledo,Cáceres,212,394151,39210,354941,694844,69311
2020/06/14,Toledo,Madrid,2218,6663394,1034626,5628768,694844,69311
2020/06/14,Toledo,Cuenca,25,196329,17616,178713,694844,69311
2020/06/14,Valencia,Alicante,1265,1858683,291731,1566952,2565124,439521
2020/06/14,Valencia,Albacete,184,388167,32753,355414,2565124,439521
2020/06/14,Valencia,Valencia,330195,2565124,444259,2120865,2565124,439521
2020/06/14,Valencia,Teruel,30,134137,10483,123654,2565124,439521
2020/06/14,Valencia,Castellón,714,579962,75808,504154,2565124,439521
2020/06/14,Valencia,Cáceres,21,394151,39210,354941,2565124,439521
2020/06/14,Valencia,Cuenca,118,196329,17616,178713,2565124,439521
2020/06/14,Valladolid,León,51,460001,56284,403717,519546,66861
2020/06/14,Valladolid,Zamora,87,172539,16907,155632,519546,66861
2020/06/14,Valladolid,Segovia,189,153129,16897,136232,519546,66861
2020/06/14,Valladolid,Palencia,44,160866,19476,141390,519546,66861
2020/06/14,Valladolid,Soria,29,88636,7638,80998,519546,66861
2020/06/14,Valladolid,Valladolid,53125,519546,68409,451137,519546,66861
2020/06/14,Valladolid,Burgos,113,357072,40317,316755,519546,66861
2020/06/14,Zamora,Zamora,12638,172539,16907,155632,172539,17274
2020/06/14,Zamora,Salamanca,34,330119,40500,289619,172539,17274
2020/06/14,Zamora,Valladolid,61,519546,68409,451137,172539,17274
2020/06/14,Zaragoza,Teruel,242,134137,10483,123654,964724,142059
2020/06/14,Zaragoza,Soria,55,88636,7638,80998,964724,142059
2020/06/14,Zaragoza,Tarragona,30,804664,117259,687405,964724,142059
2020/06/14,Zaragoza,Lleida,119,434930,58255,376675,964724,142059
2020/06/14,Zaragoza,Navarra,621,654183,98690,555493,964724,142059
2020/06/14,Zaragoza,Huesca,345,220461,30233,190228,964724,142059
2020/06/14,Zaragoza,Zaragoza,111480,964724,151822,812902,964724,142059
2020/06/15,Albacete,Albacete,30234,388167,47814,340353,388167,47993
2020/06/15,Albacete,Valencia,374,2565124,557515,2007609,388167,47993
2020/06/15,Albacete,Murcia,596,1493898,279908,1213990,388167,47993
2020/06/15,Albacete,Cuenca,876,196329,26579,169750,388167,47993
2020/06/15,Albacete,Alicante,264,1858683,350650,1508033,388167,47993
2020/06/15,Albacete,Ciudad Real,632,495761,60422,435339,388167,47993
2020/06/15,Albacete,Jaén,29,633564,91689,541875,388167,47993
2020/06/15,Alicante,Valencia,2085,2565124,557515,2007609,1858683,356714
2020/06/15,Alicante,Albacete,408,388167,47814,340353,1858683,356714
2020/06/15,Alicante,Murcia,3532,1493898,279908,1213990,1858683,356714
2020/06/15,Alicante,Alicante,273204,1858683,350650,1508033,1858683,356714
2020/06/15,Almería,Granada,957,914678,169819,744859,716820,120515
2020/06/15,Almería,Almería,95351,716820,117764,599056,716820,120515
2020/06/15,Almería,Murcia,2012,1493898,279908,1213990,716820,120515
2020/06/15,Araba,Bizkaia,2646,1152934,272523,880411,331549,80703
2020/06/15,Araba,Navarra,247,654183,127300,526883,331549,80703
2020/06/15,Araba,Rioja,2326,316798,57908,258890,331549,80703
2020/06/15,Araba,Burgos,2275,357072,56544,300528,331549,80703
2020/06/15,Araba,Araba,57408,331549,71151,260398,331549,80703
2020/06/15,Araba,Gipuzkoa,656,723576,138560,585016,331549,80703
2020/06/15,Asturias,Cantabria,216,580795,116771,464024,1022800,195576
2020/06/15,Asturias,Lugo,977,329587,55601,273986,1022800,195576
2020/06/15,Asturias,León,38,460001,82475,377526,1022800,195576
2020/06/15,Asturias,Asturias,161111,1022800,198093,824707,1022800,195576
2020/06/15,Ávila,Ávila,14617,157640,22675,134965,157640,23559
2020/06/15,Ávila,Valladolid,56,519546,102939,416607,157640,23559
2020/06/15,Ávila,Cáceres,131,394151,57615,336536,157640,23559
2020/06/15,Ávila,Salamanca,368,330119,58200,271919,157640,23559
2020/06/15,Ávila,Madrid,198,6663394,1370212,5293182,157640,23559
2020/06/15,Ávila,Toledo,316,694844,111919,582925,157640,23559
2020/06/15,Ávila,Segovia,79,153129,24710,128419,157640,23559
2020/06/15,Badajoz,Cáceres,1512,394151,57615,336536,673559,105555
2020/06/15,Badajoz,Ciudad Real,57,495761,60422,435339,673559,105555
2020/06/15,Badajoz,Sevilla,78,1942389,387256,1555133,673559,105555
2020/06/15,Badajoz,Córdoba,80,782979,137763,645216,673559,105555
2020/06/15,Badajoz,Huelva,232,521870,93885,427985,673559,105555
2020/06/15,Badajoz,Badajoz,78685,673559,107642,565917,673559,105555
2020/06/15,Balears,Valencia,37,2565124,557515,2007609,1149460,208211
2020/06/15,Balears,Barcelona,17,5664579,1245372,4419207,1149460,208211
2020/06/15,Balears,Balears,186856,1149460,207326,942134,1149460,208211
2020/06/15,Barcelona,Girona,3767,771044,127885,643159,5664579,1241593
2020/06/15,Barcelona,Barcelona,808859,5664579,1245372,4419207,5664579,1241593
2020/06/15,Barcelona,Tarragona,2738,804664,141090,663574,5664579,1241593
2020/06/15,Barcelona,Lleida,310,434930,79331,355599,5664579,1241593
2020/06/15,Bizkaia,Araba,1299,331549,71151,260398,1152934,269194
2020/06/15,Bizkaia,Burgos,109,357072,56544,300528,1152934,269194
2020/06/15,Bizkaia,Gipuzkoa,1572,723576,138560,585016,1152934,269194
2020/06/15,Bizkaia,Cantabria,3674,580795,116771,464024,1152934,269194
2020/06/15,Bizkaia,Bizkaia,212428,1152934,272523,880411,1152934,269194
2020/06/15,Burgos,Araba,982,331549,71151,260398,357072,58317
2020/06/15,Burgos,Burgos,42088,357072,56544,300528,357072,58317
2020/06/15,Burgos,Valladolid,101,519546,102939,416607,357072,58317
2020/06/15,Burgos,Palencia,223,160866,27471,133395,357072,58317
2020/06/15,Burgos,Bizkaia,194,1152934,272523,880411,357072,58317
2020/06/15,Burgos,Soria,51,88636,10164,78472,357072,58317
2020/06/15,Burgos,Rioja,76,316798,57908,258890,357072,58317
2020/06/15,Burgos,Segovia,79,153129,24710,128419,357072,58317
2020/06/15,Cáceres,Ávila,128,157640,22675,134965,394151,57748
2020/06/15,Cáceres,Valencia,27,2565124,557515,2007609,394151,57748
2020/06/15,Cáceres,Toledo,227,694844,111919,582925,394151,57748
2020/06/15,Cáceres,Cáceres,38811,394151,57615,336536,394151,57748
2020/06/15,Cáceres,Badajoz,1554,673559,107642,565917,394151,57748
2020/06/15,Cádiz,Cádiz,184110,1240155,229252,1010903,1240155,228918
2020/06/15,Cádiz,Málaga,1883,1661785,314633,1347152,1240155,228918
2020/06/15,Cádiz,Huelva,705,521870,93885,427985,1240155,228918
2020/06/15,Cádiz,Sevilla,1831,1942389,387256,1555133,1240155,228918
2020/06/15,Cádiz,Ceuta,54,84777,10837,73940,1240155,228918
2020/06/15,Cantabria,Bizkaia,1031,1152934,272523,880411,580795,109547
2020/06/15,Cantabria,Cantabria,86424,580795,116771,464024,580795,109547
2020/06/15,Cantabria,Palencia,75,160866,27471,133395,580795,109547
2020/06/15,Cantabria,Asturias,214,1022800,198093,824707,580795,109547
2020/06/15,Castellón,Valencia,1143,2565124,557515,2007609,579962,106901
2020/06/15,Castellón,Tarragona,907,804664,141090,663574,579962,106901
2020/06/15,Castellón,Castellón,74347,579962,98544,481418,579962,106901
2020/06/15,Castellón,Teruel,56,134137,14608,119529,579962,106901
2020/06/15,Ceuta,Cádiz,58,1240155,229252,1010903,84777,10809
2020/06/15,Ceuta,Ceuta,10220,84777,10837,73940,84777,10809
2020/06/15,Ciudad Real,Córdoba,418,782979,137763,645216,495761,55631
2020/06/15,Ciudad Real,Toledo,661,694844,111919,582925,495761,55631
2020/06/15,Ciudad Real,Ciudad Real,36482,495761,60422,435339,495761,55631
2020/06/15,Ciudad Real,Albacete,531,388167,47814,340353,495761,55631
2020/06/15,Ciudad Real,Badajoz,98,673559,107642,565917,495761,55631
2020/06/15,Ciudad Real,Cuenca,61,196329,26579,169750,495761,55631
2020/06/15,Córdoba,Jaén,844,633564,91689,541875,782979,132018
2020/06/15,Córdoba,Córdoba,94614,782979,137763,645216,782979,132018
2020/06/15,Córdoba,Sevilla,2232,1942389,387256,1555133,782979,132018
2020/06/15,Córdoba,Granada,136,914678,169819,744859,782979,132018
2020/06/15,Córdoba,Ciudad Real,284,495761,60422,435339,782979,132018
2020/06/15,Córdoba,Málaga,386,1661785,314633,1347152,782979,132018
2020/06/15,Córdoba,Badajoz,89,673559,107642,565917,782979,132018
2020/06/15,Coruña,Coruña,173570,1119596,228464,891132,1119596,229937
2020/06/15,Coruña,Ourense,19,307651,62712,244939,1119596,229937
2020/06/15,Coruña,Lugo,747,329587,55601,273986,1119596,229937
2020/06/15,Coruña,Pontevedra,6827,942665,200456,742209,1119596,229937
2020/06/15,Cuenca,Albacete,818,388167,47814,340353,196329,27866
2020/06/15,Cuenca,Cuenca,14386,196329,26579,169750,196329,27866
2020/06/15,Cuenca,Guadalajara,86,257762,46230,211532,196329,27866
2020/06/15,Cuenca,Toledo,245,694844,111919,582925,196329,27866
2020/06/15,Cuenca,Valencia,108,2565124,557515,2007609,196329,27866
2020/06/15,Cuenca,Ciudad Real,150,495761,60422,435339,196329,27866
2020/06/15,Cuenca,Madrid,60,6663394,1370212,5293182,196329,27866
2020/06/15,Gipuzkoa,Navarra,658,654183,127300,526883,723576,144972
2020/06/15,Gipuzkoa,Araba,560,331549,71151,260398,723576,144972
2020/06/15,Gipuzkoa,Gipuzkoa,107075,723576,138560,585016,723576,144972
2020/06/15,Gipuzkoa,Bizkaia,2509,1152934,272523,880411,723576,144972
2020/06/15,Girona,Lleida,255,434930,79331,355599,771044,135036
2020/06/15,Girona,Barcelona,3541,5664579,1245372,4419207,771044,135036
2020/06/15,Girona,Girona,86270,771044,127885,643159,771044,135036
2020/06/15,Granada,Málaga,258,1661785,314633,1347152,914678,166331
2020/06/15,Granada,Córdoba,198,782979,137763,645216,914678,166331
2020/06/15,Granada,Jaén,530,633564,91689,541875,914678,166331
2020/06/15,Granada,Murcia,110,1493898,279908,1213990,914678,166331
2020/06/15,Granada,Almería,551,716820,117764,599056,914678,166331
2020/06/15,Granada,Granada,121522,914678,169819,744859,914678,166331
2020/06/15,Guadalajara,Cuenca,47,196329,26579,169750,257762,50433
2020/06/15,Guadalajara,Guadalajara,26873,257762,46230,211532,257762,50433
2020/06/15,Guadalajara,Madrid,3079,6663394,1370212,5293182,257762,50433
2020/06/15,Huelva,Huelva,67881,521870,93885,427985,521870,94110
2020/06/15,Huelva,Córdoba,16,782979,137763,645216,521870,94110
2020/06/15,Huelva,Cádiz,488,1240155,229252,1010903,521870,94110
2020/06/15,Huelva,Badajoz,433,673559,107642,565917,521870,94110
2020/06/15,Huelva,Sevilla,1357,1942389,387256,1555133,521870,94110
2020/06/15,Huesca,Lleida,1413,434930,79331,355599,220461,40570
2020/06/15,Huesca,Zaragoza,502,964724,205023,759701,220461,40570
2020/06/15,Huesca,Huesca,23491,220461,36661,183800,220461,40570
2020/06/15,Jaén,Granada,443,914678,169819,744859,633564,88084
2020/06/15,Jaén,Albacete,44,388167,47814,340353,633564,88084
2020/06/15,Jaén,Córdoba,911,782979,137763,645216,633564,88084
2020/06/15,Jaén,Jaén,61538,633564,91689,541875,633564,88084
2020/06/15,Las Palmas de Gran Canaria,Las Palmas de Gran Canaria,201324,1120406,215104,905302,1120406,214590
2020/06/15,León,Zamora,149,172539,26219,146320,460001,82227
2020/06/15,León,Asturias,139,1022800,198093,824707,460001,82227
2020/06/15,León,Ourense,371,307651,62712,244939,460001,82227
2020/06/15,León,Palencia,73,160866,27471,133395,460001,82227
2020/06/15,León,León,62385,460001,82475,377526,460001,82227
2020/06/15,Lleida,Huesca,823,220461,36661,183800,434930,77973
2020/06/15,Lleida,Tarragona,35,804664,141090,663574,434930,77973
2020/06/15,Lleida,Lleida,52956,434930,79331,355599,434930,77973
2020/06/15,Lleida,Zaragoza,156,964724,205023,759701,434930,77973
2020/06/15,Lleida,Girona,258,771044,127885,643159,434930,77973
2020/06/15,Lleida,Barcelona,417,5664579,1245372,4419207,434930,77973
2020/06/15,Lugo,Coruña,825,1119596,228464,891132,329587,56841
2020/06/15,Lugo,Lugo,38345,329587,55601,273986,329587,56841
2020/06/15,Lugo,Ourense,282,307651,62712,244939,329587,56841
2020/06/15,Lugo,Asturias,800,1022800,198093,824707,329587,56841
2020/06/15,Madrid,Cuenca,113,196329,26579,169750,6663394,1375913
2020/06/15,Madrid,Ávila,272,157640,22675,134965,6663394,1375913
2020/06/15,Madrid,Guadalajara,3669,257762,46230,211532,6663394,1375913
2020/06/15,Madrid,Toledo,4935,694844,111919,582925,6663394,1375913
2020/06/15,Madrid,Ciudad Real,36,495761,60422,435339,6663394,1375913
2020/06/15,Madrid,Madrid,859342,6663394,1370212,5293182,6663394,1375913
2020/06/15,Madrid,Segovia,57,153129,24710,128419,6663394,1375913
2020/06/15,Málaga,Cádiz,2042,1240155,229252,1010903,1661785,322112
2020/06/15,Málaga,Sevilla,261,1942389,387256,1555133,1661785,322112
2020/06/15,Málaga,Granada,362,914678,169819,744859,1661785,322112
2020/06/15,Málaga,Melilla,18,86487,16046,70441,1661785,322112
2020/06/15,Málaga,Málaga,258728,1661785,314633,1347152,1661785,322112
2020/06/15,Málaga,Córdoba,453,782979,137763,645216,1661785,322112
2020/06/15,Melilla,Melilla,15923,86487,16046,70441,86487,16161
2020/06/15,Murcia,Almería,1408,716820,117764,599056,1493898,273546
2020/06/15,Murcia,Murcia,222880,1493898,279908,1213990,1493898,273546
2020/06/15,Murcia,Alicante,3180,1858683,350650,1508033,1493898,273546
2020/06/15,Murcia,Granada,29,914678,169819,744859,1493898,273546
2020/06/15,Murcia,Albacete,589,388167,47814,340353,1493898,273546
2020/06/15,Navarra,Rioja,2689,316798,57908,258890,654183,130265
2020/06/15,Navarra,Gipuzkoa,445,723576,138560,585016,654183,130265
2020/06/15,Navarra,Zaragoza,771,964724,205023,759701,654183,130265
2020/06/15,Navarra,Navarra,94811,654183,127300,526883,654183,130265
2020/06/15,Navarra,Araba,179,331549,71151,260398,654183,130265
2020/06/15,Ourense,León,353,460001,82475,377526,307651,62841
2020/06/15,Ourense,Ourense,47180,307651,62712,244939,307651,62841
2020/06/15,Ourense,Zamora,26,172539,26219,146320,307651,62841
2020/06/15,Ourense,Lugo,316,329587,55601,273986,307651,62841
2020/06/15,Ourense,Pontevedra,264,942665,200456,742209,307651,62841
2020/06/15,Palencia,Cantabria,184,580795,116771,464024,160866,29206
2020/06/15,Palencia,Valladolid,453,519546,102939,416607,160866,29206
2020/06/15,Palencia,León,31,460001,82475,377526,160866,29206
2020/06/15,Palencia,Palencia,19491,160866,27471,133395,160866,29206
2020/06/15,Palencia,Burgos,231,357072,56544,300528,160866,29206
2020/06/15,Pontevedra,Lugo,70,329587,55601,273986,942665,197244
2020/06/15,Pontevedra,Coruña,4776,1119596,228464,891132,942665,197244
2020/06/15,Pontevedra,Ourense,309,307651,62712,244939,942665,197244
2020/06/15,Pontevedra,Pontevedra,155003,942665,200456,742209,942665,197244
2020/06/15,Rioja,Rioja,42959,316798,57908,258890,316798,55904
2020/06/15,Rioja,Burgos,59,357072,56544,300528,316798,55904
2020/06/15,Rioja,Navarra,2001,654183,127300,526883,316798,55904
2020/06/15,Rioja,Zaragoza,16,964724,205023,759701,316798,55904
2020/06/15,Rioja,Araba,883,331549,71151,260398,316798,55904
2020/06/15,Rioja,Bizkaia,19,1152934,272523,880411,316798,55904
2020/06/15,Salamanca,Salamanca,45865,330119,58200,271919,330119,57875
2020/06/15,Salamanca,Zamora,120,172539,26219,146320,330119,57875
2020/06/15,Salamanca,Ávila,254,157640,22675,134965,330119,57875
2020/06/15,Santa Cruz de Tenerife,Las Palmas de Gran Canaria,81,1120406,215104,905302,1032983,194625
2020/06/15,Santa Cruz de Tenerife,Santa Cruz de Tenerife,176778,1032983,194449,838534,1032983,194625
2020/06/15,Segovia,Madrid,22,6663394,1370212,5293182,153129,27046
2020/06/15,Segovia,Ávila,168,157640,22675,134965,153129,27046
2020/06/15,Segovia,Segovia,16239,153129,24710,128419,153129,27046
2020/06/15,Segovia,Burgos,161,357072,56544,300528,153129,27046
2020/06/15,Segovia,Valladolid,461,519546,102939,416607,153129,27046
2020/06/15,Sevilla,Sevilla,276053,1942389,387256,1555133,1942389,386593
2020/06/15,Sevilla,Cádiz,1880,1240155,229252,1010903,1942389,386593
2020/06/15,Sevilla,Málaga,175,1661785,314633,1347152,1942389,386593
2020/06/15,Sevilla,Huelva,1715,521870,93885,427985,1942389,386593
2020/06/15,Sevilla,Córdoba,2388,782979,137763,645216,1942389,386593
2020/06/15,Sevilla,Badajoz,99,673559,107642,565917,1942389,386593
2020/06/15,Soria,Valladolid,32,519546,102939,416607,88636,12305
2020/06/15,Soria,Soria,7846,88636,10164,78472,88636,12305
2020/06/15,Soria,Burgos,110,357072,56544,300528,88636,12305
2020/06/15,Soria,Segovia,22,153129,24710,128419,88636,12305
2020/06/15,Soria,Zaragoza,154,964724,205023,759701,88636,12305
2020/06/15,Tarragona,Castellón,912,579962,98544,481418,804664,140777
2020/06/15,Tarragona,Barcelona,1688,5664579,1245372,4419207,804664,140777
2020/06/15,Tarragona,Zaragoza,42,964724,205023,759701,804664,140777
2020/06/15,Tarragona,Lleida,44,434930,79331,355599,804664,140777
2020/06/15,Tarragona,Teruel,32,134137,14608,119529,804664,140777
2020/06/15,Tarragona,Tarragona,95353,804664,141090,663574,804664,140777
2020/06/15,Teruel,Guadalajara,49,257762,46230,211532,134137,16868
2020/06/15,Teruel,Castellón,83,579962,98544,481418,134137,16868
2020/06/15,Teruel,Valencia,24,2565124,557515,2007609,134137,16868
2020/06/15,Teruel,Tarragona,106,804664,141090,663574,134137,16868
2020/06/15,Teruel,Teruel,8376,134137,14608,119529,134137,16868
2020/06/15,Teruel,Zaragoza,380,964724,205023,759701,134137,16868
2020/06/15,Toledo,Madrid,4116,6663394,1370212,5293182,694844,106676
2020/06/15,Toledo,Ciudad Real,416,495761,60422,435339,694844,106676
2020/06/15,Toledo,Toledo,54196,694844,111919,582925,694844,106676
2020/06/15,Toledo,Cáceres,223,394151,57615,336536,694844,106676
2020/06/15,Toledo,Cuenca,128,196329,26579,169750,694844,106676
2020/06/15,Toledo,Ávila,243,157640,22675,134965,694844,106676
2020/06/15,Valencia,Cuenca,142,196329,26579,169750,2565124,538212
2020/06/15,Valencia,Alicante,1920,1858683,350650,1508033,2565124,538212
2020/06/15,Valencia,Albacete,371,388167,47814,340353,2565124,538212
2020/06/15,Valencia,Castellón,1003,579962,98544,481418,2565124,538212
2020/06/15,Valencia,Valencia,395178,2565124,557515,2007609,2565124,538212
2020/06/15,Valencia,Teruel,19,134137,14608,119529,2565124,538212
2020/06/15,Valladolid,Segovia,305,153129,24710,128419,519546,100480
2020/06/15,Valladolid,Palencia,115,160866,27471,133395,519546,100480
2020/06/15,Valladolid,Valladolid,76333,519546,102939,416607,519546,100480
2020/06/15,Valladolid,Burgos,130,357072,56544,300528,519546,100480
2020/06/15,Valladolid,León,52,460001,82475,377526,519546,100480
2020/06/15,Valladolid,Zamora,155,172539,26219,146320,519546,100480
2020/06/15,Valladolid,Soria,56,88636,10164,78472,519546,100480
2020/06/15,Zamora,León,89,460001,82475,377526,172539,26631
2020/06/15,Zamora,Ourense,40,307651,62712,244939,172539,26631
2020/06/15,Zamora,Zamora,18099,172539,26219,146320,172539,26631
2020/06/15,Zamora,Valladolid,87,519546,102939,416607,172539,26631
2020/06/15,Zamora,Salamanca,33,330119,58200,271919,172539,26631
2020/06/15,Zaragoza,Teruel,403,134137,14608,119529,964724,202032
2020/06/15,Zaragoza,Lleida,103,434930,79331,355599,964724,202032
2020/06/15,Zaragoza,Huesca,514,220461,36661,183800,964724,202032
2020/06/15,Zaragoza,Navarra,592,654183,127300,526883,964724,202032
2020/06/15,Zaragoza,Barcelona,16,5664579,1245372,4419207,964724,202032
2020/06/15,Zaragoza,Zaragoza,158152,964724,205023,759701,964724,202032
2020/06/15,Zaragoza,Soria,71,88636,10164,78472,964724,202032
2020/06/16,Albacete,Albacete,33768,388167,50272,337895,388167,51669
2020/06/16,Albacete,Ciudad Real,692,495761,60297,435464,388167,51669
2020/06/16,Albacete,Jaén,55,633564,89650,543914,388167,51669
2020/06/16,Albacete,Murcia,590,1493898,289398,1204500,388167,51669
2020/06/16,Albacete,Cuenca,827,196329,26908,169421,388167,51669
2020/06/16,Albacete,Alicante,251,1858683,373473,1485210,388167,51669
2020/06/16,Albacete,Valencia,401,2565124,588008,1977116,388167,51669
2020/06/16,Alicante,Albacete,470,388167,50272,337895,1858683,381883
2020/06/16,Alicante,Murcia,4127,1493898,289398,1204500,1858683,381883
2020/06/16,Alicante,Alicante,297107,1858683,373473,1485210,1858683,381883
2020/06/16,Alicante,Valencia,2373,2565124,588008,1977116,1858683,381883
2020/06/16,Almería,Almería,98140,716820,119257,597563,716820,121808
2020/06/16,Almería,Granada,624,914678,171314,743364,716820,121808
2020/06/16,Almería,Murcia,2167,1493898,289398,1204500,716820,121808
2020/06/16,Araba,Navarra,249,654183,132608,521575,331549,84395
2020/06/16,Araba,Burgos,2429,357072,59202,297870,331549,84395
2020/06/16,Araba,Rioja,2464,316798,61286,255512,331549,84395
2020/06/16,Araba,Cantabria,17,580795,115305,465490,331549,84395
2020/06/16,Araba,Gipuzkoa,621,723576,147759,575817,331549,84395
2020/06/16,Araba,Bizkaia,2845,1152934,284835,868099,331549,84395
2020/06/16,Araba,Araba,61202,331549,74859,256690,331549,84395
2020/06/16,Asturias,Asturias,164904,1022800,199086,823714,1022800,197562
2020/06/16,Asturias,Lugo,1026,329587,55888,273699,1022800,197562
2020/06/16,Asturias,León,97,460001,83260,376741,1022800,197562
2020/06/16,Asturias,Cantabria,228,580795,115305,465490,1022800,197562
2020/06/16,Ávila,Toledo,306,694844,116395,578449,157640,23934
2020/06/16,Ávila,Salamanca,431,330119,59938,270181,157640,23934
2020/06/16,Ávila,Segovia,93,153129,24252,128877,157640,23934
2020/06/16,Ávila,Valladolid,34,519546,108878,410668,157640,23934
2020/06/16,Ávila,Cáceres,116,394151,57657,336494,157640,23934
2020/06/16,Ávila,Madrid,181,6663394,1438826,5224568,157640,23934
2020/06/16,Ávila,Ávila,14962,157640,22396,135244,157640,23934
2020/06/16,Badajoz,Sevilla,76,1942389,404336,1538053,673559,110250
2020/06/16,Badajoz,Córdoba,86,782979,139316,643663,673559,110250
2020/06/16,Badajoz,Cáceres,1768,394151,57657,336494,673559,110250
2020/06/16,Badajoz,Ciudad Real,51,495761,60297,435464,673559,110250
2020/06/16,Badajoz,Huelva,258,521870,91451,430419,673559,110250
2020/06/16,Badajoz,Badajoz,83675,673559,111035,562524,673559,110250
2020/06/16,Balears,Barcelona,41,5664579,1280641,4383938,1149460,216203
2020/06/16,Balears,Balears,193429,1149460,214936,934524,1149460,216203
2020/06/16,Balears,Valencia,88,2565124,588008,1977116,1149460,216203
2020/06/16,Barcelona,Tarragona,2874,804664,141685,662979,5664579,1275460
2020/06/16,Barcelona,Barcelona,848670,5664579,1280641,4383938,5664579,1275460
2020/06/16,Barcelona,Lleida,216,434930,77359,357571,5664579,1275460
2020/06/16,Barcelona,Girona,3805,771044,126376,644668,5664579,1275460
2020/06/16,Bizkaia,Burgos,98,357072,59202,297870,1152934,280142
2020/06/16,Bizkaia,Araba,1637,331549,74859,256690,1152934,280142
2020/06/16,Bizkaia,Cantabria,3673,580795,115305,465490,1152934,280142
2020/06/16,Bizkaia,Bizkaia,225083,1152934,284835,868099,1152934,280142
2020/06/16,Bizkaia,Gipuzkoa,1675,723576,147759,575817,1152934,280142
2020/06/16,Burgos,Rioja,97,316798,61286,255512,357072,60320
2020/06/16,Burgos,Burgos,44703,357072,59202,297870,357072,60320
2020/06/16,Burgos,Bizkaia,178,1152934,284835,868099,357072,60320
2020/06/16,Burgos,Soria,54,88636,10828,77808,357072,60320
2020/06/16,Burgos,Segovia,99,153129,24252,128877,357072,60320
2020/06/16,Burgos,Araba,1244,331549,74859,256690,357072,60320
2020/06/16,Burgos,Valladolid,80,519546,108878,410668,357072,60320
2020/06/16,Burgos,Palencia,254,160866,28406,132460,357072,60320
2020/06/16,Cáceres,Cáceres,39648,394151,57657,336494,394151,57761
2020/06/16,Cáceres,Toledo,287,694844,116395,578449,394151,57761
2020/06/16,Cáceres,Ávila,138,157640,22396,135244,394151,57761
2020/06/16,Cáceres,Badajoz,1491,673559,111035,562524,394151,57761
2020/06/16,Cádiz,Almería,22,716820,119257,597563,1240155,238675
2020/06/16,Cádiz,Cádiz,194172,1240155,231627,1008528,1240155,238675
2020/06/16,Cádiz,Málaga,2147,1661785,328843,1332942,1240155,238675
2020/06/16,Cádiz,Huelva,769,521870,91451,430419,1240155,238675
2020/06/16,Cádiz,Sevilla,1730,1942389,404336,1538053,1240155,238675
2020/06/16,Cádiz,Ceuta,48,84777,11608,73169,1240155,238675
2020/06/16,Cantabria,Palencia,68,160866,28406,132460,580795,110310
2020/06/16,Cantabria,Asturias,249,1022800,199086,823714,580795,110310
2020/06/16,Cantabria,Cantabria,86388,580795,115305,465490,580795,110310
2020/06/16,Cantabria,Bizkaia,1163,1152934,284835,868099,580795,110310
2020/06/16,Castellón,Teruel,72,134137,13613,120524,579962,110554
2020/06/16,Castellón,Valencia,1193,2565124,588008,1977116,579962,110554
2020/06/16,Castellón,Tarragona,933,804664,141685,662979,579962,110554
2020/06/16,Castellón,Castellón,78988,579962,103189,476773,579962,110554
2020/06/16,Ceuta,Ceuta,11038,84777,11608,73169,84777,11625
2020/06/16,Ceuta,Cádiz,65,1240155,231627,1008528,84777,11625
2020/06/16,Ciudad Real,Córdoba,394,782979,139316,643663,495761,56810
2020/06/16,Ciudad Real,Cuenca,32,196329,26908,169421,495761,56810
2020/06/16,Ciudad Real,Toledo,608,694844,116395,578449,495761,56810
2020/06/16,Ciudad Real,Ciudad Real,38038,495761,60297,435464,495761,56810
2020/06/16,Ciudad Real,Albacete,507,388167,50272,337895,495761,56810
2020/06/16,Ciudad Real,Jaén,25,633564,89650,543914,495761,56810
2020/06/16,Ciudad Real,Badajoz,61,673559,111035,562524,495761,56810
2020/06/16,Córdoba,Córdoba,99559,782979,139316,643663,782979,135718
2020/06/16,Córdoba,Málaga,354,1661785,328843,1332942,782979,135718
2020/06/16,Córdoba,Jaén,804,633564,89650,543914,782979,135718
2020/06/16,Córdoba,Granada,133,914678,171314,743364,782979,135718
2020/06/16,Córdoba,Ciudad Real,298,495761,60297,435464,782979,135718
2020/06/16,Córdoba,Sevilla,2171,1942389,404336,1538053,782979,135718
2020/06/16,Córdoba,Badajoz,113,673559,111035,562524,782979,135718
2020/06/16,Coruña,Coruña,181615,1119596,234454,885142,1119596,236955
2020/06/16,Coruña,Pontevedra,6663,942665,207974,734691,1119596,236955
2020/06/16,Coruña,Lugo,808,329587,55888,273699,1119596,236955
2020/06/16,Cuenca,Albacete,936,388167,50272,337895,196329,28664
2020/06/16,Cuenca,Valencia,147,2565124,588008,1977116,196329,28664
2020/06/16,Cuenca,Cuenca,15103,196329,26908,169421,196329,28664
2020/06/16,Cuenca,Guadalajara,70,257762,47593,210169,196329,28664
2020/06/16,Cuenca,Toledo,205,694844,116395,578449,196329,28664
2020/06/16,Cuenca,Ciudad Real,169,495761,60297,435464,196329,28664
2020/06/16,Cuenca,Madrid,61,6663394,1438826,5224568,196329,28664
2020/06/16,Gipuzkoa,Araba,548,331549,74859,256690,723576,152960
2020/06/16,Gipuzkoa,Bizkaia,2627,1152934,284835,868099,723576,152960
2020/06/16,Gipuzkoa,Navarra,728,654183,132608,521575,723576,152960
2020/06/16,Gipuzkoa,Gipuzkoa,116799,723576,147759,575817,723576,152960
2020/06/16,Girona,Murcia,16,1493898,289398,1204500,771044,136085
2020/06/16,Girona,Barcelona,3785,5664579,1280641,4383938,771044,136085
2020/06/16,Girona,Lleida,219,434930,77359,357571,771044,136085
2020/06/16,Girona,Girona,87289,771044,126376,644668,771044,136085
2020/06/16,Girona,Tarragona,42,804664,141685,662979,771044,136085
2020/06/16,Granada,Murcia,188,1493898,289398,1204500,914678,169364
2020/06/16,Granada,Jaén,444,633564,89650,543914,914678,169364
2020/06/16,Granada,Córdoba,234,782979,139316,643663,914678,169364
2020/06/16,Granada,Almería,729,716820,119257,597563,914678,169364
2020/06/16,Granada,Granada,127123,914678,171314,743364,914678,169364
2020/06/16,Granada,Málaga,323,1661785,328843,1332942,914678,169364
2020/06/16,Guadalajara,Cuenca,96,196329,26908,169421,257762,51676
2020/06/16,Guadalajara,Madrid,3516,6663394,1438826,5224568,257762,51676
2020/06/16,Guadalajara,Toledo,17,694844,116395,578449,257762,51676
2020/06/16,Guadalajara,Guadalajara,27956,257762,47593,210169,257762,51676
2020/06/16,Guadalajara,Teruel,28,134137,13613,120524,257762,51676
2020/06/16,Huelva,Badajoz,389,673559,111035,562524,521870,96628
2020/06/16,Huelva,Cádiz,601,1240155,231627,1008528,521870,96628
2020/06/16,Huelva,Huelva,70764,521870,91451,430419,521870,96628
2020/06/16,Huelva,Sevilla,1606,1942389,404336,1538053,521870,96628
2020/06/16,Huesca,Lleida,1062,434930,77359,357571,220461,38125
2020/06/16,Huesca,Zaragoza,465,964724,210686,754038,220461,38125
2020/06/16,Huesca,Huesca,23640,220461,34987,185474,220461,38125
2020/06/16,Jaén,Córdoba,870,782979,139316,643663,633564,88226
2020/06/16,Jaén,Jaén,62208,633564,89650,543914,633564,88226
2020/06/16,Jaén,Albacete,36,388167,50272,337895,633564,88226
2020/06/16,Jaén,Navarra,23,654183,132608,521575,633564,88226
2020/06/16,Jaén,Granada,353,914678,171314,743364,633564,88226
2020/06/16,Las Palmas de Gran Canaria,Las Palmas de Gran Canaria,209608,1120406,223694,896712,1120406,223977
2020/06/16,León,Palencia,66,160866,28406,132460,460001,83156
2020/06/16,León,Zamora,176,172539,26597,145942,460001,83156
2020/06/16,León,Asturias,38,1022800,199086,823714,460001,83156
2020/06/16,León,Lugo,34,329587,55888,273699,460001,83156
2020/06/16,León,Valladolid,19,519546,108878,410668,460001,83156
2020/06/16,León,León,64037,460001,83260,376741,460001,83156
2020/06/16,León,Ourense,335,307651,62449,245202,460001,83156
2020/06/16,Lleida,Zaragoza,187,964724,210686,754038,434930,75950
2020/06/16,Lleida,Girona,207,771044,126376,644668,434930,75950
2020/06/16,Lleida,Barcelona,337,5664579,1280641,4383938,434930,75950
2020/06/16,Lleida,Huesca,888,220461,34987,185474,434930,75950
2020/06/16,Lleida,Lleida,52257,434930,77359,357571,434930,75950
2020/06/16,Lugo,Pontevedra,35,942665,207974,734691,329587,57922
2020/06/16,Lugo,Lugo,39866,329587,55888,273699,329587,57922
2020/06/16,Lugo,Asturias,793,1022800,199086,823714,329587,57922
2020/06/16,Lugo,Coruña,774,1119596,234454,885142,329587,57922
2020/06/16,Lugo,Ourense,253,307651,62449,245202,329587,57922
2020/06/16,Madrid,Ciudad Real,34,495761,60297,435464,6663394,1431259
2020/06/16,Madrid,Cuenca,84,196329,26908,169421,6663394,1431259
2020/06/16,Madrid,Ávila,316,157640,22396,135244,6663394,1431259
2020/06/16,Madrid,Madrid,928506,6663394,1438826,5224568,6663394,1431259
2020/06/16,Madrid,Guadalajara,4073,257762,47593,210169,6663394,1431259
2020/06/16,Madrid,Segovia,69,153129,24252,128877,6663394,1431259
2020/06/16,Madrid,Toledo,5544,694844,116395,578449,6663394,1431259
2020/06/16,Málaga,Málaga,276501,1661785,328843,1332942,1661785,333520
2020/06/16,Málaga,Granada,365,914678,171314,743364,1661785,333520
2020/06/16,Málaga,Cádiz,1963,1240155,231627,1008528,1661785,333520
2020/06/16,Málaga,Córdoba,427,782979,139316,643663,1661785,333520
2020/06/16,Málaga,Sevilla,422,1942389,404336,1538053,1661785,333520
2020/06/16,Melilla,Melilla,16346,86487,16433,70054,86487,16604
2020/06/16,Melilla,Málaga,36,1661785,328843,1332942,86487,16604
2020/06/16,Murcia,Albacete,596,388167,50272,337895,1493898,283349
2020/06/16,Murcia,Murcia,232193,1493898,289398,1204500,1493898,283349
2020/06/16,Murcia,Almería,1441,716820,119257,597563,1493898,283349
2020/06/16,Murcia,Alicante,3207,1858683,373473,1485210,1493898,283349
2020/06/16,Navarra,Gipuzkoa,580,723576,147759,575817,654183,135320
2020/06/16,Navarra,Rioja,2850,316798,61286,255512,654183,135320
2020/06/16,Navarra,Navarra,100060,654183,132608,521575,654183,135320
2020/06/16,Navarra,Zaragoza,772,964724,210686,754038,654183,135320
2020/06/16,Navarra,Araba,122,331549,74859,256690,654183,135320
2020/06/16,Ourense,Pontevedra,285,942665,207974,734691,307651,63053
2020/06/16,Ourense,Zamora,64,172539,26597,145942,307651,63053
2020/06/16,Ourense,Ourense,48078,307651,62449,245202,307651,63053
2020/06/16,Ourense,León,416,460001,83260,376741,307651,63053
2020/06/16,Ourense,Lugo,310,329587,55888,273699,307651,63053
2020/06/16,Palencia,Palencia,20678,160866,28406,132460,160866,29965
2020/06/16,Palencia,Cantabria,217,580795,115305,465490,160866,29965
2020/06/16,Palencia,Valladolid,467,519546,108878,410668,160866,29965
2020/06/16,Palencia,Burgos,293,357072,59202,297870,160866,29965
2020/06/16,Palencia,León,30,460001,83260,376741,160866,29965
2020/06/16,Pontevedra,Coruña,4873,1119596,234454,885142,942665,206380
2020/06/16,Pontevedra,Ourense,183,307651,62449,245202,942665,206380
2020/06/16,Pontevedra,Pontevedra,164182,942665,207974,734691,942665,206380
2020/06/16,Pontevedra,Lugo,71,329587,55888,273699,942665,206380
2020/06/16,Rioja,Araba,912,331549,74859,256690,316798,58658
2020/06/16,Rioja,Burgos,117,357072,59202,297870,316798,58658
2020/06/16,Rioja,Rioja,45687,316798,61286,255512,316798,58658
2020/06/16,Rioja,Navarra,2049,654183,132608,521575,316798,58658
2020/06/16,Salamanca,Zamora,59,172539,26597,145942,330119,59547
2020/06/16,Salamanca,Ávila,212,157640,22396,135244,330119,59547
2020/06/16,Salamanca,Salamanca,47944,330119,59938,270181,330119,59547
2020/06/16,Santa Cruz de Tenerife,Santa Cruz de Tenerife,186962,1032983,203750,829233,1032983,203011
2020/06/16,Santa Cruz de Tenerife,Las Palmas de Gran Canaria,21,1120406,223694,896712,1032983,203011
2020/06/16,Segovia,Burgos,176,357072,59202,297870,153129,26726
2020/06/16,Segovia,Ávila,96,157640,22396,135244,153129,26726
2020/06/16,Segovia,Valladolid,343,519546,108878,410668,153129,26726
2020/06/16,Segovia,Soria,30,88636,10828,77808,153129,26726
2020/06/16,Segovia,Segovia,15641,153129,24252,128877,153129,26726
2020/06/16,Segovia,Madrid,22,6663394,1438826,5224568,153129,26726
2020/06/16,Sevilla,Ciudad Real,17,495761,60297,435464,1942389,394068
2020/06/16,Sevilla,Sevilla,295357,1942389,404336,1538053,1942389,394068
2020/06/16,Sevilla,Huelva,659,521870,91451,430419,1942389,394068
2020/06/16,Sevilla,Cádiz,1180,1240155,231627,1008528,1942389,394068
2020/06/16,Sevilla,Málaga,140,1661785,328843,1332942,1942389,394068
2020/06/16,Sevilla,Badajoz,55,673559,111035,562524,1942389,394068
2020/06/16,Sevilla,Córdoba,2188,782979,139316,643663,1942389,394068
2020/06/16,Soria,Soria,8284,88636,10828,77808,88636,12131
2020/06/16,Soria,Segovia,28,153129,24252,128877,88636,12131
2020/06/16,Soria,Burgos,118,357072,59202,297870,88636,12131
2020/06/16,Soria,Valladolid,47,519546,108878,410668,88636,12131
2020/06/16,Soria,Zaragoza,175,964724,210686,754038,88636,12131
2020/06/16,Tarragona,Barcelona,1610,5664579,1280641,4383938,804664,142831
2020/06/16,Tarragona,Tarragona,97855,804664,141685,662979,804664,142831
2020/06/16,Tarragona,Lleida,25,434930,77359,357571,804664,142831
2020/06/16,Tarragona,Teruel,78,134137,13613,120524,804664,142831
2020/06/16,Tarragona,Castellón,1015,579962,103189,476773,804664,142831
2020/06/16,Teruel,Teruel,8402,134137,13613,120524,134137,16059
2020/06/16,Teruel,Valencia,23,2565124,588008,1977116,134137,16059
2020/06/16,Teruel,Tarragona,71,804664,141685,662979,134137,16059
2020/06/16,Teruel,Castellón,54,579962,103189,476773,134137,16059
2020/06/16,Teruel,Zaragoza,347,964724,210686,754038,134137,16059
2020/06/16,Toledo,Toledo,57783,694844,116395,578449,694844,111878
2020/06/16,Toledo,Cuenca,129,196329,26908,169421,694844,111878
2020/06/16,Toledo,Ávila,260,157640,22396,135244,694844,111878
2020/06/16,Toledo,Madrid,4898,6663394,1438826,5224568,694844,111878
2020/06/16,Toledo,Ciudad Real,485,495761,60297,435464,694844,111878
2020/06/16,Toledo,Cáceres,149,394151,57657,336494,694844,111878
2020/06/16,Valencia,Albacete,417,388167,50272,337895,2565124,569499
2020/06/16,Valencia,Castellón,943,579962,103189,476773,2565124,569499
2020/06/16,Valencia,Valencia,429753,2565124,588008,1977116,2565124,569499
2020/06/16,Valencia,Alicante,1928,1858683,373473,1485210,2565124,569499
2020/06/16,Valencia,Cáceres,23,394151,57657,336494,2565124,569499
2020/06/16,Valencia,Cuenca,160,196329,26908,169421,2565124,569499
2020/06/16,Valladolid,Zamora,120,172539,26597,145942,519546,105895
2020/06/16,Valladolid,León,47,460001,83260,376741,519546,105895
2020/06/16,Valladolid,Segovia,364,153129,24252,128877,519546,105895
2020/06/16,Valladolid,Soria,73,88636,10828,77808,519546,105895
2020/06/16,Valladolid,Salamanca,53,330119,59938,270181,519546,105895
2020/06/16,Valladolid,Burgos,103,357072,59202,297870,519546,105895
2020/06/16,Valladolid,Valladolid,82611,519546,108878,410668,519546,105895
2020/06/16,Valladolid,Palencia,68,160866,28406,132460,519546,105895
2020/06/16,Valladolid,Ávila,76,157640,22396,135244,519546,105895
2020/06/16,Zamora,Ourense,92,307651,62449,245202,172539,26691
2020/06/16,Zamora,Salamanca,67,330119,59938,270181,172539,26691
2020/06/16,Zamora,León,54,460001,83260,376741,172539,26691
2020/06/16,Zamora,Zamora,18121,172539,26597,145942,172539,26691
2020/06/16,Zamora,Valladolid,109,519546,108878,410668,172539,26691
2020/06/16,Zaragoza,Navarra,655,654183,132608,521575,964724,203709
2020/06/16,Zaragoza,Zaragoza,166485,964724,210686,754038,964724,203709
2020/06/16,Zaragoza,Teruel,314,134137,13613,120524,964724,203709
2020/06/16,Zaragoza,Tarragona,31,804664,141685,662979,964724,203709
2020/06/16,Zaragoza,Huesca,370,220461,34987,185474,964724,203709
2020/06/16,Zaragoza,Lleida,118,434930,77359,357571,964724,203709
2020/06/16,Zaragoza,Soria,108,88636,10828,77808,964724,203709
2020/06/17,Albacete,Albacete,33291,388167,50270,337897,388167,51539
2020/06/17,Albacete,Ciudad Real,676,495761,61123,434638,388167,51539
2020/06/17,Albacete,Valencia,387,2565124,592168,1972956,388167,51539
2020/06/17,Albacete,Jaén,97,633564,90045,543519,388167,51539
2020/06/17,Albacete,Murcia,734,1493898,291734,1202164,388167,51539
2020/06/17,Albacete,Alicante,259,1858683,374701,1483982,388167,51539
2020/06/17,Albacete,Girona,51,771044,131902,639142,388167,51539
2020/06/17,Albacete,Cuenca,960,196329,27016,169313,388167,51539
2020/06/17,Alicante,Alicante,298735,1858683,374701,1483982,1858683,383024
2020/06/17,Alicante,Valencia,2137,2565124,592168,1972956,1858683,383024
2020/06/17,Alicante,Albacete,443,388167,50270,337897,1858683,383024
2020/06/17,Alicante,Murcia,4277,1493898,291734,1202164,1858683,383024
2020/06/17,Almería,Granada,623,914678,173311,741367,716820,124385
2020/06/17,Almería,Murcia,2367,1493898,291734,1202164,716820,124385
2020/06/17,Almería,Almería,101292,716820,121163,595657,716820,124385
2020/06/17,Araba,Araba,60141,331549,73648,257901,331549,83257
2020/06/17,Araba,Burgos,2308,357072,57815,299257,331549,83257
2020/06/17,Araba,Rioja,2367,316798,59946,256852,331549,83257
2020/06/17,Araba,Bizkaia,2679,1152934,281780,871154,331549,83257
2020/06/17,Araba,Navarra,218,654183,131419,522764,331549,83257
2020/06/17,Araba,Gipuzkoa,655,723576,141684,581892,331549,83257
2020/06/17,Asturias,Asturias,167500,1022800,201428,821372,1022800,199770
2020/06/17,Asturias,Cantabria,225,580795,117107,463688,1022800,199770
2020/06/17,Asturias,León,44,460001,83201,376800,1022800,199770
2020/06/17,Asturias,Lugo,1119,329587,56069,273518,1022800,199770
2020/06/17,Ávila,Valladolid,57,519546,110144,409402,157640,24602
2020/06/17,Ávila,Ávila,15123,157640,22797,134843,157640,24602
2020/06/17,Ávila,Cáceres,203,394151,58521,335630,157640,24602
2020/06/17,Ávila,Salamanca,430,330119,59483,270636,157640,24602
2020/06/17,Ávila,Toledo,328,694844,117314,577530,157640,24602
2020/06/17,Ávila,Madrid,219,6663394,1454296,5209098,157640,24602
2020/06/17,Ávila,Segovia,136,153129,25655,127474,157640,24602
2020/06/17,Badajoz,Badajoz,83620,673559,110696,562863,673559,109975
2020/06/17,Badajoz,Sevilla,48,1942389,409218,1533171,673559,109975
2020/06/17,Badajoz,Córdoba,86,782979,140243,642736,673559,109975
2020/06/17,Badajoz,Huelva,260,521870,92179,429691,673559,109975
2020/06/17,Badajoz,Ciudad Real,75,495761,61123,434638,673559,109975
2020/06/17,Badajoz,Cáceres,1675,394151,58521,335630,673559,109975
2020/06/17,Balears,Balears,194280,1149460,215906,933554,1149460,216712
2020/06/17,Balears,Valencia,70,2565124,592168,1972956,1149460,216712
2020/06/17,Balears,Barcelona,19,5664579,1317178,4347401,1149460,216712
2020/06/17,Barcelona,Barcelona,876021,5664579,1317178,4347401,5664579,1310378
2020/06/17,Barcelona,Tarragona,2982,804664,148884,655780,5664579,1310378
2020/06/17,Barcelona,Girona,4227,771044,131902,639142,5664579,1310378
2020/06/17,Barcelona,Lleida,302,434930,81571,353359,5664579,1310378
2020/06/17,Bizkaia,Araba,1486,331549,73648,257901,1152934,276313
2020/06/17,Bizkaia,Cantabria,3535,580795,117107,463688,1152934,276313
2020/06/17,Bizkaia,Burgos,126,357072,57815,299257,1152934,276313
2020/06/17,Bizkaia,Bizkaia,221785,1152934,281780,871154,1152934,276313
2020/06/17,Bizkaia,Gipuzkoa,1559,723576,141684,581892,1152934,276313
2020/06/17,Burgos,Bizkaia,158,1152934,281780,871154,357072,59566
2020/06/17,Burgos,Segovia,80,153129,25655,127474,357072,59566
2020/06/17,Burgos,Rioja,74,316798,59946,256852,357072,59566
2020/06/17,Burgos,Valladolid,148,519546,110144,409402,357072,59566
2020/06/17,Burgos,Soria,44,88636,10469,78167,357072,59566
2020/06/17,Burgos,Araba,1147,331549,73648,257901,357072,59566
2020/06/17,Burgos,Palencia,237,160866,28211,132655,357072,59566
2020/06/17,Burgos,Burgos,43395,357072,57815,299257,357072,59566
2020/06/17,Cáceres,Cáceres,40817,394151,58521,335630,394151,58655
2020/06/17,Cáceres,Toledo,242,694844,117314,577530,394151,58655
2020/06/17,Cáceres,Badajoz,1513,673559,110696,562863,394151,58655
2020/06/17,Cáceres,Ávila,154,157640,22797,134843,394151,58655
2020/06/17,Cádiz,Cádiz,198968,1240155,237150,1003005,1240155,244789
2020/06/17,Cádiz,Málaga,2044,1661785,330997,1330788,1240155,244789
2020/06/17,Cádiz,Sevilla,1687,1942389,409218,1533171,1240155,244789
2020/06/17,Cádiz,Huelva,776,521870,92179,429691,1240155,244789
2020/06/17,Cádiz,Ceuta,76,84777,12560,72217,1240155,244789
2020/06/17,Cantabria,Cantabria,88127,580795,117107,463688,580795,111622
2020/06/17,Cantabria,Asturias,232,1022800,201428,821372,580795,111622
2020/06/17,Cantabria,Bizkaia,966,1152934,281780,871154,580795,111622
2020/06/17,Cantabria,Palencia,45,160866,28211,132655,580795,111622
2020/06/17,Cantabria,Burgos,22,357072,57815,299257,580795,111622
2020/06/17,Castellón,Valencia,1238,2565124,592168,1972956,579962,109687
2020/06/17,Castellón,Tarragona,1108,804664,148884,655780,579962,109687
2020/06/17,Castellón,Teruel,173,134137,14399,119738,579962,109687
2020/06/17,Castellón,Castellón,78025,579962,102118,477844,579962,109687
2020/06/17,Ceuta,Cádiz,33,1240155,237150,1003005,84777,12462
2020/06/17,Ceuta,Ceuta,11924,84777,12560,72217,84777,12462
2020/06/17,Ciudad Real,Córdoba,408,782979,140243,642736,495761,57853
2020/06/17,Ciudad Real,Badajoz,53,673559,110696,562863,495761,57853
2020/06/17,Ciudad Real,Ciudad Real,39036,495761,61123,434638,495761,57853
2020/06/17,Ciudad Real,Albacete,486,388167,50270,337897,495761,57853
2020/06/17,Ciudad Real,Toledo,637,694844,117314,577530,495761,57853
2020/06/17,Ciudad Real,Cuenca,86,196329,27016,169313,495761,57853
2020/06/17,Córdoba,Granada,120,914678,173311,741367,782979,136651
2020/06/17,Córdoba,Sevilla,2282,1942389,409218,1533171,782979,136651
2020/06/17,Córdoba,Córdoba,100288,782979,140243,642736,782979,136651
2020/06/17,Córdoba,Badajoz,109,673559,110696,562863,782979,136651
2020/06/17,Córdoba,Málaga,391,1661785,330997,1330788,782979,136651
2020/06/17,Córdoba,Jaén,777,633564,90045,543519,782979,136651
2020/06/17,Córdoba,Ciudad Real,267,495761,61123,434638,782979,136651
2020/06/17,Coruña,Lugo,768,329587,56069,273518,1119596,240201
2020/06/17,Coruña,Pontevedra,6945,942665,211770,730895,1119596,240201
2020/06/17,Coruña,Coruña,184687,1119596,237567,882029,1119596,240201
2020/06/17,Cuenca,Valencia,96,2565124,592168,1972956,196329,28428
2020/06/17,Cuenca,Albacete,899,388167,50270,337897,196329,28428
2020/06/17,Cuenca,Ciudad Real,202,495761,61123,434638,196329,28428
2020/06/17,Cuenca,Toledo,211,694844,117314,577530,196329,28428
2020/06/17,Cuenca,Guadalajara,70,257762,48695,209067,196329,28428
2020/06/17,Cuenca,Madrid,78,6663394,1454296,5209098,196329,28428
2020/06/17,Cuenca,Cuenca,15023,196329,27016,169313,196329,28428
2020/06/17,Gipuzkoa,Bizkaia,2459,1152934,281780,871154,723576,146460
2020/06/17,Gipuzkoa,Navarra,590,654183,131419,522764,723576,146460
2020/06/17,Gipuzkoa,Gipuzkoa,110654,723576,141684,581892,723576,146460
2020/06/17,Gipuzkoa,Araba,587,331549,73648,257901,723576,146460
2020/06/17,Girona,Girona,91515,771044,131902,639142,771044,140021
2020/06/17,Girona,Barcelona,3676,5664579,1317178,4347401,771044,140021
2020/06/17,Girona,Lleida,262,434930,81571,353359,771044,140021
2020/06/17,Granada,Almería,736,716820,121163,595657,914678,171100
2020/06/17,Granada,Córdoba,195,782979,140243,642736,914678,171100
2020/06/17,Granada,Jaén,515,633564,90045,543519,914678,171100
2020/06/17,Granada,Murcia,194,1493898,291734,1202164,914678,171100
2020/06/17,Granada,Málaga,284,1661785,330997,1330788,914678,171100
2020/06/17,Granada,Granada,129098,914678,173311,741367,914678,171100
2020/06/17,Guadalajara,Madrid,3607,6663394,1454296,5209098,257762,52936
2020/06/17,Guadalajara,Teruel,44,134137,14399,119738,257762,52936
2020/06/17,Guadalajara,Guadalajara,28460,257762,48695,209067,257762,52936
2020/06/17,Guadalajara,Cuenca,64,196329,27016,169313,257762,52936
2020/06/17,Huelva,Badajoz,375,673559,110696,562863,521870,98133
2020/06/17,Huelva,Sevilla,2033,1942389,409218,1533171,521870,98133
2020/06/17,Huelva,Cádiz,546,1240155,237150,1003005,521870,98133
2020/06/17,Huelva,Huelva,71881,521870,92179,429691,521870,98133
2020/06/17,Huesca,Lleida,1406,434930,81571,353359,220461,40856
2020/06/17,Huesca,Huesca,24410,220461,35895,184566,220461,40856
2020/06/17,Huesca,Zaragoza,456,964724,217835,746889,220461,40856
2020/06/17,Jaén,Córdoba,941,782979,140243,642736,633564,88720
2020/06/17,Jaén,Granada,409,914678,173311,741367,633564,88720
2020/06/17,Jaén,Jaén,62986,633564,90045,543519,633564,88720
2020/06/17,Jaén,Albacete,59,388167,50270,337897,633564,88720
2020/06/17,Las Palmas de Gran Canaria,Santa Cruz de Tenerife,17,1032983,201759,831224,1120406,224169
2020/06/17,Las Palmas de Gran Canaria,Las Palmas de Gran Canaria,210586,1120406,224760,895646,1120406,224169
2020/06/17,León,Lugo,37,329587,56069,273518,460001,83548
2020/06/17,León,Palencia,64,160866,28211,132655,460001,83548
2020/06/17,León,Zamora,170,172539,28796,143743,460001,83548
2020/06/17,León,León,64111,460001,83201,376800,460001,83548
2020/06/17,León,Asturias,111,1022800,201428,821372,460001,83548
2020/06/17,León,Ourense,378,307651,63677,243974,460001,83548
2020/06/17,León,Valladolid,48,519546,110144,409402,460001,83548
2020/06/17,Lleida,Huesca,783,220461,35895,184566,434930,79901
2020/06/17,Lleida,Barcelona,419,5664579,1317178,4347401,434930,79901
2020/06/17,Lleida,Tarragona,18,804664,148884,655780,434930,79901
2020/06/17,Lleida,Lleida,55453,434930,81571,353359,434930,79901
2020/06/17,Lleida,Zaragoza,274,964724,217835,746889,434930,79901
2020/06/17,Lleida,Girona,248,771044,131902,639142,434930,79901
2020/06/17,Lugo,Asturias,872,1022800,201428,821372,329587,58096
2020/06/17,Lugo,Lugo,39666,329587,56069,273518,329587,58096
2020/06/17,Lugo,Pontevedra,110,942665,211770,730895,329587,58096
2020/06/17,Lugo,Coruña,781,1119596,237567,882029,329587,58096
2020/06/17,Lugo,Ourense,373,307651,63677,243974,329587,58096
2020/06/17,Madrid,Guadalajara,4125,257762,48695,209067,6663394,1448931
2020/06/17,Madrid,Cuenca,102,196329,27016,169313,6663394,1448931
2020/06/17,Madrid,Madrid,938979,6663394,1454296,5209098,6663394,1448931
2020/06/17,Madrid,Segovia,71,153129,25655,127474,6663394,1448931
2020/06/17,Madrid,Ávila,335,157640,22797,134843,6663394,1448931
2020/06/17,Madrid,Toledo,5540,694844,117314,577530,6663394,1448931
2020/06/17,Málaga,Almería,16,716820,121163,595657,1661785,336845
2020/06/17,Málaga,Cádiz,1856,1240155,237150,1003005,1661785,336845
2020/06/17,Málaga,Sevilla,428,1942389,409218,1533171,1661785,336845
2020/06/17,Málaga,Málaga,279448,1661785,330997,1330788,1661785,336845
2020/06/17,Málaga,Córdoba,356,782979,140243,642736,1661785,336845
2020/06/17,Málaga,Granada,428,914678,173311,741367,1661785,336845
2020/06/17,Melilla,Melilla,16211,86487,16354,70133,86487,16468
2020/06/17,Murcia,Murcia,233232,1493898,291734,1202164,1493898,285439
2020/06/17,Murcia,Girona,51,771044,131902,639142,1493898,285439
2020/06/17,Murcia,Alicante,3262,1858683,374701,1483982,1493898,285439
2020/06/17,Murcia,Albacete,634,388167,50270,337897,1493898,285439
2020/06/17,Murcia,Almería,1519,716820,121163,595657,1493898,285439
2020/06/17,Navarra,Rioja,3013,316798,59946,256852,654183,134143
2020/06/17,Navarra,Araba,60,331549,73648,257901,654183,134143
2020/06/17,Navarra,Navarra,98240,654183,131419,522764,654183,134143
2020/06/17,Navarra,Zaragoza,920,964724,217835,746889,654183,134143
2020/06/17,Navarra,Gipuzkoa,545,723576,141684,581892,654183,134143
2020/06/17,Navarra,Soria,27,88636,10469,78167,654183,134143
2020/06/17,Ourense,Pontevedra,296,942665,211770,730895,307651,64209
2020/06/17,Ourense,Lugo,245,329587,56069,273518,307651,64209
2020/06/17,Ourense,León,328,460001,83201,376800,307651,64209
2020/06/17,Ourense,Zamora,60,172539,28796,143743,307651,64209
2020/06/17,Ourense,Ourense,49141,307651,63677,243974,307651,64209
2020/06/17,Palencia,Valladolid,444,519546,110144,409402,160866,29910
2020/06/17,Palencia,Cantabria,228,580795,117107,463688,160866,29910
2020/06/17,Palencia,León,22,460001,83201,376800,160866,29910
2020/06/17,Palencia,Burgos,260,357072,57815,299257,160866,29910
2020/06/17,Palencia,Palencia,20423,160866,28211,132655,160866,29910
2020/06/17,Pontevedra,Coruña,5048,1119596,237567,882029,942665,209797
2020/06/17,Pontevedra,Pontevedra,167224,942665,211770,730895,942665,209797
2020/06/17,Pontevedra,Ourense,238,307651,63677,243974,942665,209797
2020/06/17,Pontevedra,Lugo,114,329587,56069,273518,942665,209797
2020/06/17,Rioja,Burgos,120,357072,57815,299257,316798,57535
2020/06/17,Rioja,Rioja,44581,316798,59946,256852,316798,57535
2020/06/17,Rioja,Navarra,2000,654183,131419,522764,316798,57535
2020/06/17,Rioja,Araba,892,331549,73648,257901,316798,57535
2020/06/17,Salamanca,Ávila,230,157640,22797,134843,330119,59413
2020/06/17,Salamanca,Salamanca,47566,330119,59483,270636,330119,59413
2020/06/17,Salamanca,Zamora,80,172539,28796,143743,330119,59413
2020/06/17,Santa Cruz de Tenerife,Las Palmas de Gran Canaria,24,1120406,224760,895646,1032983,201296
2020/06/17,Santa Cruz de Tenerife,Santa Cruz de Tenerife,184453,1032983,201759,831224,1032983,201296
2020/06/17,Segovia,Burgos,188,357072,57815,299257,153129,28225
2020/06/17,Segovia,Ávila,152,157640,22797,134843,153129,28225
2020/06/17,Segovia,Segovia,17244,153129,25655,127474,153129,28225
2020/06/17,Segovia,Valladolid,402,519546,110144,409402,153129,28225
2020/06/17,Segovia,Madrid,20,6663394,1454296,5209098,153129,28225
2020/06/17,Sevilla,Córdoba,2284,782979,140243,642736,1942389,396854
2020/06/17,Sevilla,Cádiz,1178,1240155,237150,1003005,1942389,396854
2020/06/17,Sevilla,Huelva,659,521870,92179,429691,1942389,396854
2020/06/17,Sevilla,Badajoz,65,673559,110696,562863,1942389,396854
2020/06/17,Sevilla,Sevilla,298342,1942389,409218,1533171,1942389,396854
2020/06/17,Sevilla,Málaga,255,1661785,330997,1330788,1942389,396854
2020/06/17,Soria,Zaragoza,215,964724,217835,746889,88636,11854
2020/06/17,Soria,Burgos,113,357072,57815,299257,88636,11854
2020/06/17,Soria,Valladolid,34,519546,110144,409402,88636,11854
2020/06/17,Soria,Soria,7878,88636,10469,78167,88636,11854
2020/06/17,Soria,Segovia,18,153129,25655,127474,88636,11854
2020/06/17,Tarragona,Teruel,76,134137,14399,119738,804664,150177
2020/06/17,Tarragona,Tarragona,103670,804664,148884,655780,804664,150177
2020/06/17,Tarragona,Barcelona,1951,5664579,1317178,4347401,804664,150177
2020/06/17,Tarragona,Zaragoza,42,964724,217835,746889,804664,150177
2020/06/17,Tarragona,Lleida,46,434930,81571,353359,804664,150177
2020/06/17,Tarragona,Castellón,1018,579962,102118,477844,804664,150177
2020/06/17,Teruel,Zaragoza,388,964724,217835,746889,134137,16974
2020/06/17,Teruel,Castellón,68,579962,102118,477844,134137,16974
2020/06/17,Teruel,Tarragona,221,804664,148884,655780,134137,16974
2020/06/17,Teruel,Teruel,8812,134137,14399,119738,134137,16974
2020/06/17,Teruel,Valencia,56,2565124,592168,1972956,134137,16974
2020/06/17,Toledo,Ávila,307,157640,22797,134843,694844,112918
2020/06/17,Toledo,Madrid,4900,6663394,1454296,5209098,694844,112918
2020/06/17,Toledo,Cuenca,134,196329,27016,169313,694844,112918
2020/06/17,Toledo,Toledo,58674,694844,117314,577530,694844,112918
2020/06/17,Toledo,Cáceres,103,394151,58521,335630,694844,112918
2020/06/17,Toledo,Ciudad Real,413,495761,61123,434638,694844,112918
2020/06/17,Valencia,Castellón,876,579962,102118,477844,2565124,574316
2020/06/17,Valencia,Albacete,366,388167,50270,337897,2565124,574316
2020/06/17,Valencia,Cuenca,171,196329,27016,169313,2565124,574316
2020/06/17,Valencia,Valencia,434408,2565124,592168,1972956,2565124,574316
2020/06/17,Valencia,Alicante,1684,1858683,374701,1483982,2565124,574316
2020/06/17,Valencia,Teruel,18,134137,14399,119738,2565124,574316
2020/06/17,Valladolid,Burgos,88,357072,57815,299257,519546,106552
2020/06/17,Valladolid,Valladolid,83644,519546,110144,409402,519546,106552
2020/06/17,Valladolid,Palencia,133,160866,28211,132655,519546,106552
2020/06/17,Valladolid,Segovia,386,153129,25655,127474,519546,106552
2020/06/17,Valladolid,Soria,24,88636,10469,78167,519546,106552
2020/06/17,Valladolid,León,48,460001,83201,376800,519546,106552
2020/06/17,Valladolid,Zamora,168,172539,28796,143743,519546,106552
2020/06/17,Zamora,Salamanca,35,330119,59483,270636,172539,28829
2020/06/17,Zamora,Zamora,20345,172539,28796,143743,172539,28829
2020/06/17,Zamora,Ourense,86,307651,63677,243974,172539,28829
2020/06/17,Zamora,Valladolid,119,519546,110144,409402,172539,28829
2020/06/17,Zamora,León,52,460001,83201,376800,172539,28829
2020/06/17,Zaragoza,Valencia,16,2565124,592168,1972956,964724,210112
2020/06/17,Zaragoza,Soria,93,88636,10469,78167,964724,210112
2020/06/17,Zaragoza,Zaragoza,172580,964724,217835,746889,964724,210112
2020/06/17,Zaragoza,Navarra,721,654183,131419,522764,964724,210112
2020/06/17,Zaragoza,Lleida,137,434930,81571,353359,964724,210112
2020/06/17,Zaragoza,Teruel,476,134137,14399,119738,964724,210112
2020/06/17,Zaragoza,Huesca,418,220461,35895,184566,964724,210112
2020/06/18,Albacete,Valencia,391,2565124,593844,1971280,388167,53028
2020/06/18,Albacete,Albacete,34262,388167,51551,336616,388167,53028
2020/06/18,Albacete,Cuenca,911,196329,27500,168829,388167,53028
2020/06/18,Albacete,Jaén,67,633564,91778,541786,388167,53028
2020/06/18,Albacete,Ciudad Real,753,495761,62021,433740,388167,53028
2020/06/18,Albacete,Alicante,291,1858683,379844,1478839,388167,53028
2020/06/18,Albacete,Murcia,741,1493898,294741,1199157,388167,53028
2020/06/18,Alicante,Albacete,434,388167,51551,336616,1858683,388009
2020/06/18,Alicante,Valencia,2357,2565124,593844,1971280,1858683,388009
2020/06/18,Alicante,Murcia,4177,1493898,294741,1199157,1858683,388009
2020/06/18,Alicante,Alicante,301738,1858683,379844,1478839,1858683,388009
2020/06/18,Almería,Granada,627,914678,174196,740482,716820,123208
2020/06/18,Almería,Murcia,2094,1493898,294741,1199157,716820,123208
2020/06/18,Almería,Almería,99185,716820,120624,596196,716820,123208
2020/06/18,Araba,Rioja,2439,316798,62455,254343,331549,84703
2020/06/18,Araba,Navarra,215,654183,135324,518859,331549,84703
2020/06/18,Araba,Gipuzkoa,671,723576,146113,577463,331549,84703
2020/06/18,Araba,Bizkaia,3115,1152934,288616,864318,331549,84703
2020/06/18,Araba,Araba,61197,331549,75401,256148,331549,84703
2020/06/18,Araba,Burgos,2307,357072,61158,295914,331549,84703
2020/06/18,Asturias,León,38,460001,85428,374573,1022800,208495
2020/06/18,Asturias,Lugo,1204,329587,57068,272519,1022800,208495
2020/06/18,Asturias,Asturias,175455,1022800,209381,813419,1022800,208495
2020/06/18,Asturias,Cantabria,270,580795,119878,460917,1022800,208495
2020/06/18,Ávila,Valladolid,48,519546,112379,407167,157640,24634
2020/06/18,Ávila,Madrid,205,6663394,1475101,5188293,157640,24634
2020/06/18,Ávila,Toledo,313,694844,117115,577729,157640,24634
2020/06/18,Ávila,Ávila,15208,157640,23032,134608,157640,24634
2020/06/18,Ávila,Salamanca,291,330119,60076,270043,157640,24634
2020/06/18,Ávila,Cáceres,113,394151,59304,334847,157640,24634
2020/06/18,Ávila,Segovia,135,153129,26051,127078,157640,24634
2020/06/18,Badajoz,Ciudad Real,43,495761,62021,433740,673559,110591
2020/06/18,Badajoz,Sevilla,130,1942389,413541,1528848,673559,110591
2020/06/18,Badajoz,Huelva,189,521870,94192,427678,673559,110591
2020/06/18,Badajoz,Cáceres,1646,394151,59304,334847,673559,110591
2020/06/18,Badajoz,Córdoba,93,782979,142702,640277,673559,110591
2020/06/18,Badajoz,Badajoz,83937,673559,111735,561824,673559,110591
2020/06/18,Balears,Balears,199456,1149460,220850,928610,1149460,222229
2020/06/18,Balears,Valencia,51,2565124,593844,1971280,1149460,222229
2020/06/18,Balears,Barcelona,34,5664579,1311278,4353301,1149460,222229
2020/06/18,Barcelona,Lleida,315,434930,80867,354063,5664579,1294911
2020/06/18,Barcelona,Girona,3704,771044,128607,642437,5664579,1294911
2020/06/18,Barcelona,Tarragona,2867,804664,145070,659594,5664579,1294911
2020/06/18,Barcelona,Barcelona,869015,5664579,1311278,4353301,5664579,1294911
2020/06/18,Bizkaia,Cantabria,3710,580795,119878,460917,1152934,282679
2020/06/18,Bizkaia,Gipuzkoa,1723,723576,146113,577463,1152934,282679
2020/06/18,Bizkaia,Burgos,104,357072,61158,295914,1152934,282679
2020/06/18,Bizkaia,Bizkaia,227857,1152934,288616,864318,1152934,282679
2020/06/18,Bizkaia,Araba,1521,331549,75401,256148,1152934,282679
2020/06/18,Burgos,Araba,1234,331549,75401,256148,357072,62852
2020/06/18,Burgos,Rioja,91,316798,62455,254343,357072,62852
2020/06/18,Burgos,Segovia,121,153129,26051,127078,357072,62852
2020/06/18,Burgos,Bizkaia,202,1152934,288616,864318,357072,62852
2020/06/18,Burgos,Cantabria,29,580795,119878,460917,357072,62852
2020/06/18,Burgos,Valladolid,121,519546,112379,407167,357072,62852
2020/06/18,Burgos,Soria,92,88636,11139,77497,357072,62852
2020/06/18,Burgos,Burgos,46558,357072,61158,295914,357072,62852
2020/06/18,Burgos,Palencia,242,160866,29148,131718,357072,62852
2020/06/18,Cáceres,Cáceres,41360,394151,59304,334847,394151,59853
2020/06/18,Cáceres,Ávila,171,157640,23032,134608,394151,59853
2020/06/18,Cáceres,Valencia,22,2565124,593844,1971280,394151,59853
2020/06/18,Cáceres,Badajoz,1651,673559,111735,561824,394151,59853
2020/06/18,Cáceres,Toledo,246,694844,117115,577729,394151,59853
2020/06/18,Cádiz,Cádiz,203909,1240155,242384,997771,1240155,252160
2020/06/18,Cádiz,Sevilla,1990,1942389,413541,1528848,1240155,252160
2020/06/18,Cádiz,Málaga,2310,1661785,333059,1328726,1240155,252160
2020/06/18,Cádiz,Ceuta,100,84777,12575,72202,1240155,252160
2020/06/18,Cádiz,Huelva,795,521870,94192,427678,1240155,252160
2020/06/18,Cantabria,Bizkaia,1185,1152934,288616,864318,580795,114549
2020/06/18,Cantabria,Cantabria,91004,580795,119878,460917,580795,114549
2020/06/18,Cantabria,Palencia,70,160866,29148,131718,580795,114549
2020/06/18,Cantabria,Asturias,249,1022800,209381,813419,580795,114549
2020/06/18,Castellón,Castellón,78944,579962,103039,476923,579962,111066
2020/06/18,Castellón,Valencia,1349,2565124,593844,1971280,579962,111066
2020/06/18,Castellón,Teruel,66,134137,14309,119828,579962,111066
2020/06/18,Castellón,Tarragona,1051,804664,145070,659594,579962,111066
2020/06/18,Ceuta,Ceuta,11900,84777,12575,72202,84777,12421
2020/06/18,Ceuta,Cádiz,20,1240155,242384,997771,84777,12421
2020/06/18,Ciudad Real,Cuenca,76,196329,27500,168829,495761,58171
2020/06/18,Ciudad Real,Albacete,557,388167,51551,336616,495761,58171
2020/06/18,Ciudad Real,Badajoz,54,673559,111735,561824,495761,58171
2020/06/18,Ciudad Real,Córdoba,401,782979,142702,640277,495761,58171
2020/06/18,Ciudad Real,Toledo,653,694844,117115,577729,495761,58171
2020/06/18,Ciudad Real,Madrid,16,6663394,1475101,5188293,495761,58171
2020/06/18,Ciudad Real,Ciudad Real,39595,495761,62021,433740,495761,58171
2020/06/18,Córdoba,Granada,169,914678,174196,740482,782979,139029
2020/06/18,Córdoba,Málaga,442,1661785,333059,1328726,782979,139029
2020/06/18,Córdoba,Ciudad Real,291,495761,62021,433740,782979,139029
2020/06/18,Córdoba,Sevilla,2288,1942389,413541,1528848,782979,139029
2020/06/18,Córdoba,Jaén,851,633564,91778,541786,782979,139029
2020/06/18,Córdoba,Badajoz,102,673559,111735,561824,782979,139029
2020/06/18,Córdoba,Córdoba,101733,782979,142702,640277,782979,139029
2020/06/18,Coruña,Lugo,795,329587,57068,272519,1119596,244841
2020/06/18,Coruña,Coruña,187899,1119596,242105,877491,1119596,244841
2020/06/18,Coruña,Pontevedra,6756,942665,215234,727431,1119596,244841
2020/06/18,Cuenca,Guadalajara,97,257762,49410,208352,196329,29517
2020/06/18,Cuenca,Valencia,104,2565124,593844,1971280,196329,29517
2020/06/18,Cuenca,Madrid,78,6663394,1475101,5188293,196329,29517
2020/06/18,Cuenca,Albacete,901,388167,51551,336616,196329,29517
2020/06/18,Cuenca,Ciudad Real,148,495761,62021,433740,196329,29517
2020/06/18,Cuenca,Toledo,303,694844,117115,577729,196329,29517
2020/06/18,Cuenca,Cuenca,15445,196329,27500,168829,196329,29517
2020/06/18,Gipuzkoa,Navarra,648,654183,135324,518859,723576,150720
2020/06/18,Gipuzkoa,Gipuzkoa,114080,723576,146113,577463,723576,150720
2020/06/18,Gipuzkoa,Araba,643,331549,75401,256148,723576,150720
2020/06/18,Gipuzkoa,Bizkaia,3006,1152934,288616,864318,723576,150720
2020/06/18,Girona,Girona,88591,771044,128607,642437,771044,141534
2020/06/18,Girona,Barcelona,3556,5664579,1311278,4353301,771044,141534
2020/06/18,Girona,Lleida,276,434930,80867,354063,771044,141534
2020/06/18,Granada,Córdoba,238,782979,142702,640277,914678,172087
2020/06/18,Granada,Almería,735,716820,120624,596196,914678,172087
2020/06/18,Granada,Málaga,375,1661785,333059,1328726,914678,172087
2020/06/18,Granada,Granada,128854,914678,174196,740482,914678,172087
2020/06/18,Granada,Jaén,542,633564,91778,541786,914678,172087
2020/06/18,Granada,Murcia,166,1493898,294741,1199157,914678,172087
2020/06/18,Guadalajara,Madrid,3581,6663394,1475101,5188293,257762,52588
2020/06/18,Guadalajara,Guadalajara,28653,257762,49410,208352,257762,52588
2020/06/18,Guadalajara,Cuenca,49,196329,27500,168829,257762,52588
2020/06/18,Guadalajara,Teruel,52,134137,14309,119828,257762,52588
2020/06/18,Huelva,Cádiz,649,1240155,242384,997771,521870,102043
2020/06/18,Huelva,Sevilla,2711,1942389,413541,1528848,521870,102043
2020/06/18,Huelva,Badajoz,467,673559,111735,561824,521870,102043
2020/06/18,Huelva,Huelva,73790,521870,94192,427678,521870,102043
2020/06/18,Huesca,Zaragoza,630,964724,220442,744282,220461,40176
2020/06/18,Huesca,Lleida,1056,434930,80867,354063,220461,40176
2020/06/18,Huesca,Huesca,24614,220461,36087,184374,220461,40176
2020/06/18,Jaén,Granada,390,914678,174196,740482,633564,90088
2020/06/18,Jaén,Albacete,47,388167,51551,336616,633564,90088
2020/06/18,Jaén,Jaén,64115,633564,91778,541786,633564,90088
2020/06/18,Jaén,Córdoba,908,782979,142702,640277,633564,90088
2020/06/18,Las Palmas de Gran Canaria,Las Palmas de Gran Canaria,214361,1120406,228252,892154,1120406,228201
2020/06/18,León,Zamora,211,172539,27546,144993,460001,85398
2020/06/18,León,Valladolid,40,519546,112379,407167,460001,85398
2020/06/18,León,Lugo,35,329587,57068,272519,460001,85398
2020/06/18,León,Palencia,76,160866,29148,131718,460001,85398
2020/06/18,León,León,65835,460001,85428,374573,460001,85398
2020/06/18,León,Ourense,393,307651,64379,243272,460001,85398
2020/06/18,León,Asturias,24,1022800,209381,813419,460001,85398
2020/06/18,Lleida,Tarragona,32,804664,145070,659594,434930,80745
2020/06/18,Lleida,Lleida,54347,434930,80867,354063,434930,80745
2020/06/18,Lleida,Zaragoza,195,964724,220442,744282,434930,80745
2020/06/18,Lleida,Huesca,788,220461,36087,184374,434930,80745
2020/06/18,Lleida,Girona,264,771044,128607,642437,434930,80745
2020/06/18,Lleida,Barcelona,378,5664579,1311278,4353301,434930,80745
2020/06/18,Lugo,Asturias,879,1022800,209381,813419,329587,59612
2020/06/18,Lugo,Ourense,228,307651,64379,243272,329587,59612
2020/06/18,Lugo,Coruña,893,1119596,242105,877491,329587,59612
2020/06/18,Lugo,Pontevedra,41,942665,215234,727431,329587,59612
2020/06/18,Lugo,Lugo,40425,329587,57068,272519,329587,59612
2020/06/18,Madrid,Ávila,264,157640,23032,134608,6663394,1467723
2020/06/18,Madrid,Toledo,5453,694844,117115,577729,6663394,1467723
2020/06/18,Madrid,Ciudad Real,29,495761,62021,433740,6663394,1467723
2020/06/18,Madrid,Madrid,954403,6663394,1475101,5188293,6663394,1467723
2020/06/18,Madrid,Segovia,89,153129,26051,127078,6663394,1467723
2020/06/18,Madrid,Cuenca,127,196329,27500,168829,6663394,1467723
2020/06/18,Madrid,Guadalajara,4575,257762,49410,208352,6663394,1467723
2020/06/18,Málaga,Sevilla,360,1942389,413541,1528848,1661785,338590
2020/06/18,Málaga,Málaga,279691,1661785,333059,1328726,1661785,338590
2020/06/18,Málaga,Córdoba,533,782979,142702,640277,1661785,338590
2020/06/18,Málaga,Granada,450,914678,174196,740482,1661785,338590
2020/06/18,Málaga,Cádiz,1965,1240155,242384,997771,1661785,338590
2020/06/18,Melilla,Melilla,16697,86487,17018,69469,86487,16829
2020/06/18,Murcia,Alicante,3335,1858683,379844,1478839,1493898,289537
2020/06/18,Murcia,Murcia,237113,1493898,294741,1199157,1493898,289537
2020/06/18,Murcia,Granada,32,914678,174196,740482,1493898,289537
2020/06/18,Murcia,Almería,1530,716820,120624,596196,1493898,289537
2020/06/18,Murcia,Albacete,643,388167,51551,336616,1493898,289537
2020/06/18,Navarra,Navarra,102087,654183,135324,518859,654183,137283
2020/06/18,Navarra,Gipuzkoa,563,723576,146113,577463,654183,137283
2020/06/18,Navarra,Zaragoza,846,964724,220442,744282,654183,137283
2020/06/18,Navarra,Araba,63,331549,75401,256148,654183,137283
2020/06/18,Navarra,Rioja,2986,316798,62455,254343,654183,137283
2020/06/18,Navarra,Alicante,16,1858683,379844,1478839,654183,137283
2020/06/18,Ourense,León,371,460001,85428,374573,307651,65200
2020/06/18,Ourense,Lugo,322,329587,57068,272519,307651,65200
2020/06/18,Ourense,Zamora,59,172539,27546,144993,307651,65200
2020/06/18,Ourense,Pontevedra,263,942665,215234,727431,307651,65200
2020/06/18,Ourense,Ourense,49584,307651,64379,243272,307651,65200
2020/06/18,Palencia,León,60,460001,85428,374573,160866,31011
2020/06/18,Palencia,Burgos,321,357072,61158,295914,160866,31011
2020/06/18,Palencia,Cantabria,236,580795,119878,460917,160866,31011
2020/06/18,Palencia,Valladolid,546,519546,112379,407167,160866,31011
2020/06/18,Palencia,Palencia,21345,160866,29148,131718,160866,31011
2020/06/18,Pontevedra,Lugo,85,329587,57068,272519,942665,213259
2020/06/18,Pontevedra,Ourense,224,307651,64379,243272,942665,213259
2020/06/18,Pontevedra,Coruña,4938,1119596,242105,877491,942665,213259
2020/06/18,Pontevedra,Pontevedra,169643,942665,215234,727431,942665,213259
2020/06/18,Rioja,Zaragoza,19,964724,220442,744282,316798,59838
2020/06/18,Rioja,Araba,931,331549,75401,256148,316798,59838
2020/06/18,Rioja,Navarra,2222,654183,135324,518859,316798,59838
2020/06/18,Rioja,Bizkaia,16,1152934,288616,864318,316798,59838
2020/06/18,Rioja,Rioja,46659,316798,62455,254343,316798,59838
2020/06/18,Rioja,Burgos,37,357072,61158,295914,316798,59838
2020/06/18,Salamanca,Ávila,305,157640,23032,134608,330119,59781
2020/06/18,Salamanca,Zamora,60,172539,27546,144993,330119,59781
2020/06/18,Salamanca,Salamanca,47840,330119,60076,270043,330119,59781
2020/06/18,Santa Cruz de Tenerife,Santa Cruz de Tenerife,189558,1032983,205512,827471,1032983,205149
2020/06/18,Santa Cruz de Tenerife,Las Palmas de Gran Canaria,82,1120406,228252,892154,1032983,205149
2020/06/18,Segovia,Valladolid,403,519546,112379,407167,153129,29231
2020/06/18,Segovia,Ávila,97,157640,23032,134608,153129,29231
2020/06/18,Segovia,Burgos,176,357072,61158,295914,153129,29231
2020/06/18,Segovia,Segovia,17597,153129,26051,127078,153129,29231
2020/06/18,Segovia,Madrid,59,6663394,1475101,5188293,153129,29231
2020/06/18,Sevilla,Huelva,730,521870,94192,427678,1942389,398694
2020/06/18,Sevilla,Badajoz,117,673559,111735,561824,1942389,398694
2020/06/18,Sevilla,Córdoba,2503,782979,142702,640277,1942389,398694
2020/06/18,Sevilla,Sevilla,298575,1942389,413541,1528848,1942389,398694
2020/06/18,Sevilla,Cádiz,1404,1240155,242384,997771,1942389,398694
2020/06/18,Sevilla,Málaga,230,1661785,333059,1328726,1942389,398694
2020/06/18,Soria,Burgos,109,357072,61158,295914,88636,12625
2020/06/18,Soria,Valladolid,31,519546,112379,407167,88636,12625
2020/06/18,Soria,Zaragoza,198,964724,220442,744282,88636,12625
2020/06/18,Soria,Soria,8413,88636,11139,77497,88636,12625
2020/06/18,Soria,Segovia,20,153129,26051,127078,88636,12625
2020/06/18,Tarragona,Lleida,24,434930,80867,354063,804664,150239
2020/06/18,Tarragona,Barcelona,2027,5664579,1311278,4353301,804664,150239
2020/06/18,Tarragona,Teruel,94,134137,14309,119828,804664,150239
2020/06/18,Tarragona,Tarragona,100112,804664,145070,659594,804664,150239
2020/06/18,Tarragona,Castellón,1016,579962,103039,476923,804664,150239
2020/06/18,Teruel,Castellón,63,579962,103039,476923,134137,17260
2020/06/18,Teruel,Zaragoza,562,964724,220442,744282,134137,17260
2020/06/18,Teruel,Valencia,25,2565124,593844,1971280,134137,17260
2020/06/18,Teruel,Teruel,8841,134137,14309,119828,134137,17260
2020/06/18,Teruel,Tarragona,123,804664,145070,659594,134137,17260
2020/06/18,Teruel,Guadalajara,22,257762,49410,208352,134137,17260
2020/06/18,Toledo,Cáceres,136,394151,59304,334847,694844,113326
2020/06/18,Toledo,Ávila,291,157640,23032,134608,694844,113326
2020/06/18,Toledo,Madrid,4998,6663394,1475101,5188293,694844,113326
2020/06/18,Toledo,Cuenca,185,196329,27500,168829,694844,113326
2020/06/18,Toledo,Toledo,58288,694844,117115,577729,694844,113326
2020/06/18,Toledo,Ciudad Real,500,495761,62021,433740,694844,113326
2020/06/18,Valencia,Alicante,1939,1858683,379844,1478839,2565124,575892
2020/06/18,Valencia,Albacete,426,388167,51551,336616,2565124,575892
2020/06/18,Valencia,Castellón,1008,579962,103039,476923,2565124,575892
2020/06/18,Valencia,Cuenca,130,196329,27500,168829,2565124,575892
2020/06/18,Valencia,Murcia,25,1493898,294741,1199157,2565124,575892
2020/06/18,Valencia,Valencia,437019,2565124,593844,1971280,2565124,575892
2020/06/18,Valencia,Teruel,21,134137,14309,119828,2565124,575892
2020/06/18,Valladolid,Soria,29,88636,11139,77497,519546,108503
2020/06/18,Valladolid,Burgos,142,357072,61158,295914,519546,108503
2020/06/18,Valladolid,Valladolid,85459,519546,112379,407167,519546,108503
2020/06/18,Valladolid,Palencia,123,160866,29148,131718,519546,108503
2020/06/18,Valladolid,León,45,460001,85428,374573,519546,108503
2020/06/18,Valladolid,Zamora,157,172539,27546,144993,519546,108503
2020/06/18,Valladolid,Segovia,422,153129,26051,127078,519546,108503
2020/06/18,Valladolid,Ávila,30,157640,23032,134608,519546,108503
2020/06/18,Zamora,Ourense,57,307651,64379,243272,172539,28034
2020/06/18,Zamora,Zamora,19475,172539,27546,144993,172539,28034
2020/06/18,Zamora,León,61,460001,85428,374573,172539,28034
2020/06/18,Zamora,Valladolid,146,519546,112379,407167,172539,28034
2020/06/18,Zaragoza,Lleida,110,434930,80867,354063,964724,212296
2020/06/18,Zaragoza,Huesca,398,220461,36087,184374,964724,212296
2020/06/18,Zaragoza,Teruel,412,134137,14309,119828,964724,212296
2020/06/18,Zaragoza,Soria,109,88636,11139,77497,964724,212296
2020/06/18,Zaragoza,Navarra,682,654183,135324,518859,964724,212296
2020/06/18,Zaragoza,Zaragoza,174060,964724,220442,744282,964724,212296
2020/06/19,Albacete,Valencia,388,2565124,594555,1970569,388167,52833
2020/06/19,Albacete,Albacete,35060,388167,51690,336477,388167,52833
2020/06/19,Albacete,Alicante,273,1858683,376279,1482404,388167,52833
2020/06/19,Albacete,Jaén,47,633564,92374,541190,388167,52833
2020/06/19,Albacete,Cuenca,907,196329,26775,169554,388167,52833
2020/06/19,Albacete,Ciudad Real,733,495761,62082,433679,388167,52833
2020/06/19,Albacete,Murcia,577,1493898,293449,1200449,388167,52833
2020/06/19,Alicante,Valencia,2491,2565124,594555,1970569,1858683,384847
2020/06/19,Alicante,Alicante,301219,1858683,376279,1482404,1858683,384847
2020/06/19,Alicante,Murcia,4062,1493898,293449,1200449,1858683,384847
2020/06/19,Alicante,Albacete,455,388167,51690,336477,1858683,384847
2020/06/19,Almería,Almería,99940,716820,121245,595575,716820,123786
2020/06/19,Almería,Murcia,2106,1493898,293449,1200449,716820,123786
2020/06/19,Almería,Granada,634,914678,174407,740271,716820,123786
2020/06/19,Araba,Araba,63527,331549,78470,253079,331549,86649
2020/06/19,Araba,Rioja,2674,316798,63192,253606,331549,86649
2020/06/19,Araba,Gipuzkoa,698,723576,150087,573489,331549,86649
2020/06/19,Araba,Navarra,327,654183,137310,516873,331549,86649
2020/06/19,Araba,Bizkaia,2707,1152934,301732,851202,331549,86649
2020/06/19,Araba,Burgos,2426,357072,59348,297724,331549,86649
2020/06/19,Asturias,Cantabria,240,580795,124461,456334,1022800,214472
2020/06/19,Asturias,Lugo,1224,329587,57983,271604,1022800,214472
2020/06/19,Asturias,Asturias,180505,1022800,215120,807680,1022800,214472
2020/06/19,Asturias,León,41,460001,87700,372301,1022800,214472
2020/06/19,Ávila,Valladolid,72,519546,114152,405394,157640,25299
2020/06/19,Ávila,Salamanca,349,330119,61312,268807,157640,25299
2020/06/19,Ávila,Cáceres,120,394151,59025,335126,157640,25299
2020/06/19,Ávila,Toledo,336,694844,115745,579099,157640,25299
2020/06/19,Ávila,Madrid,234,6663394,1467762,5195632,157640,25299
2020/06/19,Ávila,Segovia,141,153129,26344,126785,157640,25299
2020/06/19,Ávila,Ávila,15723,157640,23110,134530,157640,25299
2020/06/19,Badajoz,Ciudad Real,43,495761,62082,433679,673559,111019
2020/06/19,Badajoz,Badajoz,85487,673559,112248,561311,673559,111019
2020/06/19,Badajoz,Córdoba,93,782979,142673,640306,673559,111019
2020/06/19,Badajoz,Huelva,244,521870,93136,428734,673559,111019
2020/06/19,Badajoz,Sevilla,100,1942389,411143,1531246,673559,111019
2020/06/19,Badajoz,Cáceres,1608,394151,59025,335126,673559,111019
2020/06/19,Balears,Valencia,89,2565124,594555,1970569,1149460,218901
2020/06/19,Balears,Barcelona,17,5664579,1353997,4310582,1149460,218901
2020/06/19,Balears,Balears,195775,1149460,218062,931398,1149460,218901
2020/06/19,Barcelona,Lleida,327,434930,83634,351296,5664579,1323289
2020/06/19,Barcelona,Tarragona,2930,804664,148780,655884,5664579,1323289
2020/06/19,Barcelona,Barcelona,890276,5664579,1353997,4310582,5664579,1323289
2020/06/19,Barcelona,Girona,4031,771044,135976,635068,5664579,1323289
2020/06/19,Bizkaia,Araba,1534,331549,78470,253079,1152934,287103
2020/06/19,Bizkaia,Gipuzkoa,1881,723576,150087,573489,1152934,287103
2020/06/19,Bizkaia,Burgos,98,357072,59348,297724,1152934,287103
2020/06/19,Bizkaia,Cantabria,3722,580795,124461,456334,1152934,287103
2020/06/19,Bizkaia,Bizkaia,233197,1152934,301732,851202,1152934,287103
2020/06/19,Burgos,Valladolid,86,519546,114152,405394,357072,58676
2020/06/19,Burgos,Cantabria,50,580795,124461,456334,357072,58676
2020/06/19,Burgos,Rioja,97,316798,63192,253606,357072,58676
2020/06/19,Burgos,Soria,62,88636,10905,77731,357072,58676
2020/06/19,Burgos,Segovia,91,153129,26344,126785,357072,58676
2020/06/19,Burgos,Araba,1420,331549,78470,253079,357072,58676
2020/06/19,Burgos,Burgos,44890,357072,59348,297724,357072,58676
2020/06/19,Burgos,Palencia,204,160866,29950,130916,357072,58676
2020/06/19,Burgos,Bizkaia,255,1152934,301732,851202,357072,58676
2020/06/19,Cáceres,Cáceres,41200,394151,59025,335126,394151,59131
2020/06/19,Cáceres,Ávila,158,157640,23110,134530,394151,59131
2020/06/19,Cáceres,Toledo,164,694844,115745,579099,394151,59131
2020/06/19,Cáceres,Badajoz,1465,673559,112248,561311,394151,59131
2020/06/19,Cáceres,Valencia,21,2565124,594555,1970569,394151,59131
2020/06/19,Cádiz,Huelva,842,521870,93136,428734,1240155,254581
2020/06/19,Cádiz,Málaga,2364,1661785,334289,1327496,1240155,254581
2020/06/19,Cádiz,Ceuta,62,84777,12991,71786,1240155,254581
2020/06/19,Cádiz,Cádiz,202963,1240155,241897,998258,1240155,254581
2020/06/19,Cádiz,Sevilla,2587,1942389,411143,1531246,1240155,254581
2020/06/19,Cantabria,Asturias,269,1022800,215120,807680,580795,130368
2020/06/19,Cantabria,Bizkaia,6429,1152934,301732,851202,580795,130368
2020/06/19,Cantabria,Palencia,137,160866,29950,130916,580795,130368
2020/06/19,Cantabria,Araba,52,331549,78470,253079,580795,130368
2020/06/19,Cantabria,Cantabria,95489,580795,124461,456334,580795,130368
2020/06/19,Castellón,Valencia,1532,2565124,594555,1970569,579962,112359
2020/06/19,Castellón,Castellón,80767,579962,104307,475655,579962,112359
2020/06/19,Castellón,Tarragona,1197,804664,148780,655884,579962,112359
2020/06/19,Castellón,Teruel,80,134137,14011,120126,579962,112359
2020/06/19,Ceuta,Cádiz,44,1240155,241897,998258,84777,12713
2020/06/19,Ceuta,Ceuta,12257,84777,12991,71786,84777,12713
2020/06/19,Ciudad Real,Albacete,516,388167,51690,336477,495761,58848
2020/06/19,Ciudad Real,Toledo,561,694844,115745,579099,495761,58848
2020/06/19,Ciudad Real,Ciudad Real,40956,495761,62082,433679,495761,58848
2020/06/19,Ciudad Real,Córdoba,389,782979,142673,640306,495761,58848
2020/06/19,Ciudad Real,Cuenca,46,196329,26775,169554,495761,58848
2020/06/19,Ciudad Real,Badajoz,100,673559,112248,561311,495761,58848
2020/06/19,Córdoba,Sevilla,2294,1942389,411143,1531246,782979,139096
2020/06/19,Córdoba,Córdoba,102532,782979,142673,640306,782979,139096
2020/06/19,Córdoba,Jaén,798,633564,92374,541190,782979,139096
2020/06/19,Córdoba,Ciudad Real,304,495761,62082,433679,782979,139096
2020/06/19,Córdoba,Badajoz,88,673559,112248,561311,782979,139096
2020/06/19,Córdoba,Granada,221,914678,174407,740271,782979,139096
2020/06/19,Córdoba,Málaga,587,1661785,334289,1327496,782979,139096
2020/06/19,Coruña,Lugo,721,329587,57983,271604,1119596,249083
2020/06/19,Coruña,Pontevedra,6984,942665,219085,723580,1119596,249083
2020/06/19,Coruña,Coruña,191549,1119596,244970,874626,1119596,249083
2020/06/19,Cuenca,Valencia,186,2565124,594555,1970569,196329,28295
2020/06/19,Cuenca,Guadalajara,70,257762,48714,209048,196329,28295
2020/06/19,Cuenca,Ciudad Real,125,495761,62082,433679,196329,28295
2020/06/19,Cuenca,Toledo,233,694844,115745,579099,196329,28295
2020/06/19,Cuenca,Cuenca,15170,196329,26775,169554,196329,28295
2020/06/19,Cuenca,Albacete,868,388167,51690,336477,196329,28295
2020/06/19,Cuenca,Madrid,79,6663394,1467762,5195632,196329,28295
2020/06/19,Gipuzkoa,Navarra,688,654183,137310,516873,723576,152935
2020/06/19,Gipuzkoa,Bizkaia,2717,1152934,301732,851202,723576,152935
2020/06/19,Gipuzkoa,Araba,492,331549,78470,253079,723576,152935
2020/06/19,Gipuzkoa,Gipuzkoa,118244,723576,150087,573489,723576,152935
2020/06/19,Girona,Barcelona,4377,5664579,1353997,4310582,771044,157093
2020/06/19,Girona,Girona,95439,771044,135976,635068,771044,157093
2020/06/19,Girona,Lleida,322,434930,83634,351296,771044,157093
2020/06/19,Granada,Granada,129806,914678,174407,740271,914678,174028
2020/06/19,Granada,Jaén,510,633564,92374,541190,914678,174028
2020/06/19,Granada,Málaga,311,1661785,334289,1327496,914678,174028
2020/06/19,Granada,Murcia,254,1493898,293449,1200449,914678,174028
2020/06/19,Granada,Almería,585,716820,121245,595575,914678,174028
2020/06/19,Granada,Córdoba,186,782979,142673,640306,914678,174028
2020/06/19,Guadalajara,Cuenca,75,196329,26775,169554,257762,52163
2020/06/19,Guadalajara,Madrid,3493,6663394,1467762,5195632,257762,52163
2020/06/19,Guadalajara,Guadalajara,29247,257762,48714,209048,257762,52163
2020/06/19,Huelva,Sevilla,2859,1942389,411143,1531246,521870,101005
2020/06/19,Huelva,Huelva,72658,521870,93136,428734,521870,101005
2020/06/19,Huelva,Cádiz,661,1240155,241897,998258,521870,101005
2020/06/19,Huelva,Badajoz,372,673559,112248,561311,521870,101005
2020/06/19,Huesca,Zaragoza,661,964724,221254,743470,220461,41578
2020/06/19,Huesca,Huesca,24945,220461,36307,184154,220461,41578
2020/06/19,Huesca,Lleida,1385,434930,83634,351296,220461,41578
2020/06/19,Jaén,Jaén,64258,633564,92374,541190,633564,89870
2020/06/19,Jaén,Albacete,56,388167,51690,336477,633564,89870
2020/06/19,Jaén,Granada,462,914678,174407,740271,633564,89870
2020/06/19,Jaén,Córdoba,933,782979,142673,640306,633564,89870
2020/06/19,Las Palmas de Gran Canaria,Las Palmas de Gran Canaria,215953,1120406,229234,891172,1120406,229226
2020/06/19,Las Palmas de Gran Canaria,Santa Cruz de Tenerife,22,1032983,207167,825816,1120406,229226
2020/06/19,León,Ourense,390,307651,65115,242536,460001,87852
2020/06/19,León,León,68590,460001,87700,372301,460001,87852
2020/06/19,León,Palencia,72,160866,29950,130916,460001,87852
2020/06/19,León,Zamora,187,172539,28015,144524,460001,87852
2020/06/19,León,Asturias,50,1022800,215120,807680,460001,87852
2020/06/19,León,Valladolid,51,519546,114152,405394,460001,87852
2020/06/19,León,Lugo,44,329587,57983,271604,460001,87852
2020/06/19,Lleida,Tarragona,61,804664,148780,655884,434930,84163
2020/06/19,Lleida,Barcelona,537,5664579,1353997,4310582,434930,84163
2020/06/19,Lleida,Girona,248,771044,135976,635068,434930,84163
2020/06/19,Lleida,Zaragoza,217,964724,221254,743470,434930,84163
2020/06/19,Lleida,Lleida,56812,434930,83634,351296,434930,84163
2020/06/19,Lleida,Huesca,794,220461,36307,184154,434930,84163
2020/06/19,Lugo,Coruña,837,1119596,244970,874626,329587,59991
2020/06/19,Lugo,Lugo,41386,329587,57983,271604,329587,59991
2020/06/19,Lugo,Ourense,293,307651,65115,242536,329587,59991
2020/06/19,Lugo,Asturias,935,1022800,215120,807680,329587,59991
2020/06/19,Lugo,Pontevedra,56,942665,219085,723580,329587,59991
2020/06/19,Madrid,Toledo,5812,694844,115745,579099,6663394,1459542
2020/06/19,Madrid,Guadalajara,4514,257762,48714,209048,6663394,1459542
2020/06/19,Madrid,Madrid,952170,6663394,1467762,5195632,6663394,1459542
2020/06/19,Madrid,Ávila,318,157640,23110,134530,6663394,1459542
2020/06/19,Madrid,Segovia,39,153129,26344,126785,6663394,1459542
2020/06/19,Madrid,Valencia,22,2565124,594555,1970569,6663394,1459542
2020/06/19,Madrid,Cuenca,101,196329,26775,169554,6663394,1459542
2020/06/19,Málaga,Granada,439,914678,174407,740271,1661785,339917
2020/06/19,Málaga,Málaga,279890,1661785,334289,1327496,1661785,339917
2020/06/19,Málaga,Cádiz,2039,1240155,241897,998258,1661785,339917
2020/06/19,Málaga,Córdoba,398,782979,142673,640306,1661785,339917
2020/06/19,Málaga,Sevilla,392,1942389,411143,1531246,1661785,339917
2020/06/19,Melilla,Melilla,16360,86487,16711,69776,86487,16740
2020/06/19,Murcia,Murcia,236666,1493898,293449,1200449,1493898,287938
2020/06/19,Murcia,Albacete,758,388167,51690,336477,1493898,287938
2020/06/19,Murcia,Alicante,3417,1858683,376279,1482404,1493898,287938
2020/06/19,Murcia,Almería,1592,716820,121245,595575,1493898,287938
2020/06/19,Murcia,Granada,30,914678,174407,740271,1493898,287938
2020/06/19,Navarra,Araba,150,331549,78470,253079,654183,137543
2020/06/19,Navarra,Navarra,104151,654183,137310,516873,654183,137543
2020/06/19,Navarra,Zaragoza,797,964724,221254,743470,654183,137543
2020/06/19,Navarra,Rioja,2850,316798,63192,253606,654183,137543
2020/06/19,Navarra,Gipuzkoa,498,723576,150087,573489,654183,137543
2020/06/19,Ourense,Ourense,50162,307651,65115,242536,307651,65443
2020/06/19,Ourense,Zamora,47,172539,28015,144524,307651,65443
2020/06/19,Ourense,Pontevedra,234,942665,219085,723580,307651,65443
2020/06/19,Ourense,Lugo,349,329587,57983,271604,307651,65443
2020/06/19,Ourense,León,362,460001,87700,372301,307651,65443
2020/06/19,Palencia,Burgos,312,357072,59348,297724,160866,31580
2020/06/19,Palencia,Palencia,22251,160866,29950,130916,160866,31580
2020/06/19,Palencia,León,53,460001,87700,372301,160866,31580
2020/06/19,Palencia,Cantabria,190,580795,124461,456334,160866,31580
2020/06/19,Palencia,Valladolid,404,519546,114152,405394,160866,31580
2020/06/19,Pontevedra,Ourense,227,307651,65115,242536,942665,218580
2020/06/19,Pontevedra,Lugo,59,329587,57983,271604,942665,218580
2020/06/19,Pontevedra,Coruña,5528,1119596,244970,874626,942665,218580
2020/06/19,Pontevedra,Pontevedra,174227,942665,219085,723580,942665,218580
2020/06/19,Rioja,Burgos,140,357072,59348,297724,316798,60383
2020/06/19,Rioja,Araba,988,331549,78470,253079,316798,60383
2020/06/19,Rioja,Navarra,2078,654183,137310,516873,316798,60383
2020/06/19,Rioja,Rioja,48068,316798,63192,253606,316798,60383
2020/06/19,Salamanca,Zamora,133,172539,28015,144524,330119,61251
2020/06/19,Salamanca,Salamanca,50117,330119,61312,268807,330119,61251
2020/06/19,Salamanca,Ávila,196,157640,23110,134530,330119,61251
2020/06/19,Santa Cruz de Tenerife,Santa Cruz de Tenerife,190431,1032983,207167,825816,1032983,206728
2020/06/19,Santa Cruz de Tenerife,Las Palmas de Gran Canaria,52,1120406,229234,891172,1032983,206728
2020/06/19,Segovia,Valladolid,451,519546,114152,405394,153129,29589
2020/06/19,Segovia,Burgos,156,357072,59348,297724,153129,29589
2020/06/19,Segovia,Ávila,136,157640,23110,134530,153129,29589
2020/06/19,Segovia,Soria,25,88636,10905,77731,153129,29589
2020/06/19,Segovia,Segovia,18389,153129,26344,126785,153129,29589
2020/06/19,Segovia,Madrid,26,6663394,1467762,5195632,153129,29589
2020/06/19,Sevilla,Málaga,280,1661785,334289,1327496,1942389,393293
2020/06/19,Sevilla,Cádiz,1467,1240155,241897,998258,1942389,393293
2020/06/19,Sevilla,Huelva,672,521870,93136,428734,1942389,393293
2020/06/19,Sevilla,Córdoba,2352,782979,142673,640306,1942389,393293
2020/06/19,Sevilla,Sevilla,294946,1942389,411143,1531246,1942389,393293
2020/06/19,Sevilla,Badajoz,101,673559,112248,561311,1942389,393293
2020/06/19,Soria,Zaragoza,132,964724,221254,743470,88636,11998
2020/06/19,Soria,Valladolid,41,519546,114152,405394,88636,11998
2020/06/19,Soria,Soria,8383,88636,10905,77731,88636,11998
2020/06/19,Soria,Guadalajara,21,257762,48714,209048,88636,11998
2020/06/19,Soria,Burgos,127,357072,59348,297724,88636,11998
2020/06/19,Tarragona,Barcelona,2572,5664579,1353997,4310582,804664,158978
2020/06/19,Tarragona,Zaragoza,67,964724,221254,743470,804664,158978
2020/06/19,Tarragona,Teruel,127,134137,14011,120126,804664,158978
2020/06/19,Tarragona,Lleida,45,434930,83634,351296,804664,158978
2020/06/19,Tarragona,Castellón,1023,579962,104307,475655,804664,158978
2020/06/19,Tarragona,Tarragona,103706,804664,148780,655884,804664,158978
2020/06/19,Teruel,Zaragoza,519,964724,221254,743470,134137,16317
2020/06/19,Teruel,Guadalajara,27,257762,48714,209048,134137,16317
2020/06/19,Teruel,Valencia,47,2565124,594555,1970569,134137,16317
2020/06/19,Teruel,Teruel,8557,134137,14011,120126,134137,16317
2020/06/19,Teruel,Castellón,87,579962,104307,475655,134137,16317
2020/06/19,Teruel,Tarragona,76,804664,148780,655884,134137,16317
2020/06/19,Toledo,Ciudad Real,540,495761,62082,433679,694844,113031
2020/06/19,Toledo,Cuenca,209,196329,26775,169554,694844,113031
2020/06/19,Toledo,Madrid,4727,6663394,1467762,5195632,694844,113031
2020/06/19,Toledo,Ávila,247,157640,23110,134530,694844,113031
2020/06/19,Toledo,Toledo,58856,694844,115745,579099,694844,113031
2020/06/19,Toledo,Cáceres,152,394151,59025,335126,694844,113031
2020/06/19,Valencia,Cáceres,19,394151,59025,335126,2565124,578695
2020/06/19,Valencia,Albacete,414,388167,51690,336477,2565124,578695
2020/06/19,Valencia,Teruel,19,134137,14011,120126,2565124,578695
2020/06/19,Valencia,Alicante,1883,1858683,376279,1482404,2565124,578695
2020/06/19,Valencia,Cuenca,142,196329,26775,169554,2565124,578695
2020/06/19,Valencia,Castellón,756,579962,104307,475655,2565124,578695
2020/06/19,Valencia,Valencia,442029,2565124,594555,1970569,2565124,578695
2020/06/19,Valladolid,Palencia,65,160866,29950,130916,519546,111226
2020/06/19,Valladolid,Ávila,37,157640,23110,134530,519546,111226
2020/06/19,Valladolid,Burgos,97,357072,59348,297724,519546,111226
2020/06/19,Valladolid,Segovia,342,153129,26344,126785,519546,111226
2020/06/19,Valladolid,Valladolid,88873,519546,114152,405394,519546,111226
2020/06/19,Valladolid,Zamora,239,172539,28015,144524,519546,111226
2020/06/19,Valladolid,León,35,460001,87700,372301,519546,111226
2020/06/19,Zamora,Salamanca,18,330119,61312,268807,172539,27881
2020/06/19,Zamora,Zamora,19950,172539,28015,144524,172539,27881
2020/06/19,Zamora,Ourense,111,307651,65115,242536,172539,27881
2020/06/19,Zamora,Valladolid,129,519546,114152,405394,172539,27881
2020/06/19,Zamora,León,24,460001,87700,372301,172539,27881
2020/06/19,Zaragoza,Teruel,486,134137,14011,120126,964724,212348
2020/06/19,Zaragoza,Soria,92,88636,10905,77731,964724,212348
2020/06/19,Zaragoza,Zaragoza,175729,964724,221254,743470,964724,212348
2020/06/19,Zaragoza,Huesca,308,220461,36307,184154,964724,212348
2020/06/19,Zaragoza,Navarra,708,654183,137310,516873,964724,212348
2020/06/19,Zaragoza,Lleida,85,434930,83634,351296,964724,212348
2020/06/20,Albacete,Albacete,31447,388167,43745,344422,388167,45948
2020/06/20,Albacete,Alicante,254,1858683,334978,1523705,388167,45948
2020/06/20,Albacete,Jaén,50,633564,82313,551251,388167,45948
2020/06/20,Albacete,Cuenca,668,196329,22652,173677,388167,45948
2020/06/20,Albacete,Ciudad Real,686,495761,50313,445448,388167,45948
2020/06/20,Albacete,Murcia,545,1493898,255216,1238682,388167,45948
2020/06/20,Albacete,Valencia,285,2565124,514364,2050760,388167,45948
2020/06/20,Alicante,Alicante,265069,1858683,334978,1523705,1858683,349697
2020/06/20,Alicante,Valencia,6212,2565124,514364,2050760,1858683,349697
2020/06/20,Alicante,Murcia,4306,1493898,255216,1238682,1858683,349697
2020/06/20,Alicante,Albacete,291,388167,43745,344422,1858683,349697
2020/06/20,Almería,Granada,746,914678,162566,752112,716820,109499
2020/06/20,Almería,Almería,85701,716820,108600,608220,716820,109499
2020/06/20,Almería,Murcia,1344,1493898,255216,1238682,716820,109499
2020/06/20,Almería,Málaga,16,1661785,301215,1360570,716820,109499
2020/06/20,Araba,Burgos,1334,357072,51926,305146,331549,74377
2020/06/20,Araba,Navarra,243,654183,118766,535417,331549,74377
2020/06/20,Araba,Gipuzkoa,1164,723576,133621,589955,331549,74377
2020/06/20,Araba,Bizkaia,2923,1152934,269212,883722,331549,74377
2020/06/20,Araba,Rioja,1535,316798,54117,262681,331549,74377
2020/06/20,Araba,Araba,53670,331549,71332,260217,331549,74377
2020/06/20,Asturias,Lugo,1107,329587,50620,278967,1022800,201377
2020/06/20,Asturias,León,38,460001,76532,383469,1022800,201377
2020/06/20,Asturias,Cantabria,290,580795,116123,464672,1022800,201377
2020/06/20,Asturias,Asturias,173612,1022800,202000,820800,1022800,201377
2020/06/20,Ávila,Valladolid,36,519546,92598,426948,157640,23262
2020/06/20,Ávila,Ávila,14313,157640,19612,138028,157640,23262
2020/06/20,Ávila,Segovia,55,153129,21906,131223,157640,23262
2020/06/20,Ávila,Salamanca,358,330119,52710,277409,157640,23262
2020/06/20,Ávila,Toledo,312,694844,88340,606504,157640,23262
2020/06/20,Ávila,Madrid,242,6663394,1252761,5410633,157640,23262
2020/06/20,Ávila,Cáceres,121,394151,50892,343259,157640,23262
2020/06/20,Badajoz,Ciudad Real,66,495761,50313,445448,673559,92712
2020/06/20,Badajoz,Badajoz,70001,673559,93624,579935,673559,92712
2020/06/20,Badajoz,Huelva,240,521870,80435,441435,673559,92712
2020/06/20,Badajoz,Córdoba,121,782979,123277,659702,673559,92712
2020/06/20,Badajoz,Cáceres,1679,394151,50892,343259,673559,92712
2020/06/20,Badajoz,Sevilla,67,1942389,349330,1593059,673559,92712
2020/06/20,Balears,Valencia,27,2565124,514364,2050760,1149460,204897
2020/06/20,Balears,Barcelona,19,5664579,1216687,4447892,1149460,204897
2020/06/20,Balears,Balears,184266,1149460,203604,945856,1149460,204897
2020/06/20,Balears,Alicante,24,1858683,334978,1523705,1149460,204897
2020/06/20,Barcelona,Valencia,16,2565124,514364,2050760,5664579,1133351
2020/06/20,Barcelona,Girona,4004,771044,127351,643693,5664579,1133351
2020/06/20,Barcelona,Tarragona,2500,804664,135947,668717,5664579,1133351
2020/06/20,Barcelona,Barcelona,714477,5664579,1216687,4447892,5664579,1133351
2020/06/20,Barcelona,Lleida,234,434930,73909,361021,5664579,1133351
2020/06/20,Bizkaia,Gipuzkoa,1442,723576,133621,589955,1152934,244800
2020/06/20,Bizkaia,Araba,1786,331549,71332,260217,1152934,244800
2020/06/20,Bizkaia,Cantabria,2208,580795,116123,464672,1152934,244800
2020/06/20,Bizkaia,Burgos,73,357072,51926,305146,1152934,244800
2020/06/20,Bizkaia,Bizkaia,196490,1152934,269212,883722,1152934,244800
2020/06/20,Burgos,Valladolid,86,519546,92598,426948,357072,55824
2020/06/20,Burgos,Araba,2771,331549,71332,260217,357072,55824
2020/06/20,Burgos,Segovia,45,153129,21906,131223,357072,55824
2020/06/20,Burgos,Bizkaia,310,1152934,269212,883722,357072,55824
2020/06/20,Burgos,Cantabria,47,580795,116123,464672,357072,55824
2020/06/20,Burgos,Rioja,41,316798,54117,262681,357072,55824
2020/06/20,Burgos,Palencia,208,160866,25806,135060,357072,55824
2020/06/20,Burgos,Soria,25,88636,10166,78470,357072,55824
2020/06/20,Burgos,Burgos,41651,357072,51926,305146,357072,55824
2020/06/20,Cáceres,Ávila,134,157640,19612,138028,394151,51964
2020/06/20,Cáceres,Cáceres,35140,394151,50892,343259,394151,51964
2020/06/20,Cáceres,Badajoz,1368,673559,93624,579935,394151,51964
2020/06/20,Cáceres,Toledo,169,694844,88340,606504,394151,51964
2020/06/20,Cádiz,Ceuta,159,84777,11861,72916,1240155,258922
2020/06/20,Cádiz,Sevilla,9881,1942389,349330,1593059,1240155,258922
2020/06/20,Cádiz,Málaga,3379,1661785,301215,1360570,1240155,258922
2020/06/20,Cádiz,Cádiz,194941,1240155,230256,1009899,1240155,258922
2020/06/20,Cádiz,Huelva,762,521870,80435,441435,1240155,258922
2020/06/20,Cantabria,Burgos,77,357072,51926,305146,580795,132812
2020/06/20,Cantabria,Asturias,315,1022800,202000,820800,580795,132812
2020/06/20,Cantabria,Cantabria,92098,580795,116123,464672,580795,132812
2020/06/20,Cantabria,Araba,282,331549,71332,260217,580795,132812
2020/06/20,Cantabria,Palencia,101,160866,25806,135060,580795,132812
2020/06/20,Cantabria,Bizkaia,12262,1152934,269212,883722,580795,132812
2020/06/20,Castellón,Tarragona,1015,804664,135947,668717,579962,100076
2020/06/20,Castellón,Teruel,44,134137,12691,121446,579962,100076
2020/06/20,Castellón,Valencia,3607,2565124,514364,2050760,579962,100076
2020/06/20,Castellón,Castellón,66285,579962,88263,491699,579962,100076
2020/06/20,Ceuta,Cádiz,55,1240155,230256,1009899,84777,11495
2020/06/20,Ceuta,Ceuta,11042,84777,11861,72916,84777,11495
2020/06/20,Ciudad Real,Córdoba,338,782979,123277,659702,495761,49831
2020/06/20,Ciudad Real,Albacete,458,388167,43745,344422,495761,49831
2020/06/20,Ciudad Real,Ciudad Real,34410,495761,50313,445448,495761,49831
2020/06/20,Ciudad Real,Badajoz,69,673559,93624,579935,495761,49831
2020/06/20,Ciudad Real,Cuenca,39,196329,22652,173677,495761,49831
2020/06/20,Ciudad Real,Toledo,269,694844,88340,606504,495761,49831
2020/06/20,Córdoba,Ciudad Real,301,495761,50313,445448,782979,117651
2020/06/20,Córdoba,Granada,128,914678,162566,752112,782979,117651
2020/06/20,Córdoba,Córdoba,82895,782979,123277,659702,782979,117651
2020/06/20,Córdoba,Málaga,298,1661785,301215,1360570,782979,117651
2020/06/20,Córdoba,Sevilla,2080,1942389,349330,1593059,782979,117651
2020/06/20,Córdoba,Badajoz,206,673559,93624,579935,782979,117651
2020/06/20,Córdoba,Jaén,783,633564,82313,551251,782979,117651
2020/06/20,Coruña,Lugo,986,329587,50620,278967,1119596,202932
2020/06/20,Coruña,Coruña,148235,1119596,201903,917693,1119596,202932
2020/06/20,Coruña,Pontevedra,5616,942665,177384,765281,1119596,202932
2020/06/20,Coruña,Ourense,23,307651,55632,252019,1119596,202932
2020/06/20,Cuenca,Toledo,223,694844,88340,606504,196329,25210
2020/06/20,Cuenca,Ciudad Real,109,495761,50313,445448,196329,25210
2020/06/20,Cuenca,Madrid,54,6663394,1252761,5410633,196329,25210
2020/06/20,Cuenca,Cuenca,14210,196329,22652,173677,196329,25210
2020/06/20,Cuenca,Guadalajara,96,257762,41084,216678,196329,25210
2020/06/20,Cuenca,Valencia,99,2565124,514364,2050760,196329,25210
2020/06/20,Cuenca,Albacete,950,388167,43745,344422,196329,25210
2020/06/20,Gipuzkoa,Gipuzkoa,101219,723576,133621,589955,723576,134982
2020/06/20,Gipuzkoa,Araba,463,331549,71332,260217,723576,134982
2020/06/20,Gipuzkoa,Navarra,377,654183,118766,535417,723576,134982
2020/06/20,Gipuzkoa,Bizkaia,2375,1152934,269212,883722,723576,134982
2020/06/20,Girona,Tarragona,26,804664,135947,668717,771044,171053
2020/06/20,Girona,Girona,87416,771044,127351,643693,771044,171053
2020/06/20,Girona,Lleida,299,434930,73909,361021,771044,171053
2020/06/20,Girona,Barcelona,6195,5664579,1216687,4447892,771044,171053
2020/06/20,Granada,Jaén,880,633564,82313,551251,914678,166084
2020/06/20,Granada,Málaga,644,1661785,301215,1360570,914678,166084
2020/06/20,Granada,Córdoba,302,782979,123277,659702,914678,166084
2020/06/20,Granada,Almería,1386,716820,108600,608220,914678,166084
2020/06/20,Granada,Granada,115093,914678,162566,752112,914678,166084
2020/06/20,Granada,Murcia,134,1493898,255216,1238682,914678,166084
2020/06/20,Guadalajara,Cuenca,75,196329,22652,173677,257762,45913
2020/06/20,Guadalajara,Guadalajara,28489,257762,41084,216678,257762,45913
2020/06/20,Guadalajara,Madrid,2684,6663394,1252761,5410633,257762,45913
2020/06/20,Huelva,Cádiz,857,1240155,230256,1009899,521870,100312
2020/06/20,Huelva,Sevilla,12368,1942389,349330,1593059,521870,100312
2020/06/20,Huelva,Badajoz,348,673559,93624,579935,521870,100312
2020/06/20,Huelva,Huelva,63046,521870,80435,441435,521870,100312
2020/06/20,Huesca,Zaragoza,6543,964724,191013,773711,220461,47174
2020/06/20,Huesca,Lleida,999,434930,73909,361021,220461,47174
2020/06/20,Huesca,Huesca,24593,220461,34543,185918,220461,47174
2020/06/20,Jaén,Jaén,54437,633564,82313,551251,633564,79622
2020/06/20,Jaén,Córdoba,961,782979,123277,659702,633564,79622
2020/06/20,Jaén,Granada,395,914678,162566,752112,633564,79622
2020/06/20,Las Palmas de Gran Canaria,Santa Cruz de Tenerife,36,1032983,178275,854708,1120406,192009
2020/06/20,Las Palmas de Gran Canaria,Las Palmas de Gran Canaria,178649,1120406,193127,927279,1120406,192009
2020/06/20,León,Ourense,202,307651,55632,252019,460001,77643
2020/06/20,León,Zamora,125,172539,23068,149471,460001,77643
2020/06/20,León,Asturias,136,1022800,202000,820800,460001,77643
2020/06/20,León,Palencia,96,160866,25806,135060,460001,77643
2020/06/20,León,León,60568,460001,76532,383469,460001,77643
2020/06/20,León,Valladolid,47,519546,92598,426948,460001,77643
2020/06/20,Lleida,Lleida,46040,434930,73909,361021,434930,79504
2020/06/20,Lleida,Tarragona,130,804664,135947,668717,434930,79504
2020/06/20,Lleida,Huesca,589,220461,34543,185918,434930,79504
2020/06/20,Lleida,Girona,373,771044,127351,643693,434930,79504
2020/06/20,Lleida,Zaragoza,141,964724,191013,773711,434930,79504
2020/06/20,Lleida,Barcelona,642,5664579,1216687,4447892,434930,79504
2020/06/20,Lugo,Coruña,839,1119596,201903,917693,329587,55254
2020/06/20,Lugo,Asturias,980,1022800,202000,820800,329587,55254
2020/06/20,Lugo,Ourense,411,307651,55632,252019,329587,55254
2020/06/20,Lugo,Lugo,34627,329587,50620,278967,329587,55254
2020/06/20,Lugo,León,68,460001,76532,383469,329587,55254
2020/06/20,Lugo,Pontevedra,51,942665,177384,765281,329587,55254
2020/06/20,Madrid,Toledo,3458,694844,88340,606504,6663394,1227971
2020/06/20,Madrid,Ávila,399,157640,19612,138028,6663394,1227971
2020/06/20,Madrid,Madrid,757592,6663394,1252761,5410633,6663394,1227971
2020/06/20,Madrid,Segovia,36,153129,21906,131223,6663394,1227971
2020/06/20,Madrid,Guadalajara,2339,257762,41084,216678,6663394,1227971
2020/06/20,Madrid,Cuenca,114,196329,22652,173677,6663394,1227971
2020/06/20,Málaga,Málaga,241800,1661785,301215,1360570,1661785,308425
2020/06/20,Málaga,Córdoba,1226,782979,123277,659702,1661785,308425
2020/06/20,Málaga,Almería,20,716820,108600,608220,1661785,308425
2020/06/20,Málaga,Granada,1056,914678,162566,752112,1661785,308425
2020/06/20,Málaga,Sevilla,591,1942389,349330,1593059,1661785,308425
2020/06/20,Málaga,Cádiz,2456,1240155,230256,1009899,1661785,308425
2020/06/20,Melilla,Melilla,15384,86487,15721,70766,86487,15647
2020/06/20,Murcia,Albacete,257,388167,43745,344422,1493898,250758
2020/06/20,Murcia,Granada,29,914678,162566,752112,1493898,250758
2020/06/20,Murcia,Alicante,2615,1858683,334978,1523705,1493898,250758
2020/06/20,Murcia,Murcia,209102,1493898,255216,1238682,1493898,250758
2020/06/20,Murcia,Almería,1302,716820,108600,608220,1493898,250758
2020/06/20,Navarra,Rioja,1291,316798,54117,262681,654183,118150
2020/06/20,Navarra,Araba,149,331549,71332,260217,654183,118150
2020/06/20,Navarra,Navarra,91157,654183,118766,535417,654183,118150
2020/06/20,Navarra,Gipuzkoa,507,723576,133621,589955,654183,118150
2020/06/20,Navarra,Zaragoza,485,964724,191013,773711,654183,118150
2020/06/20,Ourense,Lugo,317,329587,50620,278967,307651,56515
2020/06/20,Ourense,Pontevedra,288,942665,177384,765281,307651,56515
2020/06/20,Ourense,León,103,460001,76532,383469,307651,56515
2020/06/20,Ourense,Ourense,40666,307651,55632,252019,307651,56515
2020/06/20,Palencia,Palencia,19804,160866,25806,135060,160866,26455
2020/06/20,Palencia,Cantabria,176,580795,116123,464672,160866,26455
2020/06/20,Palencia,Valladolid,257,519546,92598,426948,160866,26455
2020/06/20,Palencia,Burgos,229,357072,51926,305146,160866,26455
2020/06/20,Pontevedra,Lugo,38,329587,50620,278967,942665,176902
2020/06/20,Pontevedra,Coruña,5366,1119596,201903,917693,942665,176902
2020/06/20,Pontevedra,Pontevedra,133436,942665,177384,765281,942665,176902
2020/06/20,Pontevedra,Ourense,865,307651,55632,252019,942665,176902
2020/06/20,Rioja,Burgos,41,357072,51926,305146,316798,54043
2020/06/20,Rioja,Araba,853,331549,71332,260217,316798,54043
2020/06/20,Rioja,Navarra,1549,654183,118766,535417,316798,54043
2020/06/20,Rioja,Rioja,44290,316798,54117,262681,316798,54043
2020/06/20,Salamanca,Valladolid,23,519546,92598,426948,330119,52599
2020/06/20,Salamanca,Ávila,270,157640,19612,138028,330119,52599
2020/06/20,Salamanca,Zamora,57,172539,23068,149471,330119,52599
2020/06/20,Salamanca,Salamanca,43201,330119,52710,277409,330119,52599
2020/06/20,Santa Cruz de Tenerife,Santa Cruz de Tenerife,160984,1032983,178275,854708,1032983,178117
2020/06/20,Santa Cruz de Tenerife,Las Palmas de Gran Canaria,45,1120406,193127,927279,1032983,178117
2020/06/20,Segovia,Ávila,67,157640,19612,138028,153129,25602
2020/06/20,Segovia,Valladolid,429,519546,92598,426948,153129,25602
2020/06/20,Segovia,Burgos,148,357072,51926,305146,153129,25602
2020/06/20,Segovia,Segovia,15992,153129,21906,131223,153129,25602
2020/06/20,Segovia,Madrid,57,6663394,1252761,5410633,153129,25602
2020/06/20,Segovia,Soria,28,88636,10166,78470,153129,25602
2020/06/20,Sevilla,Córdoba,2127,782979,123277,659702,1942389,302298
2020/06/20,Sevilla,Huelva,658,521870,80435,441435,1942389,302298
2020/06/20,Sevilla,Málaga,152,1661785,301215,1360570,1942389,302298
2020/06/20,Sevilla,Badajoz,88,673559,93624,579935,1942389,302298
2020/06/20,Sevilla,Cádiz,1107,1240155,230256,1009899,1942389,302298
2020/06/20,Sevilla,Sevilla,213676,1942389,349330,1593059,1942389,302298
2020/06/20,Soria,Burgos,26,357072,51926,305146,88636,10624
2020/06/20,Soria,Valladolid,57,519546,92598,426948,88636,10624
2020/06/20,Soria,Zaragoza,46,964724,191013,773711,88636,10624
2020/06/20,Soria,Segovia,17,153129,21906,131223,88636,10624
2020/06/20,Soria,Soria,8345,88636,10166,78470,88636,10624
2020/06/20,Tarragona,Zaragoza,84,964724,191013,773711,804664,166760
2020/06/20,Tarragona,Castellón,729,579962,88263,491699,804664,166760
2020/06/20,Tarragona,Teruel,122,134137,12691,121446,804664,166760
2020/06/20,Tarragona,Barcelona,6445,5664579,1216687,4447892,804664,166760
2020/06/20,Tarragona,Lleida,394,434930,73909,361021,804664,166760
2020/06/20,Tarragona,Tarragona,94263,804664,135947,668717,804664,166760
2020/06/20,Teruel,Valencia,24,2565124,514364,2050760,134137,18482
2020/06/20,Teruel,Tarragona,148,804664,135947,668717,134137,18482
2020/06/20,Teruel,Zaragoza,1966,964724,191013,773711,134137,18482
2020/06/20,Teruel,Castellón,61,579962,88263,491699,134137,18482
2020/06/20,Teruel,Teruel,7858,134137,12691,121446,134137,18482
2020/06/20,Teruel,Guadalajara,35,257762,41084,216678,134137,18482
2020/06/20,Toledo,Toledo,51754,694844,88340,606504,694844,94378
2020/06/20,Toledo,Cuenca,49,196329,22652,173677,694844,94378
2020/06/20,Toledo,Ciudad Real,236,495761,50313,445448,694844,94378
2020/06/20,Toledo,Madrid,3415,6663394,1252761,5410633,694844,94378
2020/06/20,Toledo,Ávila,344,157640,19612,138028,694844,94378
2020/06/20,Toledo,Cáceres,128,394151,50892,343259,694844,94378
2020/06/20,Valencia,Castellón,1104,579962,88263,491699,2565124,488527
2020/06/20,Valencia,Cuenca,129,196329,22652,173677,2565124,488527
2020/06/20,Valencia,Teruel,74,134137,12691,121446,2565124,488527
2020/06/20,Valencia,Albacete,331,388167,43745,344422,2565124,488527
2020/06/20,Valencia,Cáceres,23,394151,50892,343259,2565124,488527
2020/06/20,Valencia,Alicante,1866,1858683,334978,1523705,2565124,488527
2020/06/20,Valencia,Valencia,354402,2565124,514364,2050760,2565124,488527
2020/06/20,Valladolid,Segovia,337,153129,21906,131223,519546,89564
2020/06/20,Valladolid,Burgos,124,357072,51926,305146,519546,89564
2020/06/20,Valladolid,Zamora,71,172539,23068,149471,519546,89564
2020/06/20,Valladolid,Palencia,33,160866,25806,135060,519546,89564
2020/06/20,Valladolid,Soria,51,88636,10166,78470,519546,89564
2020/06/20,Valladolid,Ávila,30,157640,19612,138028,519546,89564
2020/06/20,Valladolid,Valladolid,73010,519546,92598,426948,519546,89564
2020/06/20,Valladolid,León,42,460001,76532,383469,519546,89564
2020/06/20,Zamora,Valladolid,121,519546,92598,426948,172539,23678
2020/06/20,Zamora,Zamora,17196,172539,23068,149471,172539,23678
2020/06/20,Zamora,Salamanca,42,330119,52710,277409,172539,23678
2020/06/20,Zamora,León,58,460001,76532,383469,172539,23678
2020/06/20,Zamora,Ourense,38,307651,55632,252019,172539,23678
2020/06/20,Zaragoza,Lleida,156,434930,73909,361021,964724,172295
2020/06/20,Zaragoza,Huesca,517,220461,34543,185918,964724,172295
2020/06/20,Zaragoza,Soria,51,88636,10166,78470,964724,172295
2020/06/20,Zaragoza,Teruel,261,134137,12691,121446,964724,172295
2020/06/20,Zaragoza,Zaragoza,138770,964724,191013,773711,964724,172295
2020/06/20,Zaragoza,Navarra,570,654183,118766,535417,964724,172295
